CODMUNRES,Ano,OICFSI,OISFSI,ONI,Total,Indicador
110000,2013,1,0,0,1,100.0
110000,2014,0,0,2,2,0.0
110000,2015,0,1,0,1,100.0
110000,2016,3,1,0,4,100.0
110000,2018,0,0,1,1,0.0
110000,2019,0,1,1,2,50.0
110000,2020,2,0,1,3,66.66666666666666
110001,2012,1,0,4,5,20.0
110001,2013,6,0,0,6,100.0
110001,2014,5,0,0,5,100.0
110001,2015,11,0,0,11,100.0
110001,2016,8,0,0,8,100.0
110001,2017,7,0,0,7,100.0
110001,2018,3,0,0,3,100.0
110001,2019,8,0,1,9,88.88888888888889
110001,2020,1,1,3,5,40.0
110002,2012,33,0,0,33,100.0
110002,2013,36,0,0,36,100.0
110002,2014,35,0,0,35,100.0
110002,2015,41,0,0,41,100.0
110002,2016,35,0,0,35,100.0
110002,2017,25,0,0,25,100.0
110002,2018,27,0,0,27,100.0
110002,2019,44,0,0,44,100.0
110002,2020,44,0,0,44,100.0
110003,2012,1,0,1,2,50.0
110003,2013,2,0,1,3,66.66666666666666
110003,2014,1,0,0,1,100.0
110003,2015,1,0,0,1,100.0
110003,2016,1,1,1,3,66.66666666666666
110003,2017,0,1,0,1,100.0
110003,2018,0,0,1,1,0.0
110003,2019,0,1,1,2,50.0
110003,2020,1,0,0,1,100.0
110004,2012,27,0,0,27,100.0
110004,2013,27,0,0,27,100.0
110004,2014,31,0,1,32,96.875
110004,2015,22,0,0,22,100.0
110004,2016,31,0,0,31,100.0
110004,2017,32,0,0,32,100.0
110004,2018,21,0,0,21,100.0
110004,2019,23,0,0,23,100.0
110004,2020,37,0,0,37,100.0
110005,2012,7,0,0,7,100.0
110005,2013,10,0,0,10,100.0
110005,2014,7,0,0,7,100.0
110005,2015,5,0,0,5,100.0
110005,2016,7,0,0,7,100.0
110005,2017,5,0,0,5,100.0
110005,2018,5,0,0,5,100.0
110005,2019,8,0,0,8,100.0
110005,2020,13,0,0,13,100.0
110006,2012,3,0,2,5,60.0
110006,2013,1,0,4,5,20.0
110006,2014,1,0,2,3,33.33333333333333
110006,2015,1,1,3,5,40.0
110006,2016,4,0,1,5,80.0
110006,2017,3,0,3,6,50.0
110006,2018,1,0,4,5,20.0
110006,2019,5,0,0,5,100.0
110006,2020,8,0,0,8,100.0
110007,2012,1,0,0,1,100.0
110007,2013,1,0,1,2,50.0
110007,2016,1,0,0,1,100.0
110007,2017,4,0,0,4,100.0
110007,2018,2,0,0,2,100.0
110007,2019,0,0,1,1,0.0
110007,2020,4,0,0,4,100.0
110008,2012,5,0,1,6,83.33333333333334
110008,2013,2,0,1,3,66.66666666666666
110008,2014,5,0,0,5,100.0
110008,2015,6,0,0,6,100.0
110008,2016,2,0,0,2,100.0
110008,2017,3,0,0,3,100.0
110008,2018,5,0,0,5,100.0
110008,2019,2,0,1,3,66.66666666666666
110008,2020,2,0,0,2,100.0
110009,2012,3,0,4,7,42.857142857142854
110009,2013,0,0,1,1,0.0
110009,2014,0,0,5,5,0.0
110009,2015,1,0,8,9,11.11111111111111
110009,2016,3,0,6,9,33.33333333333333
110009,2017,6,0,1,7,85.71428571428571
110009,2018,6,0,0,6,100.0
110009,2019,5,0,0,5,100.0
110009,2020,11,0,0,11,100.0
110010,2012,18,0,1,19,94.73684210526315
110010,2013,23,0,0,23,100.0
110010,2014,12,0,0,12,100.0
110010,2015,20,0,0,20,100.0
110010,2016,19,0,0,19,100.0
110010,2017,17,0,1,18,94.44444444444444
110010,2018,16,0,0,16,100.0
110010,2019,12,0,0,12,100.0
110010,2020,17,0,0,17,100.0
110011,2012,12,0,0,12,100.0
110011,2013,11,0,1,12,91.66666666666666
110011,2014,6,0,3,9,66.66666666666666
110011,2015,7,0,12,19,36.84210526315789
110011,2016,16,0,0,16,100.0
110011,2017,19,0,0,19,100.0
110011,2018,17,0,0,17,100.0
110011,2019,21,0,0,21,100.0
110011,2020,20,0,0,20,100.0
110012,2012,36,0,8,44,81.81818181818183
110012,2013,49,0,4,53,92.45283018867924
110012,2014,37,0,0,37,100.0
110012,2015,45,1,0,46,100.0
110012,2016,32,0,0,32,100.0
110012,2017,53,0,1,54,98.14814814814815
110012,2018,42,0,0,42,100.0
110012,2019,35,0,1,36,97.22222222222221
110012,2020,26,0,0,26,100.0
110013,2012,19,0,0,19,100.0
110013,2013,7,0,1,8,87.5
110013,2014,16,0,0,16,100.0
110013,2015,11,0,0,11,100.0
110013,2016,11,0,0,11,100.0
110013,2017,8,0,0,8,100.0
110013,2018,9,0,0,9,100.0
110013,2019,4,0,0,4,100.0
110013,2020,9,0,0,9,100.0
110014,2012,4,0,0,4,100.0
110014,2013,3,0,0,3,100.0
110014,2014,4,0,0,4,100.0
110014,2015,6,0,0,6,100.0
110014,2016,9,0,0,9,100.0
110014,2017,2,0,0,2,100.0
110014,2018,6,0,0,6,100.0
110014,2019,2,0,0,2,100.0
110014,2020,4,0,0,4,100.0
110015,2012,19,0,1,20,95.0
110015,2013,10,0,0,10,100.0
110015,2014,20,1,0,21,100.0
110015,2015,14,0,0,14,100.0
110015,2016,12,0,0,12,100.0
110015,2017,9,0,0,9,100.0
110015,2018,9,0,0,9,100.0
110015,2019,15,0,0,15,100.0
110015,2020,11,0,1,12,91.66666666666666
110018,2012,16,0,0,16,100.0
110018,2013,20,0,0,20,100.0
110018,2014,7,0,0,7,100.0
110018,2015,15,0,0,15,100.0
110018,2016,12,0,0,12,100.0
110018,2017,13,0,0,13,100.0
110018,2018,19,0,0,19,100.0
110018,2019,13,0,0,13,100.0
110018,2020,9,0,0,9,100.0
110020,2012,135,2,50,187,73.2620320855615
110020,2013,141,1,34,176,80.68181818181817
110020,2014,162,1,22,185,88.10810810810811
110020,2015,120,0,47,167,71.8562874251497
110020,2016,150,0,31,181,82.87292817679558
110020,2017,166,0,1,167,99.40119760479041
110020,2018,135,1,6,142,95.77464788732394
110020,2019,143,2,5,150,96.66666666666667
110020,2020,206,0,14,220,93.63636363636364
110025,2012,3,0,4,7,42.857142857142854
110025,2013,2,0,4,6,33.33333333333333
110025,2014,8,0,3,11,72.72727272727273
110025,2015,9,0,0,9,100.0
110025,2016,6,0,0,6,100.0
110025,2017,8,0,0,8,100.0
110025,2018,5,0,0,5,100.0
110025,2019,7,0,0,7,100.0
110025,2020,6,0,0,6,100.0
110026,2012,3,0,0,3,100.0
110026,2013,1,0,0,1,100.0
110026,2014,0,0,1,1,0.0
110026,2016,1,0,1,2,50.0
110026,2017,1,0,0,1,100.0
110026,2018,1,0,0,1,100.0
110026,2020,2,0,0,2,100.0
110028,2012,15,0,0,15,100.0
110028,2013,18,0,0,18,100.0
110028,2014,18,0,1,19,94.73684210526315
110028,2015,18,0,0,18,100.0
110028,2016,19,0,0,19,100.0
110028,2017,18,0,0,18,100.0
110028,2018,14,0,0,14,100.0
110028,2019,18,0,0,18,100.0
110028,2020,15,0,0,15,100.0
110029,2012,4,0,0,4,100.0
110029,2013,3,0,0,3,100.0
110029,2014,4,0,0,4,100.0
110029,2015,1,0,0,1,100.0
110029,2016,1,0,0,1,100.0
110029,2018,2,0,0,2,100.0
110029,2019,2,0,2,4,50.0
110029,2020,1,0,2,3,33.33333333333333
110030,2012,27,0,0,27,100.0
110030,2013,27,0,0,27,100.0
110030,2014,29,0,0,29,100.0
110030,2015,20,0,0,20,100.0
110030,2016,19,0,0,19,100.0
110030,2017,30,0,0,30,100.0
110030,2018,34,0,0,34,100.0
110030,2019,20,0,0,20,100.0
110030,2020,39,0,1,40,97.5
110032,2012,7,0,0,7,100.0
110032,2013,3,0,0,3,100.0
110032,2014,3,0,0,3,100.0
110032,2015,8,0,0,8,100.0
110032,2016,6,0,0,6,100.0
110032,2017,6,0,0,6,100.0
110032,2018,6,0,0,6,100.0
110032,2019,2,0,0,2,100.0
110032,2020,4,0,1,5,80.0
110033,2012,11,0,0,11,100.0
110033,2013,4,0,0,4,100.0
110033,2014,8,0,0,8,100.0
110033,2015,2,0,0,2,100.0
110033,2016,0,0,7,7,0.0
110033,2017,5,0,1,6,83.33333333333334
110033,2018,7,0,0,7,100.0
110033,2019,4,0,0,4,100.0
110033,2020,12,0,1,13,92.3076923076923
110034,2012,5,0,0,5,100.0
110034,2013,3,0,1,4,75.0
110034,2014,4,0,0,4,100.0
110034,2015,7,0,0,7,100.0
110034,2016,7,0,0,7,100.0
110034,2017,3,0,1,4,75.0
110034,2018,4,0,0,4,100.0
110034,2019,6,0,0,6,100.0
110034,2020,5,0,0,5,100.0
110037,2012,9,0,0,9,100.0
110037,2013,4,0,0,4,100.0
110037,2014,5,0,0,5,100.0
110037,2015,3,0,0,3,100.0
110037,2016,5,0,0,5,100.0
110037,2017,1,0,0,1,100.0
110037,2018,2,0,0,2,100.0
110037,2019,2,0,0,2,100.0
110037,2020,7,0,0,7,100.0
110040,2012,4,0,0,4,100.0
110040,2013,4,0,0,4,100.0
110040,2014,3,0,0,3,100.0
110040,2015,10,0,1,11,90.9090909090909
110040,2016,3,0,0,3,100.0
110040,2017,4,0,0,4,100.0
110040,2018,8,0,1,9,88.88888888888889
110040,2019,2,0,0,2,100.0
110040,2020,4,0,0,4,100.0
110045,2012,9,0,1,10,90.0
110045,2013,3,1,2,6,66.66666666666666
110045,2014,16,0,0,16,100.0
110045,2015,15,0,0,15,100.0
110045,2016,10,0,0,10,100.0
110045,2017,7,0,0,7,100.0
110045,2018,7,0,0,7,100.0
110045,2019,7,0,0,7,100.0
110045,2020,11,0,0,11,100.0
110050,2012,2,0,0,2,100.0
110050,2013,2,0,1,3,66.66666666666666
110050,2015,2,0,1,3,66.66666666666666
110050,2016,2,0,2,4,50.0
110050,2017,3,0,0,3,100.0
110050,2018,1,0,0,1,100.0
110050,2019,2,0,0,2,100.0
110060,2012,2,0,0,2,100.0
110060,2013,2,0,0,2,100.0
110060,2015,3,0,0,3,100.0
110060,2017,0,1,0,1,100.0
110060,2018,1,0,0,1,100.0
110060,2019,2,0,0,2,100.0
110070,2012,2,0,1,3,66.66666666666666
110070,2013,0,0,1,1,0.0
110070,2014,1,0,2,3,33.33333333333333
110070,2015,1,0,0,1,100.0
110070,2016,2,0,2,4,50.0
110070,2017,2,0,0,2,100.0
110070,2018,4,0,0,4,100.0
110070,2019,2,0,0,2,100.0
110070,2020,2,0,0,2,100.0
110080,2012,3,0,7,10,30.0
110080,2013,6,0,5,11,54.54545454545454
110080,2014,6,0,1,7,85.71428571428571
110080,2015,6,0,2,8,75.0
110080,2016,5,1,3,9,66.66666666666666
110080,2017,4,0,5,9,44.44444444444444
110080,2018,3,0,4,7,42.857142857142854
110080,2019,9,0,0,9,100.0
110080,2020,6,0,5,11,54.54545454545454
110090,2015,1,0,0,1,100.0
110090,2017,1,0,0,1,100.0
110090,2019,1,0,0,1,100.0
110092,2012,2,0,0,2,100.0
110092,2013,2,0,2,4,50.0
110092,2014,1,0,1,2,50.0
110092,2015,2,1,1,4,75.0
110092,2016,1,0,1,2,50.0
110092,2017,1,2,0,3,100.0
110092,2018,0,0,4,4,0.0
110092,2019,0,1,2,3,33.33333333333333
110092,2020,4,0,0,4,100.0
110094,2012,1,0,0,1,100.0
110094,2013,1,0,1,2,50.0
110094,2014,0,0,1,1,0.0
110094,2015,5,0,2,7,71.42857142857143
110094,2016,2,0,0,2,100.0
110094,2017,1,0,2,3,33.33333333333333
110094,2018,3,0,0,3,100.0
110094,2019,1,0,0,1,100.0
110094,2020,3,0,0,3,100.0
110100,2012,0,1,3,4,25.0
110100,2013,1,0,0,1,100.0
110100,2014,7,0,0,7,100.0
110100,2017,1,0,0,1,100.0
110100,2018,0,0,2,2,0.0
110100,2019,2,0,4,6,33.33333333333333
110100,2020,0,0,5,5,0.0
110110,2013,12,0,0,12,100.0
110110,2014,1,0,0,1,100.0
110110,2015,0,0,2,2,0.0
110110,2016,0,0,1,1,0.0
110110,2017,0,0,4,4,0.0
110110,2018,0,0,3,3,0.0
110110,2019,0,0,3,3,0.0
110110,2020,0,0,3,3,0.0
110120,2012,3,0,0,3,100.0
110120,2013,4,0,1,5,80.0
110120,2014,3,0,0,3,100.0
110120,2015,4,0,0,4,100.0
110120,2016,1,0,1,2,50.0
110120,2017,3,0,0,3,100.0
110120,2018,2,0,0,2,100.0
110120,2019,4,0,1,5,80.0
110120,2020,1,0,1,2,50.0
110130,2012,2,0,2,4,50.0
110130,2013,3,0,1,4,75.0
110130,2014,0,0,2,2,0.0
110130,2015,0,1,0,1,100.0
110130,2016,1,0,0,1,100.0
110130,2017,7,0,0,7,100.0
110130,2018,1,0,0,1,100.0
110130,2020,2,0,1,3,66.66666666666666
110140,2012,2,0,0,2,100.0
110140,2013,3,0,0,3,100.0
110140,2014,4,0,0,4,100.0
110140,2015,5,0,0,5,100.0
110140,2016,1,0,0,1,100.0
110140,2017,4,0,1,5,80.0
110140,2018,5,0,0,5,100.0
110140,2019,9,0,0,9,100.0
110140,2020,4,0,0,4,100.0
110143,2012,0,1,0,1,100.0
110143,2013,2,0,0,2,100.0
110143,2014,0,0,1,1,0.0
110143,2015,0,0,2,2,0.0
110143,2016,4,0,0,4,100.0
110143,2018,2,0,0,2,100.0
110143,2019,1,0,0,1,100.0
110143,2020,0,0,3,3,0.0
110145,2013,1,0,0,1,100.0
110145,2014,2,0,0,2,100.0
110145,2015,3,0,0,3,100.0
110145,2016,1,0,0,1,100.0
110145,2020,0,0,1,1,0.0
110146,2016,0,1,1,2,50.0
110146,2017,0,0,1,1,0.0
110146,2020,0,0,2,2,0.0
110147,2014,1,0,0,1,100.0
110147,2015,2,0,0,2,100.0
110147,2018,1,0,0,1,100.0
110147,2019,1,0,0,1,100.0
110147,2020,1,0,0,1,100.0
110148,2012,1,0,2,3,33.33333333333333
110148,2013,2,0,1,3,66.66666666666666
110148,2014,2,0,0,2,100.0
110148,2015,1,0,0,1,100.0
110148,2017,0,2,0,2,100.0
110148,2018,1,0,1,2,50.0
110148,2019,0,0,4,4,0.0
110149,2012,8,0,0,8,100.0
110149,2013,4,0,0,4,100.0
110149,2014,4,0,0,4,100.0
110149,2015,6,0,0,6,100.0
110149,2016,3,0,0,3,100.0
110149,2017,6,0,0,6,100.0
110149,2018,2,0,0,2,100.0
110149,2019,10,0,0,10,100.0
110149,2020,5,0,0,5,100.0
110150,2012,2,0,0,2,100.0
110150,2013,4,0,0,4,100.0
110150,2014,1,0,0,1,100.0
110150,2015,7,0,0,7,100.0
110150,2016,4,0,0,4,100.0
110150,2017,3,0,0,3,100.0
110150,2018,2,0,0,2,100.0
110150,2019,4,0,0,4,100.0
110150,2020,5,0,0,5,100.0
110155,2012,2,0,0,2,100.0
110155,2013,2,0,0,2,100.0
110155,2014,2,0,1,3,66.66666666666666
110155,2015,1,0,0,1,100.0
110155,2016,2,0,0,2,100.0
110155,2017,1,0,0,1,100.0
110155,2018,1,0,0,1,100.0
110155,2019,1,0,0,1,100.0
110155,2020,0,2,0,2,100.0
110160,2012,0,0,3,3,0.0
110160,2013,0,3,1,4,75.0
110160,2014,0,0,1,1,0.0
110160,2015,1,0,2,3,33.33333333333333
110160,2016,0,0,1,1,0.0
110160,2017,3,0,0,3,100.0
110160,2018,0,0,2,2,0.0
110160,2019,0,0,1,1,0.0
110160,2020,3,0,0,3,100.0
110170,2012,6,0,0,6,100.0
110170,2014,3,0,1,4,75.0
110170,2015,1,0,2,3,33.33333333333333
110170,2016,3,0,0,3,100.0
110170,2017,3,0,3,6,50.0
110170,2018,1,0,0,1,100.0
110170,2019,4,0,0,4,100.0
110170,2020,4,0,1,5,80.0
110175,2012,0,0,4,4,0.0
110175,2013,0,0,3,3,0.0
110175,2014,0,0,1,1,0.0
110175,2016,5,0,0,5,100.0
110175,2017,3,0,0,3,100.0
110175,2018,1,0,0,1,100.0
110175,2019,3,0,0,3,100.0
110175,2020,4,0,0,4,100.0
110180,2013,0,0,2,2,0.0
110180,2014,0,0,3,3,0.0
110180,2015,1,0,1,2,50.0
110180,2016,0,0,4,4,0.0
110180,2018,2,0,0,2,100.0
110180,2019,4,0,0,4,100.0
110180,2020,2,0,0,2,100.0
120000,2020,0,0,1,1,0.0
120001,2012,2,0,0,2,100.0
120001,2013,1,0,0,1,100.0
120001,2014,1,0,0,1,100.0
120001,2015,1,0,0,1,100.0
120001,2016,3,0,0,3,100.0
120001,2017,6,0,0,6,100.0
120001,2018,7,0,0,7,100.0
120001,2019,5,0,0,5,100.0
120001,2020,3,0,0,3,100.0
120005,2012,3,0,0,3,100.0
120005,2013,1,0,1,2,50.0
120005,2014,1,0,0,1,100.0
120005,2016,3,0,0,3,100.0
120005,2017,5,0,0,5,100.0
120005,2018,4,0,0,4,100.0
120005,2019,3,0,0,3,100.0
120005,2020,3,0,0,3,100.0
120010,2012,6,0,0,6,100.0
120010,2013,6,0,0,6,100.0
120010,2014,11,0,0,11,100.0
120010,2015,6,0,0,6,100.0
120010,2016,6,0,0,6,100.0
120010,2017,6,0,0,6,100.0
120010,2018,7,0,0,7,100.0
120010,2019,9,0,0,9,100.0
120010,2020,12,0,0,12,100.0
120013,2012,1,0,0,1,100.0
120013,2013,4,0,0,4,100.0
120013,2014,4,0,0,4,100.0
120013,2015,4,0,0,4,100.0
120013,2016,2,0,0,2,100.0
120013,2017,3,0,0,3,100.0
120013,2018,2,0,0,2,100.0
120013,2019,4,0,1,5,80.0
120013,2020,3,0,0,3,100.0
120017,2012,3,0,0,3,100.0
120017,2013,1,0,0,1,100.0
120017,2014,4,0,0,4,100.0
120017,2015,4,0,0,4,100.0
120017,2016,3,0,0,3,100.0
120017,2017,2,0,0,2,100.0
120017,2018,4,0,0,4,100.0
120017,2019,1,0,0,1,100.0
120017,2020,4,0,0,4,100.0
120020,2012,20,0,3,23,86.95652173913044
120020,2013,19,0,4,23,82.6086956521739
120020,2014,24,0,0,24,100.0
120020,2015,24,0,0,24,100.0
120020,2016,26,0,0,26,100.0
120020,2017,27,0,0,27,100.0
120020,2018,22,0,0,22,100.0
120020,2019,31,0,0,31,100.0
120020,2020,23,0,0,23,100.0
120025,2012,7,0,0,7,100.0
120025,2013,2,0,0,2,100.0
120025,2014,3,0,0,3,100.0
120025,2015,3,0,0,3,100.0
120025,2016,4,0,0,4,100.0
120025,2017,5,0,0,5,100.0
120025,2018,7,0,0,7,100.0
120025,2019,4,0,0,4,100.0
120025,2020,10,0,0,10,100.0
120030,2012,6,0,1,7,85.71428571428571
120030,2013,4,0,7,11,36.36363636363637
120030,2014,9,0,0,9,100.0
120030,2015,10,0,0,10,100.0
120030,2016,13,0,0,13,100.0
120030,2017,11,0,0,11,100.0
120030,2018,7,0,0,7,100.0
120030,2019,8,0,0,8,100.0
120030,2020,12,0,0,12,100.0
120032,2012,2,0,0,2,100.0
120032,2013,1,0,0,1,100.0
120032,2014,2,0,0,2,100.0
120032,2015,2,0,0,2,100.0
120032,2016,2,0,0,2,100.0
120032,2017,1,0,0,1,100.0
120032,2018,3,0,0,3,100.0
120032,2019,1,0,0,1,100.0
120032,2020,0,0,1,1,0.0
120033,2012,1,0,0,1,100.0
120033,2013,7,0,1,8,87.5
120033,2014,7,0,0,7,100.0
120033,2015,3,0,0,3,100.0
120033,2016,3,0,0,3,100.0
120033,2017,4,0,0,4,100.0
120033,2018,8,0,0,8,100.0
120033,2019,10,0,0,10,100.0
120033,2020,2,0,4,6,33.33333333333333
120034,2012,2,0,0,2,100.0
120034,2014,3,0,0,3,100.0
120034,2015,2,0,0,2,100.0
120034,2016,1,0,0,1,100.0
120034,2017,5,0,0,5,100.0
120034,2018,1,0,0,1,100.0
120034,2019,5,0,0,5,100.0
120034,2020,5,0,0,5,100.0
120035,2012,6,0,0,6,100.0
120035,2013,3,0,0,3,100.0
120035,2014,2,0,0,2,100.0
120035,2015,4,0,0,4,100.0
120035,2016,3,0,0,3,100.0
120035,2017,5,0,0,5,100.0
120035,2018,3,0,0,3,100.0
120035,2019,3,0,2,5,60.0
120035,2020,2,0,1,3,66.66666666666666
120038,2012,5,0,1,6,83.33333333333334
120038,2013,8,0,0,8,100.0
120038,2014,6,0,0,6,100.0
120038,2015,5,0,0,5,100.0
120038,2016,8,0,0,8,100.0
120038,2017,1,0,0,1,100.0
120038,2018,5,0,0,5,100.0
120038,2019,2,0,0,2,100.0
120038,2020,5,0,0,5,100.0
120039,2012,1,0,1,2,50.0
120039,2014,1,0,0,1,100.0
120039,2016,3,0,0,3,100.0
120039,2018,4,0,0,4,100.0
120039,2019,2,0,1,3,66.66666666666666
120040,2012,141,0,2,143,98.6013986013986
120040,2013,119,1,4,124,96.7741935483871
120040,2014,126,0,5,131,96.18320610687023
120040,2015,112,1,8,121,93.38842975206612
120040,2016,105,0,2,107,98.13084112149532
120040,2017,145,0,7,152,95.39473684210526
120040,2018,144,0,5,149,96.64429530201343
120040,2019,120,1,10,131,92.36641221374046
120040,2020,120,2,62,184,66.30434782608695
120042,2012,3,0,0,3,100.0
120042,2013,1,0,1,2,50.0
120042,2014,6,0,0,6,100.0
120042,2015,3,0,0,3,100.0
120042,2016,5,0,0,5,100.0
120042,2018,3,0,0,3,100.0
120042,2019,6,0,1,7,85.71428571428571
120042,2020,4,0,0,4,100.0
120043,2012,1,0,1,2,50.0
120043,2013,1,0,0,1,100.0
120043,2014,3,0,0,3,100.0
120043,2015,4,0,0,4,100.0
120043,2016,2,0,0,2,100.0
120043,2017,2,0,0,2,100.0
120043,2018,2,0,0,2,100.0
120043,2019,1,0,0,1,100.0
120043,2020,4,0,0,4,100.0
120045,2012,4,0,0,4,100.0
120045,2013,7,0,0,7,100.0
120045,2014,3,0,0,3,100.0
120045,2015,11,0,0,11,100.0
120045,2016,8,0,0,8,100.0
120045,2017,3,0,0,3,100.0
120045,2018,10,0,0,10,100.0
120045,2019,10,0,0,10,100.0
120045,2020,6,0,0,6,100.0
120050,2012,14,0,0,14,100.0
120050,2013,11,0,0,11,100.0
120050,2014,8,0,1,9,88.88888888888889
120050,2015,9,0,0,9,100.0
120050,2016,12,0,0,12,100.0
120050,2017,10,0,0,10,100.0
120050,2018,15,0,0,15,100.0
120050,2019,15,0,0,15,100.0
120050,2020,8,0,4,12,66.66666666666666
120060,2012,13,0,2,15,86.66666666666667
120060,2013,7,0,5,12,58.333333333333336
120060,2014,14,0,0,14,100.0
120060,2015,14,0,0,14,100.0
120060,2016,15,0,0,15,100.0
120060,2017,13,0,0,13,100.0
120060,2018,18,0,0,18,100.0
120060,2019,17,0,0,17,100.0
120060,2020,5,0,0,5,100.0
120070,2012,4,0,0,4,100.0
120070,2013,4,0,4,8,50.0
120070,2014,2,0,0,2,100.0
120070,2015,4,0,0,4,100.0
120070,2016,7,0,0,7,100.0
120070,2017,5,0,0,5,100.0
120070,2018,5,0,0,5,100.0
120070,2019,4,0,0,4,100.0
120070,2020,4,0,0,4,100.0
120080,2012,4,0,0,4,100.0
120080,2013,2,0,5,7,28.57142857142857
120080,2014,4,0,0,4,100.0
120080,2015,3,0,0,3,100.0
120080,2016,7,0,0,7,100.0
120080,2017,2,0,0,2,100.0
120080,2018,9,0,0,9,100.0
120080,2019,8,0,0,8,100.0
120080,2020,6,0,0,6,100.0
130000,2012,0,1,0,1,100.0
130000,2019,0,0,1,1,0.0
130002,2012,0,2,1,3,66.66666666666666
130002,2013,2,2,2,6,66.66666666666666
130002,2014,3,0,0,3,100.0
130002,2015,4,0,0,4,100.0
130002,2016,4,0,1,5,80.0
130002,2017,5,0,0,5,100.0
130002,2018,2,0,0,2,100.0
130002,2019,3,0,0,3,100.0
130002,2020,7,0,0,7,100.0
130006,2012,4,0,0,4,100.0
130006,2013,2,0,0,2,100.0
130006,2014,2,0,0,2,100.0
130006,2015,1,0,0,1,100.0
130006,2016,1,0,1,2,50.0
130006,2017,1,0,1,2,50.0
130006,2018,1,0,0,1,100.0
130006,2019,1,0,0,1,100.0
130006,2020,2,0,0,2,100.0
130008,2012,0,0,2,2,0.0
130008,2014,2,1,0,3,100.0
130008,2015,0,0,2,2,0.0
130008,2016,4,0,0,4,100.0
130008,2017,4,0,1,5,80.0
130008,2019,1,0,1,2,50.0
130010,2012,2,0,0,2,100.0
130010,2014,2,0,0,2,100.0
130010,2015,3,0,0,3,100.0
130010,2016,1,0,0,1,100.0
130010,2017,4,0,0,4,100.0
130010,2018,3,0,0,3,100.0
130010,2020,3,0,0,3,100.0
130014,2012,2,0,0,2,100.0
130014,2013,4,0,0,4,100.0
130014,2014,6,0,0,6,100.0
130014,2015,7,0,0,7,100.0
130014,2016,1,0,0,1,100.0
130014,2017,3,0,0,3,100.0
130014,2018,6,0,0,6,100.0
130014,2019,3,0,0,3,100.0
130014,2020,3,0,0,3,100.0
130020,2012,1,0,7,8,12.5
130020,2013,1,1,2,4,50.0
130020,2014,5,1,3,9,66.66666666666666
130020,2015,6,0,1,7,85.71428571428571
130020,2016,8,0,0,8,100.0
130020,2017,7,0,0,7,100.0
130020,2018,2,0,3,5,40.0
130020,2019,0,0,4,4,0.0
130020,2020,5,0,1,6,83.33333333333334
130030,2012,3,0,0,3,100.0
130030,2013,2,1,5,8,37.5
130030,2014,10,0,0,10,100.0
130030,2015,10,0,0,10,100.0
130030,2016,9,0,0,9,100.0
130030,2017,4,0,8,12,33.33333333333333
130030,2018,12,0,0,12,100.0
130030,2019,8,0,0,8,100.0
130030,2020,11,0,0,11,100.0
130040,2012,0,0,7,7,0.0
130040,2013,1,0,2,3,33.33333333333333
130040,2014,0,0,2,2,0.0
130040,2015,2,0,1,3,66.66666666666666
130040,2016,10,0,1,11,90.9090909090909
130040,2017,2,0,3,5,40.0
130040,2018,1,0,4,5,20.0
130040,2019,2,0,2,4,50.0
130040,2020,3,0,4,7,42.857142857142854
130050,2012,4,0,1,5,80.0
130050,2013,9,0,0,9,100.0
130050,2014,10,0,0,10,100.0
130050,2015,5,0,0,5,100.0
130050,2016,7,0,0,7,100.0
130050,2017,3,0,2,5,60.0
130050,2018,5,0,0,5,100.0
130050,2019,10,0,0,10,100.0
130050,2020,5,0,0,5,100.0
130060,2012,11,0,0,11,100.0
130060,2013,10,0,0,10,100.0
130060,2014,11,0,0,11,100.0
130060,2015,9,0,0,9,100.0
130060,2016,11,0,0,11,100.0
130060,2017,12,0,1,13,92.3076923076923
130060,2018,15,0,0,15,100.0
130060,2019,12,0,0,12,100.0
130060,2020,13,0,1,14,92.85714285714286
130063,2012,2,0,2,4,50.0
130063,2013,0,2,1,3,66.66666666666666
130063,2014,1,1,3,5,40.0
130063,2015,1,0,1,2,50.0
130063,2016,5,0,0,5,100.0
130063,2017,2,0,1,3,66.66666666666666
130063,2018,2,0,1,3,66.66666666666666
130063,2019,3,0,3,6,50.0
130063,2020,6,0,0,6,100.0
130068,2012,1,0,3,4,25.0
130068,2013,0,0,1,1,0.0
130068,2014,3,0,0,3,100.0
130068,2015,3,0,0,3,100.0
130068,2016,7,0,0,7,100.0
130068,2017,3,0,0,3,100.0
130068,2018,3,0,0,3,100.0
130068,2019,3,0,0,3,100.0
130068,2020,3,0,0,3,100.0
130070,2012,3,0,0,3,100.0
130070,2013,12,0,0,12,100.0
130070,2014,6,0,0,6,100.0
130070,2015,8,0,0,8,100.0
130070,2016,11,0,0,11,100.0
130070,2017,10,0,0,10,100.0
130070,2018,4,0,0,4,100.0
130070,2019,9,0,0,9,100.0
130070,2020,18,0,0,18,100.0
130080,2012,3,0,0,3,100.0
130080,2013,2,0,0,2,100.0
130080,2014,9,0,0,9,100.0
130080,2015,5,0,0,5,100.0
130080,2016,11,0,0,11,100.0
130080,2017,4,0,0,4,100.0
130080,2018,9,0,0,9,100.0
130080,2019,8,0,0,8,100.0
130080,2020,9,0,0,9,100.0
130083,2012,0,0,1,1,0.0
130083,2013,2,0,1,3,66.66666666666666
130083,2014,1,0,0,1,100.0
130083,2016,1,0,0,1,100.0
130083,2018,0,0,1,1,0.0
130083,2019,3,0,0,3,100.0
130083,2020,3,0,0,3,100.0
130090,2012,0,1,1,2,50.0
130090,2013,3,0,0,3,100.0
130090,2014,2,0,0,2,100.0
130090,2015,2,0,1,3,66.66666666666666
130090,2016,2,0,4,6,33.33333333333333
130090,2017,5,0,0,5,100.0
130090,2018,2,0,1,3,66.66666666666666
130090,2019,4,0,0,4,100.0
130090,2020,4,0,0,4,100.0
130100,2012,1,0,5,6,16.666666666666664
130100,2013,3,0,5,8,37.5
130100,2014,4,0,0,4,100.0
130100,2015,7,0,1,8,87.5
130100,2016,6,0,0,6,100.0
130100,2017,3,0,0,3,100.0
130100,2018,7,0,0,7,100.0
130100,2019,6,0,1,7,85.71428571428571
130100,2020,6,0,0,6,100.0
130110,2012,8,0,0,8,100.0
130110,2013,4,0,1,5,80.0
130110,2014,3,0,0,3,100.0
130110,2015,7,0,0,7,100.0
130110,2016,6,0,0,6,100.0
130110,2017,9,0,0,9,100.0
130110,2018,3,0,0,3,100.0
130110,2019,5,0,3,8,62.5
130110,2020,10,0,0,10,100.0
130115,2012,3,0,3,6,50.0
130115,2013,6,0,0,6,100.0
130115,2014,2,0,0,2,100.0
130115,2015,2,0,0,2,100.0
130115,2016,3,0,0,3,100.0
130115,2017,3,0,0,3,100.0
130115,2018,4,0,0,4,100.0
130115,2019,1,0,0,1,100.0
130115,2020,3,0,0,3,100.0
130120,2012,14,0,3,17,82.35294117647058
130120,2013,15,0,1,16,93.75
130120,2014,15,0,0,15,100.0
130120,2015,25,0,0,25,100.0
130120,2016,22,0,0,22,100.0
130120,2017,25,0,0,25,100.0
130120,2018,29,0,0,29,100.0
130120,2019,25,0,0,25,100.0
130120,2020,19,0,0,19,100.0
130130,2012,0,0,2,2,0.0
130130,2013,5,1,0,6,100.0
130130,2014,7,0,0,7,100.0
130130,2015,5,0,0,5,100.0
130130,2016,4,0,0,4,100.0
130130,2017,5,0,1,6,83.33333333333334
130130,2018,4,0,0,4,100.0
130130,2019,6,0,0,6,100.0
130130,2020,9,0,1,10,90.0
130140,2012,6,0,0,6,100.0
130140,2013,12,0,0,12,100.0
130140,2014,10,0,0,10,100.0
130140,2015,12,0,1,13,92.3076923076923
130140,2016,12,0,0,12,100.0
130140,2017,13,0,0,13,100.0
130140,2018,11,0,0,11,100.0
130140,2019,11,0,1,12,91.66666666666666
130140,2020,13,0,2,15,86.66666666666667
130150,2012,0,0,4,4,0.0
130150,2013,3,0,0,3,100.0
130150,2014,5,0,0,5,100.0
130150,2015,9,0,0,9,100.0
130150,2016,1,0,0,1,100.0
130150,2017,6,0,0,6,100.0
130150,2018,5,0,0,5,100.0
130150,2019,5,0,0,5,100.0
130150,2020,7,0,0,7,100.0
130160,2012,0,1,1,2,50.0
130160,2013,3,0,0,3,100.0
130160,2014,5,0,0,5,100.0
130160,2015,5,0,0,5,100.0
130160,2016,3,0,0,3,100.0
130160,2017,12,0,0,12,100.0
130160,2018,6,0,0,6,100.0
130160,2019,7,0,0,7,100.0
130160,2020,15,0,2,17,88.23529411764706
130165,2012,5,0,0,5,100.0
130165,2013,2,0,0,2,100.0
130165,2014,0,0,1,1,0.0
130165,2015,2,0,0,2,100.0
130165,2016,4,0,0,4,100.0
130165,2017,2,0,0,2,100.0
130165,2018,5,0,0,5,100.0
130165,2019,4,0,0,4,100.0
130165,2020,2,0,0,2,100.0
130170,2012,19,0,0,19,100.0
130170,2013,12,0,0,12,100.0
130170,2014,9,0,0,9,100.0
130170,2015,10,0,0,10,100.0
130170,2016,13,0,0,13,100.0
130170,2017,12,0,0,12,100.0
130170,2018,11,0,0,11,100.0
130170,2019,10,0,0,10,100.0
130170,2020,20,0,0,20,100.0
130180,2012,0,0,4,4,0.0
130180,2013,0,0,3,3,0.0
130180,2014,3,0,1,4,75.0
130180,2015,5,0,0,5,100.0
130180,2016,0,0,7,7,0.0
130180,2017,6,0,0,6,100.0
130180,2018,3,0,1,4,75.0
130180,2019,1,0,2,3,33.33333333333333
130180,2020,0,0,1,1,0.0
130185,2012,10,0,5,15,66.66666666666666
130185,2013,7,1,6,14,57.14285714285714
130185,2014,12,0,5,17,70.58823529411765
130185,2015,27,0,0,27,100.0
130185,2016,13,0,0,13,100.0
130185,2017,9,0,2,11,81.81818181818183
130185,2018,15,0,0,15,100.0
130185,2019,13,0,1,14,92.85714285714286
130185,2020,21,0,0,21,100.0
130190,2012,29,0,4,33,87.87878787878788
130190,2013,23,0,0,23,100.0
130190,2014,28,0,0,28,100.0
130190,2015,26,0,1,27,96.29629629629629
130190,2016,19,0,0,19,100.0
130190,2017,29,0,0,29,100.0
130190,2018,34,0,0,34,100.0
130190,2019,34,0,0,34,100.0
130190,2020,33,0,5,38,86.8421052631579
130195,2012,0,0,3,3,0.0
130195,2013,0,1,0,1,100.0
130195,2014,1,0,2,3,33.33333333333333
130195,2015,0,0,2,2,0.0
130195,2017,2,0,1,3,66.66666666666666
130195,2018,0,0,3,3,0.0
130195,2019,1,0,1,2,50.0
130195,2020,3,0,1,4,75.0
130200,2013,2,0,0,2,100.0
130200,2014,3,0,0,3,100.0
130200,2015,5,0,0,5,100.0
130200,2016,4,0,0,4,100.0
130200,2017,2,0,0,2,100.0
130200,2018,3,0,0,3,100.0
130200,2019,1,0,0,1,100.0
130200,2020,5,0,0,5,100.0
130210,2012,1,0,1,2,50.0
130210,2014,3,0,0,3,100.0
130210,2015,1,0,0,1,100.0
130210,2016,2,0,0,2,100.0
130210,2017,1,0,0,1,100.0
130210,2019,3,0,0,3,100.0
130220,2012,1,0,2,3,33.33333333333333
130220,2013,1,1,0,2,100.0
130220,2014,1,0,0,1,100.0
130220,2015,2,0,1,3,66.66666666666666
130220,2016,3,0,0,3,100.0
130220,2017,1,0,0,1,100.0
130220,2018,2,0,0,2,100.0
130220,2019,4,0,0,4,100.0
130220,2020,5,0,0,5,100.0
130230,2012,0,0,4,4,0.0
130230,2013,9,0,0,9,100.0
130230,2014,7,0,0,7,100.0
130230,2015,5,0,0,5,100.0
130230,2016,5,0,0,5,100.0
130230,2017,4,0,0,4,100.0
130230,2018,3,0,0,3,100.0
130230,2019,2,0,0,2,100.0
130230,2020,4,0,0,4,100.0
130240,2012,5,0,0,5,100.0
130240,2013,10,0,0,10,100.0
130240,2014,14,0,0,14,100.0
130240,2015,10,0,0,10,100.0
130240,2016,9,0,0,9,100.0
130240,2017,4,0,0,4,100.0
130240,2018,10,0,0,10,100.0
130240,2019,15,0,0,15,100.0
130240,2020,10,0,0,10,100.0
130250,2012,27,1,3,31,90.32258064516128
130250,2013,17,0,1,18,94.44444444444444
130250,2014,23,0,0,23,100.0
130250,2015,27,0,0,27,100.0
130250,2016,26,0,0,26,100.0
130250,2017,32,0,0,32,100.0
130250,2018,33,0,1,34,97.05882352941177
130250,2019,24,0,0,24,100.0
130250,2020,39,0,0,39,100.0
130255,2012,1,0,0,1,100.0
130255,2013,4,0,0,4,100.0
130255,2014,2,0,0,2,100.0
130255,2015,3,0,0,3,100.0
130255,2016,3,0,0,3,100.0
130255,2018,2,0,0,2,100.0
130255,2019,6,0,0,6,100.0
130255,2020,10,1,0,11,100.0
130260,2012,479,1,249,729,65.84362139917695
130260,2013,531,16,237,784,69.7704081632653
130260,2014,592,8,266,866,69.28406466512702
130260,2015,541,1,260,802,67.58104738154613
130260,2016,577,2,226,805,71.92546583850931
130260,2017,603,7,160,770,79.22077922077922
130260,2018,662,7,162,831,80.50541516245488
130260,2019,657,7,179,843,78.76631079478055
130260,2020,797,15,177,989,82.10313447927199
130270,2012,1,0,7,8,12.5
130270,2013,2,2,3,7,57.14285714285714
130270,2014,4,0,1,5,80.0
130270,2015,5,0,1,6,83.33333333333334
130270,2016,13,0,1,14,92.85714285714286
130270,2017,5,0,0,5,100.0
130270,2018,12,0,0,12,100.0
130270,2019,7,0,0,7,100.0
130270,2020,8,0,0,8,100.0
130280,2012,0,0,1,1,0.0
130280,2013,1,0,0,1,100.0
130280,2014,1,0,0,1,100.0
130280,2015,2,0,0,2,100.0
130280,2016,1,0,0,1,100.0
130280,2017,1,0,0,1,100.0
130280,2018,4,0,0,4,100.0
130280,2019,2,0,0,2,100.0
130280,2020,3,0,0,3,100.0
130290,2012,13,0,1,14,92.85714285714286
130290,2013,5,1,0,6,100.0
130290,2014,14,0,0,14,100.0
130290,2015,14,0,0,14,100.0
130290,2016,8,0,0,8,100.0
130290,2017,18,0,0,18,100.0
130290,2018,16,0,0,16,100.0
130290,2019,15,0,0,15,100.0
130290,2020,14,0,0,14,100.0
130300,2012,0,0,5,5,0.0
130300,2013,1,0,0,1,100.0
130300,2014,3,0,1,4,75.0
130300,2015,2,0,0,2,100.0
130300,2016,3,1,1,5,80.0
130300,2017,1,0,2,3,33.33333333333333
130300,2018,0,4,2,6,66.66666666666666
130300,2019,4,0,0,4,100.0
130300,2020,5,0,0,5,100.0
130310,2012,4,0,0,4,100.0
130310,2013,2,0,0,2,100.0
130310,2014,4,0,0,4,100.0
130310,2015,8,0,0,8,100.0
130310,2016,8,0,0,8,100.0
130310,2017,9,0,0,9,100.0
130310,2018,9,0,0,9,100.0
130310,2019,3,0,0,3,100.0
130310,2020,10,0,2,12,83.33333333333334
130320,2012,0,0,3,3,0.0
130320,2013,2,0,1,3,66.66666666666666
130320,2014,0,2,3,5,40.0
130320,2015,1,0,0,1,100.0
130320,2016,2,0,0,2,100.0
130320,2017,7,0,0,7,100.0
130320,2018,3,0,0,3,100.0
130320,2019,1,0,2,3,33.33333333333333
130320,2020,6,0,0,6,100.0
130330,2012,5,0,0,5,100.0
130330,2013,1,0,0,1,100.0
130330,2014,1,0,0,1,100.0
130330,2015,4,0,0,4,100.0
130330,2016,6,0,0,6,100.0
130330,2017,3,0,0,3,100.0
130330,2018,9,0,0,9,100.0
130330,2019,5,0,0,5,100.0
130330,2020,5,0,0,5,100.0
130340,2012,15,0,0,15,100.0
130340,2013,28,0,0,28,100.0
130340,2014,27,0,0,27,100.0
130340,2015,26,0,1,27,96.29629629629629
130340,2016,17,0,0,17,100.0
130340,2017,29,0,0,29,100.0
130340,2018,23,0,0,23,100.0
130340,2019,28,0,0,28,100.0
130340,2020,21,0,1,22,95.45454545454545
130350,2012,2,0,1,3,66.66666666666666
130350,2013,5,0,0,5,100.0
130350,2014,3,0,0,3,100.0
130350,2015,4,0,0,4,100.0
130350,2016,2,0,0,2,100.0
130350,2017,5,0,0,5,100.0
130350,2018,4,0,0,4,100.0
130350,2019,4,0,0,4,100.0
130350,2020,4,0,0,4,100.0
130353,2012,5,0,0,5,100.0
130353,2013,13,0,0,13,100.0
130353,2014,9,0,0,9,100.0
130353,2015,3,0,0,3,100.0
130353,2016,8,0,0,8,100.0
130353,2017,10,0,0,10,100.0
130353,2018,7,0,0,7,100.0
130353,2019,11,0,0,11,100.0
130353,2020,13,0,0,13,100.0
130356,2012,2,0,7,9,22.22222222222222
130356,2013,4,0,0,4,100.0
130356,2014,5,0,0,5,100.0
130356,2015,7,0,0,7,100.0
130356,2016,7,0,0,7,100.0
130356,2017,6,0,0,6,100.0
130356,2018,9,0,0,9,100.0
130356,2019,9,0,0,9,100.0
130356,2020,4,0,1,5,80.0
130360,2012,0,0,2,2,0.0
130360,2013,1,1,2,4,50.0
130360,2014,0,1,0,1,100.0
130360,2015,1,0,2,3,33.33333333333333
130360,2016,0,0,2,2,0.0
130360,2018,1,1,0,2,100.0
130360,2019,1,0,2,3,33.33333333333333
130360,2020,0,1,2,3,33.33333333333333
130370,2012,2,0,0,2,100.0
130370,2013,8,1,0,9,100.0
130370,2014,3,0,0,3,100.0
130370,2015,3,1,0,4,100.0
130370,2016,7,0,2,9,77.77777777777779
130370,2017,4,0,1,5,80.0
130370,2018,3,0,0,3,100.0
130370,2019,8,0,0,8,100.0
130370,2020,14,0,0,14,100.0
130380,2012,18,0,3,21,85.71428571428571
130380,2013,18,1,0,19,100.0
130380,2014,16,1,2,19,89.47368421052632
130380,2015,15,0,1,16,93.75
130380,2016,16,1,0,17,100.0
130380,2017,19,1,1,21,95.23809523809523
130380,2018,20,0,0,20,100.0
130380,2019,14,1,2,17,88.23529411764706
130380,2020,19,4,10,33,69.6969696969697
130390,2012,8,0,0,8,100.0
130390,2013,8,0,0,8,100.0
130390,2014,6,0,0,6,100.0
130390,2015,7,0,0,7,100.0
130390,2016,3,1,2,6,66.66666666666666
130390,2017,7,0,2,9,77.77777777777779
130390,2018,8,0,1,9,88.88888888888889
130390,2019,5,0,5,10,50.0
130390,2020,12,0,6,18,66.66666666666666
130395,2012,2,0,0,2,100.0
130395,2013,1,0,0,1,100.0
130395,2014,1,0,0,1,100.0
130395,2015,2,1,0,3,100.0
130395,2016,0,3,0,3,100.0
130395,2017,0,3,0,3,100.0
130395,2019,0,1,0,1,100.0
130395,2020,2,0,0,2,100.0
130400,2014,2,0,0,2,100.0
130400,2015,1,0,0,1,100.0
130400,2016,2,0,0,2,100.0
130400,2018,1,0,0,1,100.0
130400,2019,2,0,0,2,100.0
130400,2020,1,0,0,1,100.0
130406,2012,16,0,4,20,80.0
130406,2013,21,0,1,22,95.45454545454545
130406,2014,23,0,1,24,95.83333333333334
130406,2015,11,0,2,13,84.61538461538461
130406,2016,23,0,0,23,100.0
130406,2017,23,0,0,23,100.0
130406,2018,16,0,0,16,100.0
130406,2019,26,0,1,27,96.29629629629629
130406,2020,27,0,0,27,100.0
130410,2012,3,0,6,9,33.33333333333333
130410,2013,0,0,3,3,0.0
130410,2014,7,0,3,10,70.0
130410,2015,4,0,2,6,66.66666666666666
130410,2016,5,0,0,5,100.0
130410,2017,5,0,0,5,100.0
130410,2018,2,0,0,2,100.0
130410,2019,1,0,0,1,100.0
130410,2020,2,0,4,6,33.33333333333333
130420,2012,13,0,3,16,81.25
130420,2013,7,0,1,8,87.5
130420,2014,15,0,0,15,100.0
130420,2015,15,0,0,15,100.0
130420,2016,20,0,0,20,100.0
130420,2017,20,0,0,20,100.0
130420,2018,19,0,0,19,100.0
130420,2019,31,0,0,31,100.0
130420,2020,25,0,0,25,100.0
130423,2012,0,0,2,2,0.0
130423,2013,1,0,3,4,25.0
130423,2014,0,0,1,1,0.0
130423,2015,0,0,2,2,0.0
130423,2016,1,1,4,6,33.33333333333333
130423,2017,0,0,1,1,0.0
130423,2018,3,0,0,3,100.0
130423,2019,1,0,4,5,20.0
130423,2020,2,0,5,7,28.57142857142857
130426,2012,0,0,4,4,0.0
130426,2013,2,0,0,2,100.0
130426,2014,2,0,0,2,100.0
130426,2016,2,0,0,2,100.0
130426,2017,2,0,0,2,100.0
130426,2018,3,0,0,3,100.0
130426,2019,0,0,2,2,0.0
130426,2020,1,0,4,5,20.0
130430,2012,2,0,0,2,100.0
130430,2013,3,0,0,3,100.0
130430,2014,2,0,0,2,100.0
130430,2015,1,0,0,1,100.0
130430,2016,1,0,0,1,100.0
130430,2017,1,0,0,1,100.0
130430,2018,6,0,0,6,100.0
130430,2019,4,0,0,4,100.0
130430,2020,2,0,0,2,100.0
130440,2012,0,1,0,1,100.0
130440,2013,4,0,0,4,100.0
130440,2014,4,0,0,4,100.0
130440,2015,2,0,0,2,100.0
130440,2016,1,0,0,1,100.0
130440,2017,3,0,0,3,100.0
130440,2018,4,0,0,4,100.0
130440,2019,2,0,0,2,100.0
140000,2014,0,0,1,1,0.0
140002,2012,1,4,1,6,83.33333333333334
140002,2013,3,2,1,6,83.33333333333334
140002,2014,2,0,0,2,100.0
140002,2015,7,0,0,7,100.0
140002,2016,5,0,1,6,83.33333333333334
140002,2017,5,0,0,5,100.0
140002,2018,1,0,0,1,100.0
140002,2019,6,0,2,8,75.0
140002,2020,8,0,1,9,88.88888888888889
140005,2012,8,0,5,13,61.53846153846154
140005,2013,5,3,3,11,72.72727272727273
140005,2014,6,0,0,6,100.0
140005,2015,6,0,1,7,85.71428571428571
140005,2016,14,0,4,18,77.77777777777779
140005,2017,12,0,1,13,92.3076923076923
140005,2018,14,0,0,14,100.0
140005,2019,7,0,3,10,70.0
140005,2020,14,0,2,16,87.5
140010,2012,102,0,0,102,100.0
140010,2013,115,1,6,122,95.08196721311475
140010,2014,87,1,5,93,94.6236559139785
140010,2015,106,0,0,106,100.0
140010,2016,87,0,5,92,94.56521739130434
140010,2017,106,1,12,119,89.91596638655463
140010,2018,143,1,7,151,95.36423841059603
140010,2019,149,1,13,163,92.02453987730061
140010,2020,112,22,46,180,74.44444444444444
140015,2012,5,0,1,6,83.33333333333334
140015,2013,4,0,1,5,80.0
140015,2014,8,0,0,8,100.0
140015,2015,4,0,0,4,100.0
140015,2016,2,0,0,2,100.0
140015,2017,4,0,0,4,100.0
140015,2018,10,0,0,10,100.0
140015,2019,5,0,0,5,100.0
140015,2020,7,0,0,7,100.0
140017,2012,6,0,0,6,100.0
140017,2013,1,0,0,1,100.0
140017,2014,5,0,0,5,100.0
140017,2015,8,0,0,8,100.0
140017,2016,1,0,0,1,100.0
140017,2017,5,0,0,5,100.0
140017,2018,4,0,0,4,100.0
140017,2019,5,0,0,5,100.0
140017,2020,12,0,0,12,100.0
140020,2012,2,0,0,2,100.0
140020,2013,3,2,1,6,83.33333333333334
140020,2014,8,0,0,8,100.0
140020,2015,8,0,0,8,100.0
140020,2016,9,0,0,9,100.0
140020,2017,8,0,0,8,100.0
140020,2018,8,0,0,8,100.0
140020,2019,11,0,0,11,100.0
140020,2020,8,0,0,8,100.0
140023,2012,4,1,0,5,100.0
140023,2013,1,0,0,1,100.0
140023,2014,2,0,0,2,100.0
140023,2015,1,0,0,1,100.0
140023,2016,3,0,0,3,100.0
140023,2017,4,0,0,4,100.0
140023,2018,3,0,0,3,100.0
140023,2019,1,0,0,1,100.0
140023,2020,3,0,0,3,100.0
140028,2012,1,0,1,2,50.0
140028,2013,3,0,1,4,75.0
140028,2014,2,0,0,2,100.0
140028,2015,1,0,0,1,100.0
140028,2016,4,0,1,5,80.0
140028,2017,1,0,0,1,100.0
140028,2018,8,0,0,8,100.0
140028,2019,0,0,1,1,0.0
140028,2020,3,0,0,3,100.0
140030,2013,6,1,1,8,87.5
140030,2014,3,0,0,3,100.0
140030,2015,4,0,0,4,100.0
140030,2016,5,1,0,6,100.0
140030,2017,4,0,0,4,100.0
140030,2018,5,0,0,5,100.0
140030,2019,10,0,0,10,100.0
140030,2020,13,0,0,13,100.0
140040,2012,0,0,1,1,0.0
140040,2013,1,0,0,1,100.0
140040,2014,2,0,0,2,100.0
140040,2015,3,0,0,3,100.0
140040,2016,5,0,1,6,83.33333333333334
140040,2017,5,0,0,5,100.0
140040,2018,6,0,0,6,100.0
140040,2019,1,0,0,1,100.0
140040,2020,9,0,0,9,100.0
140045,2012,1,0,0,1,100.0
140045,2014,1,0,0,1,100.0
140045,2015,1,0,0,1,100.0
140045,2016,3,0,0,3,100.0
140045,2017,5,0,0,5,100.0
140045,2018,2,0,0,2,100.0
140045,2019,8,0,0,8,100.0
140045,2020,3,0,0,3,100.0
140047,2012,6,0,0,6,100.0
140047,2013,8,0,0,8,100.0
140047,2014,2,0,0,2,100.0
140047,2015,5,0,0,5,100.0
140047,2016,6,0,0,6,100.0
140047,2017,19,0,0,19,100.0
140047,2018,8,0,0,8,100.0
140047,2019,12,0,1,13,92.3076923076923
140047,2020,13,0,1,14,92.85714285714286
140050,2012,3,0,0,3,100.0
140050,2013,3,0,0,3,100.0
140050,2014,3,0,0,3,100.0
140050,2015,3,0,0,3,100.0
140050,2016,1,0,0,1,100.0
140050,2018,1,0,0,1,100.0
140050,2019,3,0,0,3,100.0
140060,2013,2,0,1,3,66.66666666666666
140060,2014,1,0,0,1,100.0
140060,2016,2,0,0,2,100.0
140060,2018,1,0,0,1,100.0
140060,2019,1,0,0,1,100.0
140060,2020,1,0,0,1,100.0
140070,2012,1,0,0,1,100.0
140070,2013,1,0,1,2,50.0
140070,2014,3,0,0,3,100.0
140070,2015,1,0,0,1,100.0
140070,2016,8,0,0,8,100.0
140070,2017,4,0,0,4,100.0
140070,2018,8,0,0,8,100.0
140070,2019,4,0,2,6,66.66666666666666
140070,2020,6,0,0,6,100.0
150000,2012,2,0,1,3,66.66666666666666
150000,2013,0,0,1,1,0.0
150000,2019,1,0,0,1,100.0
150000,2020,0,1,0,1,100.0
150010,2012,25,0,8,33,75.75757575757575
150010,2013,39,0,8,47,82.97872340425532
150010,2014,27,0,3,30,90.0
150010,2015,16,0,27,43,37.2093023255814
150010,2016,23,0,20,43,53.48837209302325
150010,2017,17,0,26,43,39.53488372093023
150010,2018,34,1,24,59,59.32203389830508
150010,2019,37,0,12,49,75.51020408163265
150010,2020,43,2,12,57,78.94736842105263
150013,2012,6,0,0,6,100.0
150013,2013,7,0,0,7,100.0
150013,2014,1,0,0,1,100.0
150013,2015,4,0,0,4,100.0
150013,2016,5,0,0,5,100.0
150013,2017,3,0,0,3,100.0
150013,2018,3,0,0,3,100.0
150013,2019,5,0,0,5,100.0
150013,2020,1,0,1,2,50.0
150020,2012,9,3,0,12,100.0
150020,2013,14,6,9,29,68.96551724137932
150020,2014,2,0,7,9,22.22222222222222
150020,2015,5,0,11,16,31.25
150020,2016,6,0,11,17,35.294117647058826
150020,2017,8,0,15,23,34.78260869565217
150020,2018,17,0,0,17,100.0
150020,2019,15,0,0,15,100.0
150020,2020,17,0,0,17,100.0
150030,2012,1,0,7,8,12.5
150030,2013,1,1,7,9,22.22222222222222
150030,2014,5,0,0,5,100.0
150030,2015,6,0,0,6,100.0
150030,2016,7,0,0,7,100.0
150030,2017,8,0,0,8,100.0
150030,2018,9,0,0,9,100.0
150030,2019,5,0,0,5,100.0
150030,2020,5,1,1,7,85.71428571428571
150034,2012,1,0,1,2,50.0
150034,2013,1,0,4,5,20.0
150034,2014,3,0,0,3,100.0
150034,2015,3,0,0,3,100.0
150034,2016,2,0,2,4,50.0
150034,2017,0,0,6,6,0.0
150034,2018,2,0,0,2,100.0
150034,2019,1,0,0,1,100.0
150034,2020,5,0,0,5,100.0
150040,2012,9,5,1,15,93.33333333333333
150040,2013,5,2,0,7,100.0
150040,2014,9,2,0,11,100.0
150040,2015,13,0,0,13,100.0
150040,2016,10,5,0,15,100.0
150040,2017,12,0,1,13,92.3076923076923
150040,2018,14,0,1,15,93.33333333333333
150040,2019,10,0,2,12,83.33333333333334
150040,2020,9,0,0,9,100.0
150050,2012,3,0,0,3,100.0
150050,2013,3,0,0,3,100.0
150050,2014,5,0,0,5,100.0
150050,2015,5,0,0,5,100.0
150050,2016,6,0,0,6,100.0
150050,2017,7,0,0,7,100.0
150050,2018,5,0,0,5,100.0
150050,2019,7,0,0,7,100.0
150050,2020,12,0,1,13,92.3076923076923
150060,2012,44,0,0,44,100.0
150060,2013,52,0,0,52,100.0
150060,2014,49,0,0,49,100.0
150060,2015,50,0,0,50,100.0
150060,2016,47,0,0,47,100.0
150060,2017,45,0,0,45,100.0
150060,2018,43,0,0,43,100.0
150060,2019,51,0,0,51,100.0
150060,2020,61,0,0,61,100.0
150070,2012,3,0,7,10,30.0
150070,2013,0,0,5,5,0.0
150070,2014,1,0,4,5,20.0
150070,2015,0,0,7,7,0.0
150070,2016,0,0,2,2,0.0
150070,2017,1,0,1,2,50.0
150070,2018,2,0,7,9,22.22222222222222
150070,2019,2,0,7,9,22.22222222222222
150070,2020,6,1,4,11,63.63636363636363
150080,2012,144,1,57,202,71.78217821782178
150080,2013,176,2,3,181,98.34254143646409
150080,2014,138,3,35,176,80.11363636363636
150080,2015,189,0,1,190,99.47368421052632
150080,2016,201,1,2,204,99.01960784313727
150080,2017,168,1,23,192,88.02083333333334
150080,2018,184,1,18,203,91.13300492610837
150080,2019,158,2,12,172,93.02325581395348
150080,2020,178,7,33,218,84.86238532110092
150085,2012,6,0,2,8,75.0
150085,2013,7,1,1,9,88.88888888888889
150085,2014,5,0,0,5,100.0
150085,2015,8,0,0,8,100.0
150085,2016,8,0,0,8,100.0
150085,2017,8,0,0,8,100.0
150085,2018,5,0,0,5,100.0
150085,2019,13,0,0,13,100.0
150085,2020,7,0,0,7,100.0
150090,2012,7,0,0,7,100.0
150090,2013,11,1,1,13,92.3076923076923
150090,2014,20,0,1,21,95.23809523809523
150090,2015,17,0,0,17,100.0
150090,2016,12,0,0,12,100.0
150090,2017,13,0,0,13,100.0
150090,2018,14,0,0,14,100.0
150090,2019,15,0,0,15,100.0
150090,2020,13,0,0,13,100.0
150095,2012,7,0,1,8,87.5
150095,2013,4,0,0,4,100.0
150095,2014,9,0,0,9,100.0
150095,2015,6,0,0,6,100.0
150095,2016,3,0,0,3,100.0
150095,2017,8,0,0,8,100.0
150095,2018,4,0,0,4,100.0
150095,2019,4,0,0,4,100.0
150095,2020,9,1,0,10,100.0
150100,2012,1,0,0,1,100.0
150100,2013,1,1,0,2,100.0
150100,2014,1,3,0,4,100.0
150100,2016,1,0,1,2,50.0
150100,2017,1,2,2,5,60.0
150100,2018,0,1,4,5,20.0
150100,2019,0,1,1,2,50.0
150100,2020,1,0,1,2,50.0
150110,2012,1,0,4,5,20.0
150110,2013,1,0,3,4,25.0
150110,2014,0,0,3,3,0.0
150110,2015,1,0,4,5,20.0
150110,2016,1,0,2,3,33.33333333333333
150110,2017,0,0,3,3,0.0
150110,2018,2,0,2,4,50.0
150110,2019,0,2,1,3,66.66666666666666
150110,2020,7,0,0,7,100.0
150120,2012,8,0,1,9,88.88888888888889
150120,2013,5,1,0,6,100.0
150120,2014,11,0,0,11,100.0
150120,2015,13,0,0,13,100.0
150120,2016,8,0,0,8,100.0
150120,2017,10,0,0,10,100.0
150120,2018,12,0,0,12,100.0
150120,2019,6,0,0,6,100.0
150120,2020,9,0,1,10,90.0
150125,2013,1,0,0,1,100.0
150125,2014,1,0,0,1,100.0
150125,2015,2,0,0,2,100.0
150125,2018,1,0,0,1,100.0
150125,2019,4,0,0,4,100.0
150125,2020,2,0,0,2,100.0
150130,2012,20,0,8,28,71.42857142857143
150130,2013,22,0,6,28,78.57142857142857
150130,2014,36,1,4,41,90.2439024390244
150130,2015,35,1,5,41,87.8048780487805
150130,2016,34,0,0,34,100.0
150130,2017,47,0,2,49,95.91836734693877
150130,2018,32,0,0,32,100.0
150130,2019,41,0,0,41,100.0
150130,2020,62,0,0,62,100.0
150140,2012,452,8,226,686,67.05539358600583
150140,2013,454,5,98,557,82.40574506283662
150140,2014,517,6,40,563,92.89520426287744
150140,2015,530,2,58,590,90.16949152542372
150140,2016,540,3,33,576,94.27083333333334
150140,2017,512,3,38,553,93.12839059674502
150140,2018,441,4,135,580,76.72413793103449
150140,2019,493,13,79,585,86.4957264957265
150140,2020,609,18,63,690,90.8695652173913
150145,2012,4,1,0,5,100.0
150145,2013,3,1,0,4,100.0
150145,2014,0,4,0,4,100.0
150145,2015,0,4,3,7,57.14285714285714
150145,2016,0,5,1,6,83.33333333333334
150145,2017,1,1,1,3,66.66666666666666
150145,2018,2,6,6,14,57.14285714285714
150145,2019,0,0,3,3,0.0
150145,2020,1,1,7,9,22.22222222222222
150150,2012,19,0,0,19,100.0
150150,2013,24,1,0,25,100.0
150150,2014,17,0,0,17,100.0
150150,2015,26,0,0,26,100.0
150150,2016,20,0,1,21,95.23809523809523
150150,2017,29,0,0,29,100.0
150150,2018,18,3,0,21,100.0
150150,2019,15,0,2,17,88.23529411764706
150150,2020,16,4,5,25,80.0
150157,2012,11,0,0,11,100.0
150157,2013,4,0,0,4,100.0
150157,2014,2,0,0,2,100.0
150157,2015,1,0,2,3,33.33333333333333
150157,2016,5,0,0,5,100.0
150157,2017,6,0,1,7,85.71428571428571
150157,2018,5,0,1,6,83.33333333333334
150157,2019,4,0,0,4,100.0
150157,2020,5,0,0,5,100.0
150160,2012,2,0,0,2,100.0
150160,2013,3,0,0,3,100.0
150160,2014,3,0,0,3,100.0
150160,2015,5,0,0,5,100.0
150160,2017,5,0,0,5,100.0
150160,2018,4,0,0,4,100.0
150160,2019,5,0,1,6,83.33333333333334
150160,2020,0,1,1,2,50.0
150170,2012,36,0,8,44,81.81818181818183
150170,2013,31,0,6,37,83.78378378378379
150170,2014,30,0,9,39,76.92307692307693
150170,2015,38,0,0,38,100.0
150170,2016,42,0,1,43,97.67441860465115
150170,2017,51,0,1,52,98.07692307692307
150170,2018,43,0,0,43,100.0
150170,2019,47,0,0,47,100.0
150170,2020,42,1,0,43,100.0
150172,2012,7,0,0,7,100.0
150172,2013,4,0,0,4,100.0
150172,2014,6,0,0,6,100.0
150172,2015,8,0,0,8,100.0
150172,2016,4,0,0,4,100.0
150172,2017,9,0,0,9,100.0
150172,2018,6,0,0,6,100.0
150172,2019,5,0,0,5,100.0
150172,2020,7,0,0,7,100.0
150175,2012,1,0,0,1,100.0
150175,2014,2,0,0,2,100.0
150175,2016,1,4,2,7,71.42857142857143
150175,2017,0,0,2,2,0.0
150175,2018,1,0,0,1,100.0
150175,2020,0,0,2,2,0.0
150178,2012,4,1,6,11,45.45454545454545
150178,2013,13,0,1,14,92.85714285714286
150178,2014,9,0,0,9,100.0
150178,2015,4,0,6,10,40.0
150178,2016,9,0,5,14,64.28571428571429
150178,2017,12,0,0,12,100.0
150178,2018,16,0,0,16,100.0
150178,2019,16,0,0,16,100.0
150178,2020,18,1,0,19,100.0
150180,2012,3,0,26,29,10.344827586206897
150180,2013,18,2,4,24,83.33333333333334
150180,2014,8,0,8,16,50.0
150180,2015,11,0,13,24,45.83333333333333
150180,2016,10,0,14,24,41.66666666666667
150180,2017,26,2,2,30,93.33333333333333
150180,2018,20,0,3,23,86.95652173913044
150180,2019,23,0,3,26,88.46153846153845
150180,2020,26,4,3,33,90.9090909090909
150190,2012,4,0,1,5,80.0
150190,2013,7,0,1,8,87.5
150190,2014,12,0,1,13,92.3076923076923
150190,2015,10,0,1,11,90.9090909090909
150190,2016,11,0,1,12,91.66666666666666
150190,2017,13,0,0,13,100.0
150190,2018,5,0,0,5,100.0
150190,2019,8,0,0,8,100.0
150190,2020,13,0,1,14,92.85714285714286
150195,2012,1,2,3,6,50.0
150195,2013,0,3,1,4,75.0
150195,2014,2,2,2,6,66.66666666666666
150195,2015,2,1,1,4,75.0
150195,2016,2,0,3,5,40.0
150195,2017,0,2,2,4,50.0
150195,2018,9,0,0,9,100.0
150195,2019,11,0,0,11,100.0
150195,2020,1,0,1,2,50.0
150200,2012,1,0,6,7,14.285714285714285
150200,2013,1,1,0,2,100.0
150200,2014,0,0,2,2,0.0
150200,2015,0,0,4,4,0.0
150200,2016,0,0,6,6,0.0
150200,2017,0,0,3,3,0.0
150200,2018,2,0,5,7,28.57142857142857
150200,2019,0,0,5,5,0.0
150200,2020,9,0,0,9,100.0
150210,2012,20,0,0,20,100.0
150210,2013,24,0,0,24,100.0
150210,2014,25,0,2,27,92.5925925925926
150210,2015,15,0,8,23,65.21739130434783
150210,2016,33,0,6,39,84.61538461538461
150210,2017,45,0,0,45,100.0
150210,2018,37,0,0,37,100.0
150210,2019,26,0,0,26,100.0
150210,2020,38,0,0,38,100.0
150215,2012,8,0,7,15,53.333333333333336
150215,2013,8,0,0,8,100.0
150215,2014,11,0,0,11,100.0
150215,2015,14,0,0,14,100.0
150215,2016,9,0,0,9,100.0
150215,2017,15,0,0,15,100.0
150215,2018,7,0,0,7,100.0
150215,2019,15,0,0,15,100.0
150215,2020,19,0,0,19,100.0
150220,2012,14,1,7,22,68.18181818181817
150220,2013,9,1,6,16,62.5
150220,2014,22,0,1,23,95.65217391304348
150220,2015,16,0,2,18,88.88888888888889
150220,2016,19,1,10,30,66.66666666666666
150220,2017,23,0,4,27,85.18518518518519
150220,2018,21,0,3,24,87.5
150220,2019,19,0,0,19,100.0
150220,2020,31,0,0,31,100.0
150230,2012,7,0,1,8,87.5
150230,2013,21,0,0,21,100.0
150230,2014,15,0,0,15,100.0
150230,2015,10,0,0,10,100.0
150230,2016,19,0,0,19,100.0
150230,2017,23,0,0,23,100.0
150230,2018,19,0,0,19,100.0
150230,2019,14,0,0,14,100.0
150230,2020,13,0,0,13,100.0
150240,2012,55,0,10,65,84.61538461538461
150240,2013,66,0,4,70,94.28571428571428
150240,2014,70,1,6,77,92.20779220779221
150240,2015,45,0,9,54,83.33333333333334
150240,2016,54,1,5,60,91.66666666666666
150240,2017,65,0,3,68,95.58823529411765
150240,2018,74,0,0,74,100.0
150240,2019,91,0,0,91,100.0
150240,2020,61,0,0,61,100.0
150250,2012,1,0,3,4,25.0
150250,2013,5,0,0,5,100.0
150250,2014,1,0,0,1,100.0
150250,2015,1,0,0,1,100.0
150250,2017,2,0,0,2,100.0
150250,2018,5,0,0,5,100.0
150250,2019,6,0,1,7,85.71428571428571
150250,2020,2,0,0,2,100.0
150260,2012,2,0,1,3,66.66666666666666
150260,2013,3,0,0,3,100.0
150260,2014,1,0,0,1,100.0
150260,2015,5,0,0,5,100.0
150260,2016,0,0,1,1,0.0
150260,2017,1,0,0,1,100.0
150260,2018,3,0,1,4,75.0
150260,2019,4,0,0,4,100.0
150260,2020,4,1,0,5,100.0
150270,2012,17,0,0,17,100.0
150270,2013,15,0,0,15,100.0
150270,2014,23,0,0,23,100.0
150270,2015,15,0,0,15,100.0
150270,2016,15,0,0,15,100.0
150270,2017,13,0,0,13,100.0
150270,2018,12,0,0,12,100.0
150270,2019,15,0,0,15,100.0
150270,2020,15,0,0,15,100.0
150275,2012,3,0,5,8,37.5
150275,2013,4,1,8,13,38.46153846153847
150275,2014,2,0,5,7,28.57142857142857
150275,2015,5,0,1,6,83.33333333333334
150275,2016,3,0,12,15,20.0
150275,2017,2,0,4,6,33.33333333333333
150275,2018,4,0,0,4,100.0
150275,2019,11,0,0,11,100.0
150275,2020,8,0,0,8,100.0
150276,2012,4,0,2,6,66.66666666666666
150276,2013,3,0,1,4,75.0
150276,2014,8,0,0,8,100.0
150276,2015,3,0,0,3,100.0
150276,2016,2,0,0,2,100.0
150276,2017,2,0,0,2,100.0
150276,2018,2,0,0,2,100.0
150276,2019,5,0,0,5,100.0
150276,2020,5,0,0,5,100.0
150277,2012,10,0,1,11,90.9090909090909
150277,2013,8,0,1,9,88.88888888888889
150277,2014,4,0,0,4,100.0
150277,2015,11,0,0,11,100.0
150277,2016,9,0,0,9,100.0
150277,2017,5,0,0,5,100.0
150277,2018,10,0,0,10,100.0
150277,2019,3,0,0,3,100.0
150277,2020,5,0,0,5,100.0
150280,2012,2,0,2,4,50.0
150280,2013,4,1,2,7,71.42857142857143
150280,2014,1,0,3,4,25.0
150280,2015,1,0,3,4,25.0
150280,2016,2,0,5,7,28.57142857142857
150280,2017,3,0,5,8,37.5
150280,2018,2,0,5,7,28.57142857142857
150280,2019,13,0,3,16,81.25
150280,2020,2,1,2,5,60.0
150285,2012,0,2,1,3,66.66666666666666
150285,2013,1,1,0,2,100.0
150285,2014,1,0,0,1,100.0
150285,2015,0,4,0,4,100.0
150285,2016,1,0,1,2,50.0
150285,2017,2,0,0,2,100.0
150285,2018,5,0,0,5,100.0
150285,2019,4,0,0,4,100.0
150285,2020,2,0,1,3,66.66666666666666
150290,2012,5,0,3,8,62.5
150290,2013,5,1,6,12,50.0
150290,2014,14,0,1,15,93.33333333333333
150290,2015,11,0,3,14,78.57142857142857
150290,2016,11,0,0,11,100.0
150290,2017,10,0,0,10,100.0
150290,2018,17,0,0,17,100.0
150290,2019,15,0,1,16,93.75
150290,2020,13,0,0,13,100.0
150293,2012,15,0,0,15,100.0
150293,2013,11,0,0,11,100.0
150293,2014,13,1,0,14,100.0
150293,2015,16,0,1,17,94.11764705882352
150293,2016,15,0,1,16,93.75
150293,2017,14,0,0,14,100.0
150293,2018,13,0,0,13,100.0
150293,2019,13,0,0,13,100.0
150293,2020,15,2,2,19,89.47368421052632
150295,2012,10,0,3,13,76.92307692307693
150295,2013,5,0,2,7,71.42857142857143
150295,2014,0,0,9,9,0.0
150295,2015,9,0,0,9,100.0
150295,2016,9,0,0,9,100.0
150295,2017,18,0,0,18,100.0
150295,2018,7,0,0,7,100.0
150295,2019,14,0,0,14,100.0
150295,2020,15,0,0,15,100.0
150300,2012,2,0,0,2,100.0
150300,2014,0,1,1,2,50.0
150300,2015,1,0,0,1,100.0
150300,2016,0,0,2,2,0.0
150300,2017,1,0,1,2,50.0
150300,2018,0,1,0,1,100.0
150300,2019,2,0,1,3,66.66666666666666
150304,2012,3,0,0,3,100.0
150304,2013,6,0,1,7,85.71428571428571
150304,2014,9,0,0,9,100.0
150304,2015,5,0,0,5,100.0
150304,2016,1,3,3,7,57.14285714285714
150304,2017,6,0,1,7,85.71428571428571
150304,2018,3,0,0,3,100.0
150304,2019,8,0,0,8,100.0
150304,2020,8,0,0,8,100.0
150307,2012,9,1,1,11,90.9090909090909
150307,2013,7,1,0,8,100.0
150307,2014,8,0,0,8,100.0
150307,2015,9,0,0,9,100.0
150307,2016,9,1,1,11,90.9090909090909
150307,2017,8,0,0,8,100.0
150307,2018,8,0,0,8,100.0
150307,2019,3,0,0,3,100.0
150307,2020,6,0,0,6,100.0
150309,2012,6,0,2,8,75.0
150309,2013,13,0,0,13,100.0
150309,2014,12,0,0,12,100.0
150309,2015,15,0,1,16,93.75
150309,2016,4,0,5,9,44.44444444444444
150309,2017,11,0,1,12,91.66666666666666
150309,2018,5,0,2,7,71.42857142857143
150309,2019,10,0,3,13,76.92307692307693
150309,2020,7,0,5,12,58.333333333333336
150310,2012,4,0,2,6,66.66666666666666
150310,2013,2,0,1,3,66.66666666666666
150310,2014,0,0,4,4,0.0
150310,2015,1,1,1,3,66.66666666666666
150310,2016,1,0,2,3,33.33333333333333
150310,2017,0,1,4,5,20.0
150310,2018,0,0,3,3,0.0
150310,2019,0,1,5,6,16.666666666666664
150310,2020,0,2,4,6,33.33333333333333
150320,2012,8,0,1,9,88.88888888888889
150320,2013,7,0,0,7,100.0
150320,2014,15,0,0,15,100.0
150320,2015,10,0,0,10,100.0
150320,2016,8,0,2,10,80.0
150320,2017,13,0,0,13,100.0
150320,2018,7,0,0,7,100.0
150320,2019,10,0,0,10,100.0
150320,2020,9,0,0,9,100.0
150330,2012,9,1,9,19,52.63157894736842
150330,2013,4,1,13,18,27.77777777777778
150330,2014,13,0,6,19,68.42105263157895
150330,2015,5,0,6,11,45.45454545454545
150330,2016,13,0,9,22,59.09090909090909
150330,2017,10,0,7,17,58.82352941176471
150330,2018,21,0,4,25,84.0
150330,2019,7,0,2,9,77.77777777777779
150330,2020,14,0,2,16,87.5
150340,2012,3,2,0,5,100.0
150340,2013,6,0,0,6,100.0
150340,2014,3,0,0,3,100.0
150340,2016,2,0,0,2,100.0
150340,2017,2,0,0,2,100.0
150340,2018,3,0,0,3,100.0
150340,2019,6,0,0,6,100.0
150340,2020,3,0,0,3,100.0
150345,2012,9,0,0,9,100.0
150345,2013,8,0,0,8,100.0
150345,2014,7,0,0,7,100.0
150345,2015,11,0,0,11,100.0
150345,2016,7,0,0,7,100.0
150345,2017,11,0,0,11,100.0
150345,2018,11,1,0,12,100.0
150345,2019,5,1,0,6,100.0
150345,2020,0,2,12,14,14.285714285714285
150350,2012,12,0,0,12,100.0
150350,2013,9,0,0,9,100.0
150350,2014,14,0,0,14,100.0
150350,2015,9,0,0,9,100.0
150350,2016,6,0,0,6,100.0
150350,2017,8,0,0,8,100.0
150350,2018,13,0,0,13,100.0
150350,2019,7,0,0,7,100.0
150350,2020,13,0,0,13,100.0
150360,2012,40,0,0,40,100.0
150360,2013,45,0,0,45,100.0
150360,2014,37,0,0,37,100.0
150360,2015,43,0,0,43,100.0
150360,2016,37,0,0,37,100.0
150360,2017,41,0,0,41,100.0
150360,2018,26,0,0,26,100.0
150360,2019,43,0,0,43,100.0
150360,2020,50,0,0,50,100.0
150370,2012,14,0,0,14,100.0
150370,2013,16,0,0,16,100.0
150370,2014,19,1,0,20,100.0
150370,2015,10,0,1,11,90.9090909090909
150370,2016,18,2,0,20,100.0
150370,2017,9,0,1,10,90.0
150370,2018,16,0,0,16,100.0
150370,2019,11,0,0,11,100.0
150370,2020,13,0,1,14,92.85714285714286
150375,2012,3,0,1,4,75.0
150375,2013,2,0,0,2,100.0
150375,2014,9,1,0,10,100.0
150375,2016,2,0,0,2,100.0
150375,2017,4,0,0,4,100.0
150375,2018,6,0,0,6,100.0
150375,2019,7,0,1,8,87.5
150375,2020,7,0,0,7,100.0
150380,2012,15,2,6,23,73.91304347826086
150380,2013,7,3,4,14,71.42857142857143
150380,2014,11,2,6,19,68.42105263157895
150380,2015,8,1,3,12,75.0
150380,2016,20,1,2,23,91.30434782608695
150380,2017,24,0,1,25,96.0
150380,2018,17,0,0,17,100.0
150380,2019,23,0,1,24,95.83333333333334
150380,2020,23,0,0,23,100.0
150390,2012,2,1,0,3,100.0
150390,2013,2,1,0,3,100.0
150390,2014,1,2,3,6,50.0
150390,2015,12,0,0,12,100.0
150390,2016,9,0,0,9,100.0
150390,2017,10,0,1,11,90.9090909090909
150390,2018,6,0,2,8,75.0
150390,2019,11,0,0,11,100.0
150390,2020,19,0,0,19,100.0
150400,2012,3,0,0,3,100.0
150400,2013,3,0,0,3,100.0
150400,2014,9,0,0,9,100.0
150400,2015,4,0,0,4,100.0
150400,2016,0,0,1,1,0.0
150400,2017,4,0,5,9,44.44444444444444
150400,2018,7,0,0,7,100.0
150400,2019,2,0,0,2,100.0
150400,2020,4,0,0,4,100.0
150405,2012,11,0,0,11,100.0
150405,2013,18,0,0,18,100.0
150405,2014,15,0,0,15,100.0
150405,2015,13,0,0,13,100.0
150405,2016,10,0,0,10,100.0
150405,2017,8,0,0,8,100.0
150405,2018,11,0,0,11,100.0
150405,2019,14,0,0,14,100.0
150405,2020,15,0,5,20,75.0
150410,2012,2,1,3,6,50.0
150410,2013,1,0,0,1,100.0
150410,2014,2,0,0,2,100.0
150410,2015,3,0,0,3,100.0
150410,2016,3,0,0,3,100.0
150410,2017,1,0,0,1,100.0
150410,2018,1,0,0,1,100.0
150410,2019,1,0,0,1,100.0
150410,2020,4,0,0,4,100.0
150420,2012,61,1,23,85,72.94117647058823
150420,2013,88,1,13,102,87.25490196078431
150420,2014,86,7,4,97,95.87628865979381
150420,2015,63,3,14,80,82.5
150420,2016,73,3,19,95,80.0
150420,2017,63,3,25,91,72.52747252747253
150420,2018,76,7,5,88,94.31818181818183
150420,2019,83,7,3,93,96.7741935483871
150420,2020,118,5,0,123,100.0
150430,2012,4,0,1,5,80.0
150430,2013,3,0,0,3,100.0
150430,2014,5,0,1,6,83.33333333333334
150430,2015,3,0,1,4,75.0
150430,2016,6,0,0,6,100.0
150430,2017,11,0,0,11,100.0
150430,2018,9,0,0,9,100.0
150430,2019,4,0,0,4,100.0
150430,2020,11,0,0,11,100.0
150440,2012,2,1,0,3,100.0
150440,2013,9,0,0,9,100.0
150440,2014,2,0,4,6,33.33333333333333
150440,2015,6,0,2,8,75.0
150440,2016,5,0,0,5,100.0
150440,2017,15,0,0,15,100.0
150440,2018,8,0,0,8,100.0
150440,2019,7,0,0,7,100.0
150440,2020,4,0,0,4,100.0
150442,2012,34,0,4,38,89.47368421052632
150442,2013,41,0,2,43,95.34883720930233
150442,2014,41,0,0,41,100.0
150442,2015,38,0,0,38,100.0
150442,2016,36,0,13,49,73.46938775510205
150442,2017,25,4,13,42,69.04761904761905
150442,2018,33,4,16,53,69.81132075471697
150442,2019,21,1,16,38,57.89473684210527
150442,2020,45,0,8,53,84.90566037735849
150445,2012,2,0,4,6,33.33333333333333
150445,2013,4,0,0,4,100.0
150445,2014,7,0,0,7,100.0
150445,2015,7,0,0,7,100.0
150445,2016,8,0,0,8,100.0
150445,2017,5,0,0,5,100.0
150445,2018,4,0,0,4,100.0
150445,2019,9,0,0,9,100.0
150445,2020,10,0,1,11,90.9090909090909
150450,2012,1,0,1,2,50.0
150450,2013,5,0,0,5,100.0
150450,2014,5,0,0,5,100.0
150450,2015,1,0,3,4,25.0
150450,2016,5,0,4,9,55.55555555555556
150450,2017,3,0,1,4,75.0
150450,2018,4,0,0,4,100.0
150450,2019,10,1,0,11,100.0
150450,2020,5,0,1,6,83.33333333333334
150460,2012,5,0,0,5,100.0
150460,2013,4,0,0,4,100.0
150460,2014,5,0,0,5,100.0
150460,2015,9,0,0,9,100.0
150460,2016,11,0,0,11,100.0
150460,2017,10,0,0,10,100.0
150460,2018,4,0,0,4,100.0
150460,2019,7,0,0,7,100.0
150460,2020,10,0,0,10,100.0
150470,2012,13,0,5,18,72.22222222222221
150470,2013,13,0,5,18,72.22222222222221
150470,2014,16,0,0,16,100.0
150470,2015,16,2,5,23,78.26086956521739
150470,2016,20,1,1,22,95.45454545454545
150470,2017,16,0,0,16,100.0
150470,2018,7,1,21,29,27.586206896551722
150470,2019,10,1,5,16,68.75
150470,2020,2,3,24,29,17.24137931034483
150475,2014,1,0,0,1,100.0
150475,2015,7,0,0,7,100.0
150475,2016,6,0,0,6,100.0
150475,2017,8,0,0,8,100.0
150475,2018,3,0,0,3,100.0
150475,2019,6,0,0,6,100.0
150475,2020,9,0,0,9,100.0
150480,2012,8,0,0,8,100.0
150480,2013,4,3,3,10,70.0
150480,2014,1,7,8,16,50.0
150480,2015,11,2,3,16,81.25
150480,2016,10,1,1,12,91.66666666666666
150480,2017,13,1,1,15,93.33333333333333
150480,2018,15,0,0,15,100.0
150480,2019,19,0,0,19,100.0
150480,2020,11,0,1,12,91.66666666666666
150490,2012,6,0,2,8,75.0
150490,2013,9,0,0,9,100.0
150490,2014,5,0,0,5,100.0
150490,2015,4,0,0,4,100.0
150490,2016,5,0,0,5,100.0
150490,2017,6,0,0,6,100.0
150490,2018,9,0,0,9,100.0
150490,2019,5,0,0,5,100.0
150490,2020,8,0,0,8,100.0
150495,2012,4,0,2,6,66.66666666666666
150495,2013,3,4,1,8,87.5
150495,2014,7,0,0,7,100.0
150495,2015,2,0,0,2,100.0
150495,2016,10,0,1,11,90.9090909090909
150495,2017,8,0,0,8,100.0
150495,2018,5,0,0,5,100.0
150495,2019,7,0,0,7,100.0
150495,2020,5,2,0,7,100.0
150497,2012,3,1,2,6,66.66666666666666
150497,2013,1,0,3,4,25.0
150497,2014,2,0,0,2,100.0
150497,2015,2,0,5,7,28.57142857142857
150497,2016,2,0,0,2,100.0
150497,2017,4,0,0,4,100.0
150497,2018,3,0,0,3,100.0
150497,2019,3,0,2,5,60.0
150497,2020,2,0,1,3,66.66666666666666
150500,2012,7,0,0,7,100.0
150500,2013,5,0,0,5,100.0
150500,2014,0,2,1,3,66.66666666666666
150500,2015,4,0,0,4,100.0
150500,2016,1,2,2,5,60.0
150500,2017,0,0,2,2,0.0
150500,2018,0,1,4,5,20.0
150500,2019,1,0,0,1,100.0
150500,2020,1,0,0,1,100.0
150503,2012,9,1,1,11,90.9090909090909
150503,2013,5,1,6,12,50.0
150503,2014,11,1,3,15,80.0
150503,2015,16,0,2,18,88.88888888888889
150503,2016,8,0,0,8,100.0
150503,2017,10,1,1,12,91.66666666666666
150503,2018,9,0,1,10,90.0
150503,2019,19,0,0,19,100.0
150503,2020,7,0,0,7,100.0
150506,2012,9,0,1,10,90.0
150506,2013,16,1,0,17,100.0
150506,2014,16,0,0,16,100.0
150506,2015,16,0,0,16,100.0
150506,2016,16,0,0,16,100.0
150506,2017,20,0,0,20,100.0
150506,2018,25,0,0,25,100.0
150506,2019,17,0,0,17,100.0
150506,2020,19,0,0,19,100.0
150510,2012,10,1,2,13,84.61538461538461
150510,2013,8,0,0,8,100.0
150510,2014,14,0,0,14,100.0
150510,2015,4,0,0,4,100.0
150510,2016,10,1,0,11,100.0
150510,2017,8,0,2,10,80.0
150510,2018,13,0,2,15,86.66666666666667
150510,2019,11,0,1,12,91.66666666666666
150510,2020,17,0,0,17,100.0
150520,2012,4,0,0,4,100.0
150520,2013,9,0,0,9,100.0
150520,2014,5,0,1,6,83.33333333333334
150520,2015,9,0,0,9,100.0
150520,2016,7,0,0,7,100.0
150520,2017,11,0,0,11,100.0
150520,2018,6,0,0,6,100.0
150520,2019,12,0,0,12,100.0
150520,2020,4,0,0,4,100.0
150530,2012,7,3,3,13,76.92307692307693
150530,2013,11,0,1,12,91.66666666666666
150530,2014,18,0,0,18,100.0
150530,2015,18,1,1,20,95.0
150530,2016,12,0,0,12,100.0
150530,2017,13,0,0,13,100.0
150530,2018,22,0,0,22,100.0
150530,2019,9,0,0,9,100.0
150530,2020,20,0,0,20,100.0
150540,2012,1,0,1,2,50.0
150540,2013,4,0,1,5,80.0
150540,2014,8,0,1,9,88.88888888888889
150540,2015,5,0,0,5,100.0
150540,2016,5,0,0,5,100.0
150540,2017,1,0,0,1,100.0
150540,2018,4,0,0,4,100.0
150540,2019,5,0,0,5,100.0
150540,2020,6,0,0,6,100.0
150543,2012,7,1,8,16,50.0
150543,2013,9,0,6,15,60.0
150543,2014,8,0,0,8,100.0
150543,2015,9,0,0,9,100.0
150543,2016,5,0,0,5,100.0
150543,2017,9,0,1,10,90.0
150543,2018,12,0,2,14,85.71428571428571
150543,2019,8,0,0,8,100.0
150543,2020,10,0,0,10,100.0
150548,2012,9,0,0,9,100.0
150548,2013,11,0,0,11,100.0
150548,2014,7,0,0,7,100.0
150548,2015,9,0,0,9,100.0
150548,2016,21,0,0,21,100.0
150548,2017,17,0,0,17,100.0
150548,2018,8,0,0,8,100.0
150548,2019,15,0,0,15,100.0
150548,2020,16,0,0,16,100.0
150549,2012,0,1,3,4,25.0
150549,2013,0,0,1,1,0.0
150549,2014,1,1,2,4,50.0
150549,2015,0,0,1,1,0.0
150549,2016,1,0,0,1,100.0
150549,2017,1,0,0,1,100.0
150549,2018,0,0,1,1,0.0
150549,2019,0,0,1,1,0.0
150550,2012,35,0,0,35,100.0
150550,2013,38,0,0,38,100.0
150550,2014,38,0,0,38,100.0
150550,2015,37,0,0,37,100.0
150550,2016,29,0,0,29,100.0
150550,2017,49,0,0,49,100.0
150550,2018,39,0,0,39,100.0
150550,2019,40,0,0,40,100.0
150550,2020,42,0,0,42,100.0
150553,2012,57,1,6,64,90.625
150553,2013,74,0,1,75,98.66666666666667
150553,2014,60,0,1,61,98.36065573770492
150553,2015,67,1,1,69,98.55072463768117
150553,2016,47,3,4,54,92.5925925925926
150553,2017,69,1,2,72,97.22222222222221
150553,2018,72,2,4,78,94.87179487179486
150553,2019,51,0,7,58,87.93103448275862
150553,2020,75,2,6,83,92.7710843373494
150555,2012,1,0,0,1,100.0
150555,2013,3,0,0,3,100.0
150555,2014,4,0,0,4,100.0
150555,2015,2,0,0,2,100.0
150555,2016,2,1,0,3,100.0
150555,2017,0,0,3,3,0.0
150555,2018,1,0,2,3,33.33333333333333
150555,2019,1,0,0,1,100.0
150555,2020,1,0,0,1,100.0
150560,2012,1,0,4,5,20.0
150560,2013,0,0,1,1,0.0
150560,2014,1,0,0,1,100.0
150560,2015,3,0,0,3,100.0
150560,2016,2,0,0,2,100.0
150560,2017,5,0,0,5,100.0
150560,2018,4,0,0,4,100.0
150560,2019,3,0,0,3,100.0
150560,2020,2,0,1,3,66.66666666666666
150563,2012,7,0,0,7,100.0
150563,2013,2,0,0,2,100.0
150563,2014,2,0,0,2,100.0
150563,2015,1,0,0,1,100.0
150563,2016,5,0,0,5,100.0
150563,2017,3,0,0,3,100.0
150563,2018,2,0,0,2,100.0
150563,2019,4,0,0,4,100.0
150563,2020,4,0,0,4,100.0
150565,2012,4,1,0,5,100.0
150565,2013,5,0,0,5,100.0
150565,2014,4,0,0,4,100.0
150565,2015,6,0,0,6,100.0
150565,2016,3,0,0,3,100.0
150565,2018,4,0,0,4,100.0
150565,2019,5,0,0,5,100.0
150565,2020,3,0,0,3,100.0
150570,2012,8,0,0,8,100.0
150570,2013,2,0,0,2,100.0
150570,2014,5,0,0,5,100.0
150570,2015,3,0,0,3,100.0
150570,2016,13,0,0,13,100.0
150570,2017,7,0,0,7,100.0
150570,2018,10,0,0,10,100.0
150570,2019,8,0,0,8,100.0
150570,2020,6,0,0,6,100.0
150580,2012,14,0,0,14,100.0
150580,2013,7,0,0,7,100.0
150580,2014,16,0,0,16,100.0
150580,2015,10,0,0,10,100.0
150580,2016,14,0,0,14,100.0
150580,2017,17,0,0,17,100.0
150580,2018,14,0,0,14,100.0
150580,2019,14,0,0,14,100.0
150580,2020,18,0,0,18,100.0
150590,2012,9,0,0,9,100.0
150590,2013,7,0,1,8,87.5
150590,2014,7,0,0,7,100.0
150590,2015,9,0,0,9,100.0
150590,2016,3,0,0,3,100.0
150590,2017,16,0,0,16,100.0
150590,2018,7,0,0,7,100.0
150590,2019,11,0,0,11,100.0
150590,2020,10,0,0,10,100.0
150600,2012,5,3,0,8,100.0
150600,2013,9,0,0,9,100.0
150600,2014,7,0,0,7,100.0
150600,2015,7,0,0,7,100.0
150600,2016,8,2,0,10,100.0
150600,2017,8,0,1,9,88.88888888888889
150600,2018,8,0,0,8,100.0
150600,2019,10,0,0,10,100.0
150600,2020,7,0,0,7,100.0
150610,2012,1,0,1,2,50.0
150610,2013,0,0,1,1,0.0
150610,2014,8,0,0,8,100.0
150610,2015,3,0,0,3,100.0
150610,2016,6,0,0,6,100.0
150610,2017,1,0,1,2,50.0
150610,2018,1,0,4,5,20.0
150610,2019,0,0,3,3,0.0
150610,2020,1,1,2,4,50.0
150611,2012,1,0,4,5,20.0
150611,2013,1,0,4,5,20.0
150611,2014,2,0,3,5,40.0
150611,2015,0,0,2,2,0.0
150611,2016,2,0,3,5,40.0
150611,2017,0,0,4,4,0.0
150611,2018,0,1,1,2,50.0
150611,2020,1,0,3,4,25.0
150613,2012,20,5,7,32,78.125
150613,2013,9,1,28,38,26.31578947368421
150613,2014,36,0,0,36,100.0
150613,2015,30,0,5,35,85.71428571428571
150613,2016,32,0,0,32,100.0
150613,2017,44,0,0,44,100.0
150613,2018,40,0,0,40,100.0
150613,2019,36,0,0,36,100.0
150613,2020,47,0,0,47,100.0
150616,2012,1,0,6,7,14.285714285714285
150616,2013,3,0,6,9,33.33333333333333
150616,2014,9,0,1,10,90.0
150616,2015,2,0,0,2,100.0
150616,2016,7,0,0,7,100.0
150616,2017,4,0,0,4,100.0
150616,2018,3,0,2,5,60.0
150616,2019,7,0,1,8,87.5
150616,2020,9,0,1,10,90.0
150618,2012,16,0,0,16,100.0
150618,2013,17,0,1,18,94.44444444444444
150618,2014,15,0,0,15,100.0
150618,2015,15,0,1,16,93.75
150618,2016,16,0,0,16,100.0
150618,2017,18,0,1,19,94.73684210526315
150618,2018,7,0,0,7,100.0
150618,2019,10,0,0,10,100.0
150618,2020,12,1,1,14,92.85714285714286
150619,2012,6,0,0,6,100.0
150619,2013,1,2,0,3,100.0
150619,2014,8,0,0,8,100.0
150619,2015,4,1,0,5,100.0
150619,2016,6,0,0,6,100.0
150619,2017,2,2,1,5,80.0
150619,2018,8,0,0,8,100.0
150619,2019,7,2,0,9,100.0
150619,2020,7,3,0,10,100.0
150620,2012,11,0,0,11,100.0
150620,2013,8,0,2,10,80.0
150620,2014,9,0,0,9,100.0
150620,2015,14,0,0,14,100.0
150620,2016,20,0,0,20,100.0
150620,2017,14,0,0,14,100.0
150620,2018,21,1,0,22,100.0
150620,2019,22,0,0,22,100.0
150620,2020,21,0,0,21,100.0
150630,2012,4,0,2,6,66.66666666666666
150630,2013,1,3,1,5,80.0
150630,2014,2,0,0,2,100.0
150630,2015,6,0,2,8,75.0
150630,2016,1,3,6,10,40.0
150630,2017,13,0,0,13,100.0
150630,2018,10,0,0,10,100.0
150630,2019,10,0,0,10,100.0
150630,2020,10,1,0,11,100.0
150635,2012,7,0,2,9,77.77777777777779
150635,2013,9,0,0,9,100.0
150635,2014,6,0,0,6,100.0
150635,2015,3,0,1,4,75.0
150635,2016,11,0,0,11,100.0
150635,2017,6,0,0,6,100.0
150635,2018,14,0,0,14,100.0
150635,2019,7,1,5,13,61.53846153846154
150635,2020,1,2,10,13,23.076923076923077
150640,2012,0,0,3,3,0.0
150640,2014,1,0,0,1,100.0
150640,2015,5,0,0,5,100.0
150640,2016,0,0,4,4,0.0
150640,2017,0,0,1,1,0.0
150640,2018,0,0,1,1,0.0
150640,2020,0,1,1,2,50.0
150650,2012,26,0,0,26,100.0
150650,2013,21,0,0,21,100.0
150650,2014,20,0,0,20,100.0
150650,2015,21,0,1,22,95.45454545454545
150650,2016,27,0,0,27,100.0
150650,2017,19,0,0,19,100.0
150650,2018,17,0,0,17,100.0
150650,2019,21,0,0,21,100.0
150650,2020,29,0,0,29,100.0
150655,2012,6,0,1,7,85.71428571428571
150655,2013,10,0,0,10,100.0
150655,2014,8,0,0,8,100.0
150655,2015,6,0,0,6,100.0
150655,2016,6,0,2,8,75.0
150655,2017,1,0,0,1,100.0
150655,2018,10,0,2,12,83.33333333333334
150655,2019,6,0,0,6,100.0
150655,2020,1,0,1,2,50.0
150658,2012,5,0,0,5,100.0
150658,2013,8,0,0,8,100.0
150658,2014,5,0,2,7,71.42857142857143
150658,2015,3,0,2,5,60.0
150658,2016,5,0,0,5,100.0
150658,2017,4,0,2,6,66.66666666666666
150658,2018,4,1,1,6,83.33333333333334
150658,2019,2,0,3,5,40.0
150658,2020,5,1,3,9,66.66666666666666
150660,2012,1,0,0,1,100.0
150660,2013,11,0,1,12,91.66666666666666
150660,2014,10,0,0,10,100.0
150660,2015,4,0,2,6,66.66666666666666
150660,2016,5,0,0,5,100.0
150660,2017,4,0,0,4,100.0
150660,2018,20,0,0,20,100.0
150660,2019,5,0,0,5,100.0
150660,2020,14,0,0,14,100.0
150670,2012,3,0,7,10,30.0
150670,2013,10,0,7,17,58.82352941176471
150670,2014,16,0,4,20,80.0
150670,2015,14,0,6,20,70.0
150670,2016,9,0,0,9,100.0
150670,2017,15,0,0,15,100.0
150670,2018,14,0,0,14,100.0
150670,2019,5,0,4,9,55.55555555555556
150670,2020,17,0,3,20,85.0
150680,2012,65,4,15,84,82.14285714285714
150680,2013,85,4,3,92,96.73913043478261
150680,2014,89,2,1,92,98.91304347826086
150680,2015,82,7,1,90,98.88888888888889
150680,2016,90,0,0,90,100.0
150680,2017,97,1,0,98,100.0
150680,2018,107,1,0,108,100.0
150680,2019,111,0,1,112,99.10714285714286
150680,2020,132,0,0,132,100.0
150690,2012,0,0,2,2,0.0
150690,2015,1,0,2,3,33.33333333333333
150690,2016,0,0,3,3,0.0
150690,2017,0,0,2,2,0.0
150690,2018,0,0,2,2,0.0
150690,2019,0,0,3,3,0.0
150700,2012,7,0,1,8,87.5
150700,2013,9,0,0,9,100.0
150700,2014,11,0,0,11,100.0
150700,2015,10,0,0,10,100.0
150700,2016,9,0,0,9,100.0
150700,2017,10,0,0,10,100.0
150700,2018,9,0,0,9,100.0
150700,2019,10,0,0,10,100.0
150700,2020,19,0,0,19,100.0
150710,2012,2,4,0,6,100.0
150710,2013,3,2,1,6,83.33333333333334
150710,2014,1,0,2,3,33.33333333333333
150710,2015,1,1,1,3,66.66666666666666
150710,2016,0,0,2,2,0.0
150710,2017,4,0,0,4,100.0
150710,2018,3,0,0,3,100.0
150710,2019,4,0,0,4,100.0
150710,2020,13,0,0,13,100.0
150715,2012,3,1,6,10,40.0
150715,2013,3,0,0,3,100.0
150715,2014,7,0,0,7,100.0
150715,2015,5,3,2,10,80.0
150715,2016,10,0,0,10,100.0
150715,2017,7,0,0,7,100.0
150715,2018,6,0,1,7,85.71428571428571
150715,2019,4,0,0,4,100.0
150715,2020,6,0,1,7,85.71428571428571
150720,2012,7,1,1,9,88.88888888888889
150720,2013,5,0,1,6,83.33333333333334
150720,2014,5,0,0,5,100.0
150720,2015,7,0,0,7,100.0
150720,2016,6,0,0,6,100.0
150720,2017,4,0,0,4,100.0
150720,2018,10,0,0,10,100.0
150720,2019,14,0,0,14,100.0
150720,2020,6,0,0,6,100.0
150730,2012,17,0,0,17,100.0
150730,2013,15,0,0,15,100.0
150730,2014,18,0,1,19,94.73684210526315
150730,2015,16,0,0,16,100.0
150730,2016,19,0,0,19,100.0
150730,2017,18,0,1,19,94.73684210526315
150730,2018,17,0,0,17,100.0
150730,2019,24,0,0,24,100.0
150730,2020,20,0,0,20,100.0
150740,2012,5,0,0,5,100.0
150740,2013,3,0,0,3,100.0
150740,2014,6,0,0,6,100.0
150740,2015,6,0,0,6,100.0
150740,2016,5,0,0,5,100.0
150740,2017,6,0,0,6,100.0
150740,2018,7,0,0,7,100.0
150740,2019,8,0,0,8,100.0
150740,2020,3,0,0,3,100.0
150745,2012,2,1,5,8,37.5
150745,2013,0,0,4,4,0.0
150745,2014,0,1,2,3,33.33333333333333
150745,2015,0,1,11,12,8.333333333333332
150745,2016,10,1,0,11,100.0
150745,2017,9,0,0,9,100.0
150745,2018,12,0,0,12,100.0
150745,2019,3,0,1,4,75.0
150745,2020,8,1,0,9,100.0
150746,2013,2,0,0,2,100.0
150746,2014,2,0,0,2,100.0
150746,2015,3,0,0,3,100.0
150746,2016,2,0,0,2,100.0
150746,2017,2,0,0,2,100.0
150746,2018,2,0,0,2,100.0
150746,2019,4,0,0,4,100.0
150746,2020,1,0,0,1,100.0
150747,2012,2,0,4,6,33.33333333333333
150747,2013,5,0,1,6,83.33333333333334
150747,2014,7,0,1,8,87.5
150747,2015,5,0,0,5,100.0
150747,2016,10,2,0,12,100.0
150747,2017,7,0,0,7,100.0
150747,2018,5,0,0,5,100.0
150747,2019,8,0,0,8,100.0
150747,2020,6,0,0,6,100.0
150750,2012,4,0,4,8,50.0
150750,2013,0,1,2,3,33.33333333333333
150750,2014,3,0,1,4,75.0
150750,2015,5,0,0,5,100.0
150750,2016,3,0,0,3,100.0
150750,2017,0,1,3,4,25.0
150750,2018,0,0,3,3,0.0
150750,2019,0,1,7,8,12.5
150750,2020,0,1,3,4,25.0
150760,2012,17,2,4,23,82.6086956521739
150760,2013,12,0,3,15,80.0
150760,2014,15,0,0,15,100.0
150760,2015,17,0,2,19,89.47368421052632
150760,2016,25,1,3,29,89.65517241379311
150760,2017,14,0,0,14,100.0
150760,2018,21,0,0,21,100.0
150760,2019,14,3,2,19,89.47368421052632
150760,2020,22,0,0,22,100.0
150770,2012,7,0,0,7,100.0
150770,2013,4,0,0,4,100.0
150770,2014,6,0,0,6,100.0
150770,2015,3,0,0,3,100.0
150770,2016,5,0,0,5,100.0
150770,2017,4,0,0,4,100.0
150770,2018,3,0,3,6,50.0
150770,2019,2,0,6,8,25.0
150770,2020,1,2,7,10,30.0
150775,2014,1,0,1,2,50.0
150775,2015,1,1,2,4,50.0
150775,2016,0,1,3,4,25.0
150775,2017,1,0,2,3,33.33333333333333
150775,2018,0,0,3,3,0.0
150775,2019,0,0,1,1,0.0
150775,2020,0,0,2,2,0.0
150780,2012,3,0,1,4,75.0
150780,2013,5,0,0,5,100.0
150780,2014,2,1,0,3,100.0
150780,2015,3,0,0,3,100.0
150780,2016,5,0,0,5,100.0
150780,2017,4,0,0,4,100.0
150780,2018,4,0,0,4,100.0
150780,2019,5,0,0,5,100.0
150780,2020,4,0,0,4,100.0
150790,2012,3,0,0,3,100.0
150790,2013,8,0,0,8,100.0
150790,2014,5,0,1,6,83.33333333333334
150790,2015,2,0,5,7,28.57142857142857
150790,2016,7,0,0,7,100.0
150790,2017,8,0,0,8,100.0
150790,2018,10,0,0,10,100.0
150790,2019,9,0,0,9,100.0
150790,2020,13,0,0,13,100.0
150795,2012,4,1,16,21,23.809523809523807
150795,2013,20,0,4,24,83.33333333333334
150795,2014,31,0,0,31,100.0
150795,2015,25,0,0,25,100.0
150795,2016,32,0,0,32,100.0
150795,2017,32,0,2,34,94.11764705882352
150795,2018,28,0,1,29,96.55172413793103
150795,2019,24,0,2,26,92.3076923076923
150795,2020,36,0,5,41,87.8048780487805
150796,2012,1,0,0,1,100.0
150796,2013,3,0,0,3,100.0
150796,2014,2,0,0,2,100.0
150796,2015,3,0,0,3,100.0
150796,2016,2,0,0,2,100.0
150796,2017,3,0,0,3,100.0
150796,2018,2,0,0,2,100.0
150796,2019,2,0,0,2,100.0
150796,2020,3,0,0,3,100.0
150797,2012,2,1,0,3,100.0
150797,2013,3,0,0,3,100.0
150797,2014,3,0,1,4,75.0
150797,2015,3,0,0,3,100.0
150797,2016,0,0,1,1,0.0
150797,2017,0,2,3,5,40.0
150797,2018,0,0,6,6,0.0
150797,2019,0,0,2,2,0.0
150797,2020,2,0,0,2,100.0
150800,2012,20,0,0,20,100.0
150800,2013,15,1,9,25,64.0
150800,2014,20,0,0,20,100.0
150800,2015,13,0,12,25,52.0
150800,2016,17,0,0,17,100.0
150800,2017,17,1,3,21,85.71428571428571
150800,2018,18,0,0,18,100.0
150800,2019,24,0,0,24,100.0
150800,2020,37,4,0,41,100.0
150803,2012,1,1,4,6,33.33333333333333
150803,2013,10,0,0,10,100.0
150803,2014,12,0,0,12,100.0
150803,2015,7,0,1,8,87.5
150803,2016,5,0,0,5,100.0
150803,2017,6,0,0,6,100.0
150803,2018,4,0,0,4,100.0
150803,2019,4,0,1,5,80.0
150803,2020,9,0,0,9,100.0
150805,2012,1,2,1,4,75.0
150805,2013,1,0,0,1,100.0
150805,2014,2,0,1,3,66.66666666666666
150805,2015,0,0,5,5,0.0
150805,2016,2,0,0,2,100.0
150805,2017,4,2,1,7,85.71428571428571
150805,2018,1,0,4,5,20.0
150805,2019,1,0,0,1,100.0
150805,2020,2,0,0,2,100.0
150808,2012,6,0,8,14,42.857142857142854
150808,2013,5,0,11,16,31.25
150808,2014,15,0,0,15,100.0
150808,2015,16,0,1,17,94.11764705882352
150808,2016,3,0,1,4,75.0
150808,2017,10,1,1,12,91.66666666666666
150808,2018,12,0,2,14,85.71428571428571
150808,2019,8,0,5,13,61.53846153846154
150808,2020,15,1,3,19,84.21052631578947
150810,2012,17,2,10,29,65.51724137931035
150810,2013,32,0,1,33,96.96969696969697
150810,2014,32,0,0,32,100.0
150810,2015,19,0,4,23,82.6086956521739
150810,2016,25,0,2,27,92.5925925925926
150810,2017,36,0,1,37,97.2972972972973
150810,2018,29,0,2,31,93.54838709677419
150810,2019,26,0,0,26,100.0
150810,2020,29,0,0,29,100.0
150812,2012,8,0,0,8,100.0
150812,2013,10,0,0,10,100.0
150812,2014,6,0,0,6,100.0
150812,2015,9,0,0,9,100.0
150812,2016,16,0,0,16,100.0
150812,2017,13,0,0,13,100.0
150812,2018,11,0,0,11,100.0
150812,2019,5,0,0,5,100.0
150812,2020,6,0,1,7,85.71428571428571
150815,2012,12,0,1,13,92.3076923076923
150815,2013,15,0,0,15,100.0
150815,2014,14,0,0,14,100.0
150815,2015,11,0,1,12,91.66666666666666
150815,2016,5,0,2,7,71.42857142857143
150815,2017,12,0,0,12,100.0
150815,2018,14,0,0,14,100.0
150815,2019,11,0,2,13,84.61538461538461
150815,2020,14,0,6,20,70.0
150820,2012,6,0,10,16,37.5
150820,2013,18,0,7,25,72.0
150820,2014,24,0,0,24,100.0
150820,2015,9,0,6,15,60.0
150820,2016,14,0,6,20,70.0
150820,2017,15,0,1,16,93.75
150820,2018,22,0,1,23,95.65217391304348
150820,2019,23,0,0,23,100.0
150820,2020,11,3,4,18,77.77777777777779
150830,2012,2,0,10,12,16.666666666666664
150830,2013,4,0,5,9,44.44444444444444
150830,2014,13,0,1,14,92.85714285714286
150830,2015,14,0,2,16,87.5
150830,2016,14,0,2,16,87.5
150830,2017,15,0,3,18,83.33333333333334
150830,2018,18,0,0,18,100.0
150830,2019,12,0,2,14,85.71428571428571
150830,2020,10,1,3,14,78.57142857142857
150835,2012,2,0,2,4,50.0
150835,2013,6,0,0,6,100.0
150835,2014,7,0,0,7,100.0
150835,2015,6,0,0,6,100.0
150835,2016,7,0,0,7,100.0
150835,2017,5,0,0,5,100.0
150835,2018,9,0,0,9,100.0
150835,2019,9,0,0,9,100.0
150835,2020,6,0,0,6,100.0
150840,2012,4,0,9,13,30.76923076923077
150840,2013,1,3,10,14,28.57142857142857
150840,2014,14,0,5,19,73.68421052631578
150840,2015,6,0,8,14,42.857142857142854
150840,2016,1,1,18,20,10.0
150840,2017,18,0,0,18,100.0
150840,2018,18,0,0,18,100.0
150840,2019,11,0,2,13,84.61538461538461
150840,2020,22,0,0,22,100.0
160005,2013,2,0,0,2,100.0
160005,2014,1,0,0,1,100.0
160005,2015,1,0,1,2,50.0
160005,2016,1,0,0,1,100.0
160005,2018,1,0,0,1,100.0
160005,2019,2,0,0,2,100.0
160005,2020,3,0,0,3,100.0
160010,2012,0,0,1,1,0.0
160010,2013,1,0,2,3,33.33333333333333
160010,2016,1,0,1,2,50.0
160010,2017,0,1,1,2,50.0
160010,2018,1,0,0,1,100.0
160010,2019,1,0,2,3,33.33333333333333
160010,2020,0,0,2,2,0.0
160015,2012,1,0,6,7,14.285714285714285
160015,2013,0,0,4,4,0.0
160015,2015,4,0,1,5,80.0
160015,2016,0,1,0,1,100.0
160015,2017,1,0,0,1,100.0
160015,2018,3,0,0,3,100.0
160015,2019,3,0,0,3,100.0
160015,2020,1,0,1,2,50.0
160020,2012,0,0,1,1,0.0
160020,2013,0,0,1,1,0.0
160020,2014,0,0,1,1,0.0
160020,2015,1,0,0,1,100.0
160020,2016,1,0,0,1,100.0
160020,2017,1,0,0,1,100.0
160020,2018,2,0,0,2,100.0
160020,2019,4,0,0,4,100.0
160020,2020,1,1,0,2,100.0
160021,2013,0,0,2,2,0.0
160021,2015,0,0,1,1,0.0
160021,2017,1,0,0,1,100.0
160021,2018,1,0,0,1,100.0
160021,2019,0,0,1,1,0.0
160021,2020,1,0,0,1,100.0
160023,2012,0,0,2,2,0.0
160023,2013,0,0,2,2,0.0
160023,2015,3,0,0,3,100.0
160023,2016,2,0,0,2,100.0
160023,2017,1,0,0,1,100.0
160023,2018,1,0,0,1,100.0
160023,2019,3,0,0,3,100.0
160023,2020,2,0,0,2,100.0
160025,2014,0,0,1,1,0.0
160025,2018,2,0,0,2,100.0
160025,2019,1,0,0,1,100.0
160025,2020,0,0,1,1,0.0
160027,2012,0,1,11,12,8.333333333333332
160027,2013,0,0,6,6,0.0
160027,2014,0,0,8,8,0.0
160027,2015,3,0,7,10,30.0
160027,2016,11,0,0,11,100.0
160027,2017,17,0,0,17,100.0
160027,2018,13,0,0,13,100.0
160027,2019,17,0,0,17,100.0
160027,2020,16,0,0,16,100.0
160030,2012,100,1,21,122,82.78688524590164
160030,2013,106,0,35,141,75.177304964539
160030,2014,151,0,1,152,99.3421052631579
160030,2015,168,0,0,168,100.0
160030,2016,164,0,0,164,100.0
160030,2017,149,0,3,152,98.02631578947368
160030,2018,177,0,1,178,99.43820224719101
160030,2019,145,0,0,145,100.0
160030,2020,261,0,1,262,99.61832061068702
160040,2012,0,0,2,2,0.0
160040,2013,0,0,2,2,0.0
160040,2014,1,0,3,4,25.0
160040,2015,2,0,0,2,100.0
160040,2016,5,0,1,6,83.33333333333334
160040,2017,1,0,0,1,100.0
160040,2018,7,0,0,7,100.0
160040,2019,5,0,0,5,100.0
160040,2020,6,0,0,6,100.0
160050,2012,0,0,6,6,0.0
160050,2013,0,1,4,5,20.0
160050,2014,5,0,3,8,62.5
160050,2015,6,0,0,6,100.0
160050,2016,3,0,1,4,75.0
160050,2017,3,0,3,6,50.0
160050,2018,8,0,0,8,100.0
160050,2019,11,0,0,11,100.0
160050,2020,14,0,0,14,100.0
160053,2012,0,0,4,4,0.0
160053,2013,0,0,7,7,0.0
160053,2014,5,0,0,5,100.0
160053,2015,3,0,0,3,100.0
160053,2016,2,0,1,3,66.66666666666666
160053,2017,4,0,0,4,100.0
160053,2018,5,0,0,5,100.0
160053,2019,4,0,1,5,80.0
160053,2020,4,0,0,4,100.0
160055,2013,0,0,1,1,0.0
160055,2015,1,0,1,2,50.0
160055,2017,1,0,0,1,100.0
160055,2018,4,0,0,4,100.0
160055,2019,2,0,0,2,100.0
160055,2020,3,0,0,3,100.0
160060,2012,9,0,20,29,31.03448275862069
160060,2013,16,0,20,36,44.44444444444444
160060,2014,36,0,1,37,97.2972972972973
160060,2015,37,0,5,42,88.09523809523809
160060,2016,27,2,3,32,90.625
160060,2017,21,4,15,40,62.5
160060,2018,36,0,4,40,90.0
160060,2019,47,0,0,47,100.0
160060,2020,58,0,1,59,98.30508474576271
160070,2012,1,1,2,4,50.0
160070,2013,1,0,2,3,33.33333333333333
160070,2014,2,0,2,4,50.0
160070,2015,7,0,0,7,100.0
160070,2016,4,0,0,4,100.0
160070,2017,4,0,1,5,80.0
160070,2019,2,0,2,4,50.0
160070,2020,3,0,0,3,100.0
160080,2012,0,0,2,2,0.0
160080,2013,0,0,3,3,0.0
160080,2014,0,0,1,1,0.0
160080,2015,0,0,2,2,0.0
160080,2016,3,0,0,3,100.0
160080,2017,4,0,0,4,100.0
160080,2018,1,0,0,1,100.0
160080,2019,5,0,0,5,100.0
160080,2020,3,0,0,3,100.0
170000,2012,1,0,0,1,100.0
170000,2014,1,0,0,1,100.0
170000,2015,0,0,1,1,0.0
170025,2015,1,0,0,1,100.0
170025,2016,1,0,0,1,100.0
170025,2018,1,0,0,1,100.0
170025,2019,1,0,0,1,100.0
170030,2012,1,0,0,1,100.0
170030,2013,2,0,0,2,100.0
170030,2014,1,0,0,1,100.0
170030,2015,1,0,0,1,100.0
170030,2016,2,0,0,2,100.0
170030,2017,2,0,0,2,100.0
170030,2018,1,0,0,1,100.0
170030,2020,2,0,0,2,100.0
170035,2012,2,0,0,2,100.0
170035,2013,3,0,0,3,100.0
170035,2014,2,0,0,2,100.0
170035,2015,2,0,0,2,100.0
170035,2016,2,0,0,2,100.0
170035,2017,4,0,0,4,100.0
170035,2018,2,0,0,2,100.0
170035,2019,3,0,0,3,100.0
170035,2020,2,0,0,2,100.0
170040,2012,1,0,0,1,100.0
170040,2013,7,0,0,7,100.0
170040,2014,3,0,0,3,100.0
170040,2015,6,0,0,6,100.0
170040,2017,1,0,0,1,100.0
170040,2018,1,0,0,1,100.0
170040,2019,2,0,2,4,50.0
170040,2020,2,0,0,2,100.0
170070,2012,1,0,0,1,100.0
170070,2013,3,0,0,3,100.0
170070,2014,2,0,0,2,100.0
170070,2015,6,0,0,6,100.0
170070,2016,3,0,0,3,100.0
170070,2017,3,0,0,3,100.0
170070,2018,3,0,0,3,100.0
170070,2019,3,0,0,3,100.0
170070,2020,6,0,0,6,100.0
170100,2012,3,0,0,3,100.0
170100,2013,4,0,0,4,100.0
170100,2014,2,0,0,2,100.0
170100,2015,3,0,0,3,100.0
170100,2016,7,0,0,7,100.0
170100,2017,3,0,0,3,100.0
170100,2018,3,0,0,3,100.0
170100,2019,6,0,0,6,100.0
170100,2020,3,0,0,3,100.0
170105,2013,2,0,0,2,100.0
170105,2015,1,0,0,1,100.0
170105,2017,1,0,0,1,100.0
170105,2018,1,0,0,1,100.0
170105,2019,1,0,0,1,100.0
170105,2020,1,0,0,1,100.0
170110,2012,1,0,0,1,100.0
170110,2014,3,0,0,3,100.0
170110,2015,2,0,0,2,100.0
170110,2016,1,0,0,1,100.0
170110,2017,1,0,0,1,100.0
170110,2018,1,0,0,1,100.0
170110,2019,1,0,0,1,100.0
170110,2020,2,0,0,2,100.0
170130,2012,2,0,0,2,100.0
170130,2013,3,0,0,3,100.0
170130,2014,2,0,0,2,100.0
170130,2016,3,0,0,3,100.0
170130,2017,1,0,0,1,100.0
170130,2018,1,0,0,1,100.0
170130,2019,1,0,0,1,100.0
170130,2020,4,0,0,4,100.0
170190,2013,3,0,0,3,100.0
170190,2014,3,0,0,3,100.0
170190,2015,2,0,0,2,100.0
170190,2016,4,0,0,4,100.0
170190,2017,2,0,0,2,100.0
170190,2018,1,0,0,1,100.0
170190,2019,1,0,0,1,100.0
170190,2020,4,0,0,4,100.0
170200,2012,4,0,0,4,100.0
170200,2013,1,0,0,1,100.0
170200,2014,1,0,1,2,50.0
170200,2015,1,0,0,1,100.0
170200,2016,5,0,0,5,100.0
170200,2017,1,0,0,1,100.0
170200,2018,3,0,0,3,100.0
170200,2019,6,0,0,6,100.0
170200,2020,2,0,0,2,100.0
170210,2012,64,0,0,64,100.0
170210,2013,55,0,1,56,98.21428571428571
170210,2014,65,0,0,65,100.0
170210,2015,59,0,1,60,98.33333333333333
170210,2016,60,0,0,60,100.0
170210,2017,69,0,2,71,97.1830985915493
170210,2018,67,0,0,67,100.0
170210,2019,52,0,0,52,100.0
170210,2020,55,0,0,55,100.0
170215,2012,2,0,0,2,100.0
170215,2013,1,0,0,1,100.0
170215,2014,1,0,0,1,100.0
170215,2015,2,0,0,2,100.0
170215,2016,0,1,0,1,100.0
170215,2017,3,0,0,3,100.0
170215,2018,1,0,0,1,100.0
170215,2019,2,0,0,2,100.0
170215,2020,1,0,0,1,100.0
170220,2012,8,0,0,8,100.0
170220,2013,10,0,0,10,100.0
170220,2014,9,0,1,10,90.0
170220,2015,5,0,1,6,83.33333333333334
170220,2016,11,0,0,11,100.0
170220,2017,9,0,0,9,100.0
170220,2018,13,0,0,13,100.0
170220,2019,7,0,0,7,100.0
170220,2020,10,0,0,10,100.0
170230,2012,2,0,0,2,100.0
170230,2014,3,0,0,3,100.0
170230,2015,4,0,0,4,100.0
170230,2016,5,0,0,5,100.0
170230,2017,1,0,0,1,100.0
170230,2018,1,0,0,1,100.0
170230,2019,1,0,0,1,100.0
170230,2020,4,0,0,4,100.0
170240,2012,3,0,0,3,100.0
170240,2013,3,0,0,3,100.0
170240,2014,3,1,0,4,100.0
170240,2015,4,0,0,4,100.0
170240,2016,5,0,1,6,83.33333333333334
170240,2017,2,0,0,2,100.0
170240,2018,6,0,0,6,100.0
170240,2019,2,0,0,2,100.0
170240,2020,2,0,0,2,100.0
170255,2012,6,0,0,6,100.0
170255,2013,5,0,0,5,100.0
170255,2014,6,0,0,6,100.0
170255,2015,8,0,0,8,100.0
170255,2016,4,0,0,4,100.0
170255,2017,5,0,0,5,100.0
170255,2018,3,0,0,3,100.0
170255,2019,3,0,0,3,100.0
170255,2020,7,0,0,7,100.0
170270,2012,2,0,0,2,100.0
170270,2015,2,0,0,2,100.0
170270,2016,2,0,0,2,100.0
170270,2017,1,0,0,1,100.0
170270,2019,2,0,0,2,100.0
170290,2012,1,0,0,1,100.0
170290,2013,7,0,0,7,100.0
170290,2014,6,0,0,6,100.0
170290,2015,4,0,0,4,100.0
170290,2016,4,0,0,4,100.0
170290,2017,5,0,0,5,100.0
170290,2018,3,0,0,3,100.0
170290,2019,2,0,0,2,100.0
170290,2020,5,0,0,5,100.0
170300,2012,1,0,0,1,100.0
170300,2013,2,0,0,2,100.0
170300,2014,2,0,0,2,100.0
170300,2015,1,1,2,4,50.0
170300,2016,4,0,0,4,100.0
170300,2017,1,0,0,1,100.0
170300,2018,4,0,0,4,100.0
170300,2019,4,0,0,4,100.0
170300,2020,4,0,0,4,100.0
170305,2012,2,0,0,2,100.0
170305,2013,1,0,0,1,100.0
170305,2015,2,0,0,2,100.0
170305,2016,2,0,0,2,100.0
170305,2017,2,0,0,2,100.0
170305,2018,1,0,0,1,100.0
170305,2019,3,0,0,3,100.0
170307,2014,3,0,0,3,100.0
170307,2015,2,0,0,2,100.0
170307,2016,1,0,0,1,100.0
170307,2017,1,0,1,2,50.0
170307,2019,1,0,0,1,100.0
170307,2020,1,0,0,1,100.0
170310,2012,1,0,0,1,100.0
170310,2013,1,0,1,2,50.0
170310,2014,0,0,1,1,0.0
170310,2015,2,0,2,4,50.0
170310,2016,1,0,0,1,100.0
170310,2017,5,0,0,5,100.0
170310,2018,1,0,0,1,100.0
170310,2019,1,0,0,1,100.0
170310,2020,3,0,0,3,100.0
170320,2013,1,0,0,1,100.0
170320,2015,2,0,0,2,100.0
170320,2017,1,0,0,1,100.0
170320,2018,3,0,0,3,100.0
170320,2019,3,0,0,3,100.0
170320,2020,1,0,0,1,100.0
170330,2012,4,0,0,4,100.0
170330,2013,1,0,0,1,100.0
170330,2014,1,0,0,1,100.0
170330,2015,3,0,1,4,75.0
170330,2016,1,0,0,1,100.0
170330,2017,1,0,0,1,100.0
170330,2018,1,0,0,1,100.0
170330,2019,2,0,0,2,100.0
170330,2020,1,0,0,1,100.0
170360,2013,1,0,0,1,100.0
170360,2018,1,0,0,1,100.0
170370,2012,2,0,0,2,100.0
170370,2013,4,0,0,4,100.0
170370,2014,3,0,0,3,100.0
170370,2015,5,0,0,5,100.0
170370,2017,2,0,0,2,100.0
170370,2019,4,0,0,4,100.0
170370,2020,2,0,0,2,100.0
170380,2012,2,0,0,2,100.0
170380,2013,2,0,0,2,100.0
170380,2014,1,0,0,1,100.0
170380,2015,5,0,0,5,100.0
170380,2016,2,0,0,2,100.0
170380,2017,3,0,0,3,100.0
170380,2019,2,0,0,2,100.0
170380,2020,4,0,0,4,100.0
170382,2012,1,0,0,1,100.0
170382,2015,1,0,0,1,100.0
170382,2016,1,0,0,1,100.0
170382,2017,1,0,0,1,100.0
170384,2012,3,0,0,3,100.0
170384,2013,4,0,0,4,100.0
170384,2014,0,1,3,4,25.0
170384,2015,3,0,0,3,100.0
170384,2016,2,0,0,2,100.0
170384,2017,3,0,0,3,100.0
170384,2018,2,0,0,2,100.0
170384,2019,4,0,0,4,100.0
170384,2020,4,0,0,4,100.0
170386,2012,3,0,0,3,100.0
170386,2013,2,0,0,2,100.0
170386,2014,1,0,0,1,100.0
170386,2015,1,0,0,1,100.0
170386,2016,2,0,0,2,100.0
170386,2017,2,0,0,2,100.0
170386,2018,1,0,0,1,100.0
170386,2019,1,0,0,1,100.0
170386,2020,1,0,0,1,100.0
170388,2012,1,0,0,1,100.0
170388,2013,1,0,0,1,100.0
170388,2017,4,0,0,4,100.0
170389,2012,1,0,0,1,100.0
170389,2014,3,0,0,3,100.0
170389,2015,1,0,0,1,100.0
170389,2016,1,0,0,1,100.0
170389,2017,1,0,0,1,100.0
170389,2019,1,0,0,1,100.0
170389,2020,1,0,0,1,100.0
170390,2012,1,0,0,1,100.0
170390,2013,2,0,0,2,100.0
170390,2015,0,0,1,1,0.0
170390,2016,1,0,0,1,100.0
170390,2017,2,0,0,2,100.0
170390,2018,1,0,0,1,100.0
170390,2019,2,0,0,2,100.0
170410,2012,2,0,0,2,100.0
170410,2013,1,0,0,1,100.0
170410,2014,1,0,0,1,100.0
170410,2018,1,0,0,1,100.0
170460,2012,1,0,0,1,100.0
170460,2013,1,0,0,1,100.0
170460,2014,2,0,0,2,100.0
170460,2019,1,0,0,1,100.0
170510,2012,1,0,0,1,100.0
170510,2013,1,0,0,1,100.0
170510,2015,1,0,0,1,100.0
170510,2016,0,0,2,2,0.0
170510,2019,2,0,0,2,100.0
170550,2012,13,0,0,13,100.0
170550,2013,9,0,0,9,100.0
170550,2014,7,0,0,7,100.0
170550,2015,13,0,0,13,100.0
170550,2016,16,0,0,16,100.0
170550,2017,14,0,0,14,100.0
170550,2018,9,0,0,9,100.0
170550,2019,12,0,0,12,100.0
170550,2020,22,0,0,22,100.0
170555,2012,1,0,0,1,100.0
170555,2013,3,0,0,3,100.0
170555,2014,1,0,0,1,100.0
170555,2015,1,0,1,2,50.0
170555,2020,4,0,0,4,100.0
170560,2012,1,0,0,1,100.0
170560,2013,1,0,0,1,100.0
170560,2014,2,0,0,2,100.0
170560,2015,2,0,0,2,100.0
170560,2017,2,0,0,2,100.0
170560,2018,2,0,0,2,100.0
170560,2019,2,0,0,2,100.0
170560,2020,4,0,0,4,100.0
170600,2012,1,0,0,1,100.0
170600,2013,1,0,0,1,100.0
170600,2014,1,0,0,1,100.0
170600,2015,3,0,0,3,100.0
170600,2017,2,0,0,2,100.0
170600,2018,2,0,0,2,100.0
170600,2019,2,0,0,2,100.0
170600,2020,1,0,0,1,100.0
170610,2012,2,0,0,2,100.0
170610,2015,1,0,0,1,100.0
170610,2016,3,0,0,3,100.0
170610,2017,3,0,0,3,100.0
170610,2018,1,0,0,1,100.0
170610,2020,4,0,0,4,100.0
170625,2014,1,0,0,1,100.0
170625,2015,0,0,1,1,0.0
170625,2016,1,0,0,1,100.0
170625,2019,1,0,0,1,100.0
170650,2012,1,0,0,1,100.0
170650,2013,2,0,0,2,100.0
170650,2014,4,0,0,4,100.0
170650,2015,0,0,1,1,0.0
170650,2016,2,0,1,3,66.66666666666666
170650,2017,2,0,0,2,100.0
170650,2018,1,0,0,1,100.0
170650,2019,3,0,0,3,100.0
170700,2012,6,0,0,6,100.0
170700,2013,8,0,0,8,100.0
170700,2014,6,0,1,7,85.71428571428571
170700,2015,7,0,0,7,100.0
170700,2016,5,0,0,5,100.0
170700,2017,5,0,0,5,100.0
170700,2018,3,0,0,3,100.0
170700,2019,5,0,0,5,100.0
170700,2020,9,0,0,9,100.0
170710,2014,4,0,0,4,100.0
170710,2015,2,0,0,2,100.0
170710,2017,3,0,0,3,100.0
170710,2018,1,0,0,1,100.0
170710,2019,2,0,0,2,100.0
170720,2012,1,1,0,2,100.0
170720,2013,1,0,0,1,100.0
170720,2014,3,0,0,3,100.0
170720,2015,1,0,0,1,100.0
170720,2016,4,0,0,4,100.0
170720,2017,1,0,0,1,100.0
170720,2018,2,0,0,2,100.0
170720,2019,0,1,0,1,100.0
170730,2012,2,0,0,2,100.0
170730,2013,1,0,0,1,100.0
170730,2014,3,0,0,3,100.0
170730,2015,3,0,0,3,100.0
170730,2016,1,0,0,1,100.0
170730,2017,1,0,0,1,100.0
170730,2018,1,0,0,1,100.0
170730,2019,1,0,0,1,100.0
170740,2012,2,0,0,2,100.0
170740,2013,3,0,0,3,100.0
170740,2015,4,0,0,4,100.0
170740,2016,2,0,0,2,100.0
170740,2017,5,0,0,5,100.0
170740,2018,4,0,0,4,100.0
170740,2019,6,0,0,6,100.0
170740,2020,4,0,0,4,100.0
170755,2013,4,0,0,4,100.0
170755,2015,1,0,0,1,100.0
170755,2019,4,0,0,4,100.0
170765,2013,1,0,0,1,100.0
170765,2015,3,0,0,3,100.0
170765,2016,1,0,0,1,100.0
170765,2017,4,0,0,4,100.0
170765,2018,5,0,0,5,100.0
170765,2019,1,1,1,3,66.66666666666666
170765,2020,5,0,0,5,100.0
170770,2012,1,0,0,1,100.0
170770,2013,3,0,0,3,100.0
170770,2014,1,0,1,2,50.0
170770,2015,1,0,1,2,50.0
170770,2016,2,1,0,3,100.0
170770,2017,3,0,0,3,100.0
170770,2018,3,0,0,3,100.0
170770,2019,3,0,0,3,100.0
170770,2020,3,0,0,3,100.0
170820,2012,7,0,0,7,100.0
170820,2013,7,0,0,7,100.0
170820,2014,6,0,0,6,100.0
170820,2015,4,0,0,4,100.0
170820,2016,9,0,0,9,100.0
170820,2017,7,0,0,7,100.0
170820,2018,8,0,0,8,100.0
170820,2019,6,0,1,7,85.71428571428571
170820,2020,11,0,0,11,100.0
170825,2012,3,0,0,3,100.0
170825,2013,2,0,0,2,100.0
170825,2015,1,0,0,1,100.0
170825,2016,4,0,0,4,100.0
170825,2017,3,0,0,3,100.0
170825,2018,3,0,0,3,100.0
170825,2020,1,0,0,1,100.0
170830,2012,2,0,0,2,100.0
170830,2013,2,0,0,2,100.0
170830,2016,1,0,0,1,100.0
170830,2017,4,0,0,4,100.0
170830,2018,2,0,0,2,100.0
170830,2019,3,0,0,3,100.0
170830,2020,2,0,0,2,100.0
170900,2012,4,0,0,4,100.0
170900,2013,3,0,0,3,100.0
170900,2014,2,0,0,2,100.0
170900,2015,2,0,0,2,100.0
170900,2016,2,0,0,2,100.0
170900,2017,6,0,0,6,100.0
170900,2018,7,0,0,7,100.0
170900,2019,2,0,0,2,100.0
170900,2020,12,0,0,12,100.0
170930,2012,7,0,0,7,100.0
170930,2013,15,0,0,15,100.0
170930,2014,8,0,0,8,100.0
170930,2015,9,0,0,9,100.0
170930,2016,3,0,0,3,100.0
170930,2017,6,0,0,6,100.0
170930,2018,7,0,0,7,100.0
170930,2019,5,0,0,5,100.0
170930,2020,7,0,0,7,100.0
170950,2012,31,0,0,31,100.0
170950,2013,23,0,0,23,100.0
170950,2014,21,0,0,21,100.0
170950,2015,27,0,0,27,100.0
170950,2016,26,0,0,26,100.0
170950,2017,44,0,0,44,100.0
170950,2018,32,0,0,32,100.0
170950,2019,32,0,0,32,100.0
170950,2020,28,0,0,28,100.0
170980,2013,0,0,1,1,0.0
170980,2019,1,0,0,1,100.0
170980,2020,2,0,0,2,100.0
171050,2013,1,0,0,1,100.0
171050,2014,3,0,0,3,100.0
171050,2015,2,0,0,2,100.0
171050,2016,5,0,0,5,100.0
171050,2017,4,0,0,4,100.0
171050,2018,3,0,0,3,100.0
171050,2019,3,0,0,3,100.0
171050,2020,2,0,0,2,100.0
171070,2012,4,1,0,5,100.0
171070,2014,3,0,0,3,100.0
171070,2015,1,0,0,1,100.0
171070,2016,2,0,1,3,66.66666666666666
171070,2017,1,0,0,1,100.0
171070,2018,4,0,0,4,100.0
171070,2019,2,0,0,2,100.0
171070,2020,1,0,0,1,100.0
171090,2012,1,0,0,1,100.0
171090,2013,1,0,0,1,100.0
171090,2015,0,0,1,1,0.0
171090,2016,1,0,0,1,100.0
171090,2017,3,0,0,3,100.0
171090,2019,2,0,1,3,66.66666666666666
171090,2020,2,0,0,2,100.0
171110,2012,1,0,0,1,100.0
171110,2013,1,0,0,1,100.0
171110,2014,1,0,1,2,50.0
171110,2018,1,0,0,1,100.0
171110,2019,2,0,0,2,100.0
171150,2013,1,0,0,1,100.0
171180,2013,3,0,0,3,100.0
171180,2014,2,0,0,2,100.0
171180,2015,1,0,0,1,100.0
171180,2016,3,0,0,3,100.0
171180,2017,2,0,0,2,100.0
171180,2018,1,0,0,1,100.0
171180,2019,1,0,0,1,100.0
171180,2020,2,0,0,2,100.0
171190,2012,3,0,0,3,100.0
171190,2013,4,0,0,4,100.0
171190,2014,4,0,1,5,80.0
171190,2015,4,0,3,7,57.14285714285714
171190,2016,4,0,0,4,100.0
171190,2017,4,0,0,4,100.0
171190,2018,8,0,0,8,100.0
171190,2019,6,0,0,6,100.0
171190,2020,4,0,0,4,100.0
171195,2012,2,0,0,2,100.0
171195,2014,1,0,0,1,100.0
171195,2016,2,0,0,2,100.0
171195,2017,1,0,0,1,100.0
171195,2018,5,0,0,5,100.0
171195,2019,1,0,0,1,100.0
171195,2020,2,0,0,2,100.0
171200,2012,1,0,0,1,100.0
171200,2013,2,0,0,2,100.0
171200,2014,2,0,0,2,100.0
171200,2015,2,0,0,2,100.0
171200,2016,1,0,0,1,100.0
171200,2018,0,1,0,1,100.0
171200,2020,1,0,0,1,100.0
171215,2013,1,0,0,1,100.0
171215,2016,1,0,0,1,100.0
171215,2018,1,0,0,1,100.0
171240,2013,1,0,0,1,100.0
171240,2014,0,1,1,2,50.0
171240,2016,1,0,0,1,100.0
171240,2020,1,0,0,1,100.0
171245,2012,1,0,0,1,100.0
171245,2013,1,0,0,1,100.0
171245,2014,1,0,0,1,100.0
171245,2015,1,0,0,1,100.0
171245,2016,1,0,0,1,100.0
171245,2018,1,0,0,1,100.0
171245,2020,1,0,0,1,100.0
171250,2012,0,2,0,2,100.0
171250,2014,1,0,0,1,100.0
171250,2015,1,0,0,1,100.0
171250,2016,2,0,0,2,100.0
171250,2017,2,0,0,2,100.0
171250,2020,2,0,0,2,100.0
171270,2012,1,0,0,1,100.0
171270,2014,1,0,0,1,100.0
171270,2017,2,0,0,2,100.0
171270,2020,1,0,0,1,100.0
171280,2012,1,0,0,1,100.0
171280,2014,2,0,0,2,100.0
171280,2015,2,0,0,2,100.0
171280,2019,0,0,1,1,0.0
171320,2012,9,0,0,9,100.0
171320,2013,3,0,0,3,100.0
171320,2014,5,0,1,6,83.33333333333334
171320,2015,7,0,0,7,100.0
171320,2016,8,0,0,8,100.0
171320,2017,6,0,0,6,100.0
171320,2018,8,0,0,8,100.0
171320,2019,9,0,0,9,100.0
171320,2020,13,0,0,13,100.0
171330,2012,7,0,0,7,100.0
171330,2013,4,0,0,4,100.0
171330,2014,3,1,0,4,100.0
171330,2015,1,0,0,1,100.0
171330,2016,4,0,0,4,100.0
171330,2017,8,0,0,8,100.0
171330,2018,3,0,0,3,100.0
171330,2019,4,0,0,4,100.0
171330,2020,4,0,0,4,100.0
171360,2013,1,0,0,1,100.0
171360,2014,2,0,0,2,100.0
171360,2015,1,0,0,1,100.0
171360,2016,3,0,0,3,100.0
171360,2017,1,0,0,1,100.0
171360,2018,3,0,0,3,100.0
171360,2019,1,0,0,1,100.0
171360,2020,3,0,0,3,100.0
171370,2012,1,0,0,1,100.0
171370,2014,1,0,0,1,100.0
171370,2015,3,0,0,3,100.0
171370,2017,1,0,0,1,100.0
171380,2012,3,0,0,3,100.0
171380,2013,2,0,1,3,66.66666666666666
171380,2014,1,0,0,1,100.0
171380,2015,1,0,0,1,100.0
171380,2017,3,0,0,3,100.0
171380,2018,2,0,0,2,100.0
171380,2019,2,0,0,2,100.0
171380,2020,3,0,0,3,100.0
171395,2013,0,0,1,1,0.0
171395,2017,1,0,0,1,100.0
171395,2018,2,0,0,2,100.0
171395,2019,2,0,0,2,100.0
171420,2013,6,0,0,6,100.0
171420,2014,1,0,0,1,100.0
171420,2015,5,0,0,5,100.0
171420,2016,4,0,0,4,100.0
171420,2017,6,0,0,6,100.0
171420,2018,4,0,0,4,100.0
171420,2019,1,0,0,1,100.0
171420,2020,2,0,0,2,100.0
171430,2014,2,0,0,2,100.0
171430,2016,2,0,0,2,100.0
171430,2017,1,0,0,1,100.0
171430,2018,1,0,0,1,100.0
171430,2020,1,0,0,1,100.0
171488,2012,1,0,1,2,50.0
171488,2013,4,0,0,4,100.0
171488,2014,7,1,1,9,88.88888888888889
171488,2015,6,0,0,6,100.0
171488,2016,2,0,0,2,100.0
171488,2017,6,0,0,6,100.0
171488,2018,5,0,0,5,100.0
171488,2019,4,0,0,4,100.0
171488,2020,3,0,0,3,100.0
171500,2012,1,0,0,1,100.0
171500,2013,2,0,0,2,100.0
171500,2015,1,0,0,1,100.0
171500,2017,1,0,0,1,100.0
171500,2018,3,0,0,3,100.0
171500,2020,2,0,0,2,100.0
171510,2012,1,0,0,1,100.0
171510,2013,1,1,0,2,100.0
171510,2014,3,0,1,4,75.0
171510,2015,2,0,0,2,100.0
171510,2016,4,0,0,4,100.0
171510,2017,1,0,0,1,100.0
171510,2019,1,0,0,1,100.0
171515,2013,1,0,0,1,100.0
171515,2015,1,0,0,1,100.0
171515,2016,2,0,0,2,100.0
171515,2017,1,0,0,1,100.0
171515,2018,2,0,0,2,100.0
171515,2019,1,0,0,1,100.0
171525,2012,3,0,0,3,100.0
171525,2013,2,0,1,3,66.66666666666666
171525,2014,1,0,0,1,100.0
171525,2015,1,0,0,1,100.0
171525,2020,3,0,0,3,100.0
171550,2013,1,0,0,1,100.0
171550,2015,0,0,1,1,0.0
171570,2012,4,0,0,4,100.0
171570,2013,1,0,0,1,100.0
171570,2014,3,0,0,3,100.0
171570,2015,1,0,0,1,100.0
171570,2016,1,0,0,1,100.0
171570,2017,1,0,0,1,100.0
171570,2018,2,0,0,2,100.0
171570,2019,2,0,0,2,100.0
171570,2020,3,0,0,3,100.0
171575,2012,1,0,0,1,100.0
171575,2013,1,0,0,1,100.0
171575,2014,3,0,0,3,100.0
171575,2015,3,0,0,3,100.0
171575,2016,1,0,0,1,100.0
171575,2017,6,0,0,6,100.0
171575,2018,2,1,0,3,100.0
171575,2019,1,0,0,1,100.0
171575,2020,2,0,0,2,100.0
171610,2012,17,0,1,18,94.44444444444444
171610,2013,11,0,0,11,100.0
171610,2014,20,0,0,20,100.0
171610,2015,19,0,0,19,100.0
171610,2016,17,1,0,18,100.0
171610,2017,20,0,0,20,100.0
171610,2018,15,0,0,15,100.0
171610,2019,12,0,0,12,100.0
171610,2020,23,0,0,23,100.0
171620,2012,2,0,0,2,100.0
171620,2013,3,0,0,3,100.0
171620,2014,3,0,3,6,50.0
171620,2015,0,1,1,2,50.0
171620,2016,2,0,0,2,100.0
171620,2017,3,0,0,3,100.0
171620,2018,5,0,0,5,100.0
171620,2019,3,0,0,3,100.0
171620,2020,2,0,0,2,100.0
171630,2013,0,0,1,1,0.0
171630,2015,0,0,1,1,0.0
171630,2016,0,0,1,1,0.0
171630,2017,1,0,0,1,100.0
171630,2019,2,0,0,2,100.0
171630,2020,2,0,0,2,100.0
171650,2012,6,0,0,6,100.0
171650,2013,4,0,0,4,100.0
171650,2014,5,0,1,6,83.33333333333334
171650,2015,5,1,2,8,75.0
171650,2016,7,0,0,7,100.0
171650,2017,5,0,0,5,100.0
171650,2018,7,0,0,7,100.0
171650,2019,6,0,0,6,100.0
171650,2020,7,0,0,7,100.0
171660,2012,5,0,0,5,100.0
171660,2013,3,0,0,3,100.0
171660,2014,3,0,0,3,100.0
171660,2015,4,0,0,4,100.0
171660,2016,3,0,0,3,100.0
171660,2017,2,0,0,2,100.0
171660,2018,1,0,0,1,100.0
171660,2019,4,0,0,4,100.0
171660,2020,2,0,0,2,100.0
171665,2012,1,0,0,1,100.0
171665,2013,4,0,0,4,100.0
171665,2014,1,0,0,1,100.0
171665,2016,1,0,0,1,100.0
171665,2017,3,0,0,3,100.0
171665,2018,1,0,0,1,100.0
171665,2019,1,0,0,1,100.0
171665,2020,1,0,0,1,100.0
171670,2012,5,0,0,5,100.0
171670,2013,1,0,0,1,100.0
171670,2014,6,0,0,6,100.0
171670,2015,4,0,0,4,100.0
171670,2016,2,0,0,2,100.0
171670,2017,3,0,0,3,100.0
171670,2018,1,0,0,1,100.0
171700,2012,1,0,0,1,100.0
171700,2013,2,0,0,2,100.0
171700,2014,1,0,0,1,100.0
171700,2015,1,0,0,1,100.0
171700,2016,2,0,1,3,66.66666666666666
171700,2017,1,0,0,1,100.0
171700,2020,1,0,0,1,100.0
171720,2012,2,0,0,2,100.0
171720,2014,1,0,0,1,100.0
171720,2018,0,0,1,1,0.0
171720,2019,1,0,1,2,50.0
171720,2020,1,0,0,1,100.0
171750,2012,4,0,0,4,100.0
171750,2013,4,0,0,4,100.0
171750,2014,4,1,0,5,100.0
171750,2015,1,0,0,1,100.0
171750,2016,3,0,0,3,100.0
171750,2017,4,0,0,4,100.0
171750,2018,3,0,0,3,100.0
171750,2019,2,0,0,2,100.0
171750,2020,4,0,0,4,100.0
171780,2012,2,0,0,2,100.0
171780,2016,2,0,0,2,100.0
171780,2017,4,0,0,4,100.0
171780,2018,2,0,0,2,100.0
171780,2019,2,0,0,2,100.0
171780,2020,1,0,0,1,100.0
171790,2012,2,0,0,2,100.0
171790,2013,2,0,0,2,100.0
171790,2015,1,1,0,2,100.0
171790,2016,0,1,0,1,100.0
171790,2018,2,0,0,2,100.0
171790,2019,2,0,0,2,100.0
171790,2020,2,0,0,2,100.0
171800,2012,1,0,0,1,100.0
171800,2016,1,0,0,1,100.0
171800,2017,2,0,0,2,100.0
171800,2018,1,0,0,1,100.0
171820,2012,25,0,0,25,100.0
171820,2013,15,0,0,15,100.0
171820,2014,20,0,0,20,100.0
171820,2015,22,0,0,22,100.0
171820,2016,19,0,0,19,100.0
171820,2017,14,0,0,14,100.0
171820,2018,23,0,1,24,95.83333333333334
171820,2019,24,0,0,24,100.0
171820,2020,22,0,0,22,100.0
171830,2013,4,0,0,4,100.0
171830,2014,2,0,0,2,100.0
171830,2015,3,0,0,3,100.0
171830,2016,5,0,0,5,100.0
171830,2018,2,0,0,2,100.0
171830,2019,4,0,0,4,100.0
171830,2020,3,0,0,3,100.0
171840,2012,1,0,0,1,100.0
171840,2013,2,0,0,2,100.0
171840,2014,2,0,0,2,100.0
171840,2017,1,0,0,1,100.0
171840,2018,1,0,0,1,100.0
171845,2012,1,0,0,1,100.0
171845,2014,1,0,0,1,100.0
171845,2015,3,0,0,3,100.0
171845,2018,1,0,0,1,100.0
171845,2019,1,0,0,1,100.0
171845,2020,3,0,0,3,100.0
171850,2012,2,0,0,2,100.0
171850,2013,1,0,0,1,100.0
171850,2014,1,0,0,1,100.0
171850,2015,0,0,1,1,0.0
171850,2017,1,0,0,1,100.0
171850,2019,1,0,0,1,100.0
171855,2015,2,0,0,2,100.0
171855,2016,2,0,0,2,100.0
171855,2017,1,0,0,1,100.0
171855,2018,1,0,0,1,100.0
171855,2019,1,0,0,1,100.0
171855,2020,1,0,0,1,100.0
171865,2013,1,0,0,1,100.0
171865,2020,1,0,0,1,100.0
171870,2013,2,0,0,2,100.0
171870,2014,1,0,0,1,100.0
171870,2015,0,0,1,1,0.0
171870,2016,2,0,0,2,100.0
171870,2017,2,0,0,2,100.0
171870,2018,1,0,0,1,100.0
171875,2012,2,0,0,2,100.0
171875,2014,1,0,0,1,100.0
171875,2015,1,0,0,1,100.0
171875,2016,1,0,0,1,100.0
171875,2017,2,0,0,2,100.0
171875,2019,1,0,0,1,100.0
171875,2020,1,0,0,1,100.0
171880,2012,2,0,0,2,100.0
171880,2014,2,0,0,2,100.0
171880,2016,2,0,1,3,66.66666666666666
171880,2017,1,0,0,1,100.0
171880,2018,1,0,1,2,50.0
171880,2019,1,0,0,1,100.0
171880,2020,3,0,0,3,100.0
171884,2012,2,0,0,2,100.0
171884,2013,2,0,0,2,100.0
171884,2014,2,0,0,2,100.0
171884,2015,2,0,0,2,100.0
171884,2017,1,0,0,1,100.0
171884,2018,2,0,0,2,100.0
171884,2020,2,0,0,2,100.0
171886,2012,2,0,0,2,100.0
171886,2013,3,0,0,3,100.0
171886,2014,4,0,0,4,100.0
171886,2015,1,0,0,1,100.0
171886,2017,2,0,0,2,100.0
171886,2018,0,0,1,1,0.0
171886,2019,5,1,0,6,100.0
171886,2020,2,0,0,2,100.0
171888,2014,2,0,0,2,100.0
171888,2015,1,0,0,1,100.0
171888,2016,1,0,0,1,100.0
171888,2018,0,1,0,1,100.0
171888,2020,1,0,0,1,100.0
171889,2012,2,0,0,2,100.0
171889,2014,0,0,1,1,0.0
171889,2016,1,0,0,1,100.0
171889,2018,1,0,0,1,100.0
171890,2013,2,0,0,2,100.0
171890,2014,2,0,0,2,100.0
171890,2015,4,0,0,4,100.0
171890,2016,2,0,0,2,100.0
171890,2017,1,0,0,1,100.0
171890,2018,2,0,0,2,100.0
171890,2019,2,0,0,2,100.0
171890,2020,1,0,0,1,100.0
171900,2015,2,0,0,2,100.0
171900,2016,3,0,0,3,100.0
171900,2019,2,0,0,2,100.0
171900,2020,1,0,0,1,100.0
172000,2012,1,0,0,1,100.0
172000,2013,1,0,0,1,100.0
172000,2015,1,0,1,2,50.0
172000,2017,1,0,0,1,100.0
172000,2019,1,0,0,1,100.0
172000,2020,2,0,0,2,100.0
172010,2012,3,0,0,3,100.0
172010,2013,1,0,0,1,100.0
172010,2014,2,0,0,2,100.0
172010,2016,1,0,0,1,100.0
172010,2017,1,0,0,1,100.0
172010,2019,0,0,1,1,0.0
172010,2020,3,0,0,3,100.0
172015,2012,1,0,0,1,100.0
172015,2013,1,0,0,1,100.0
172015,2020,1,0,0,1,100.0
172020,2012,6,0,0,6,100.0
172020,2013,3,0,0,3,100.0
172020,2014,4,0,0,4,100.0
172020,2015,3,0,0,3,100.0
172020,2016,1,0,0,1,100.0
172020,2017,3,0,0,3,100.0
172020,2018,6,0,0,6,100.0
172020,2020,4,0,0,4,100.0
172025,2012,4,0,0,4,100.0
172025,2014,1,0,0,1,100.0
172025,2015,3,0,0,3,100.0
172025,2016,2,0,0,2,100.0
172025,2017,2,0,0,2,100.0
172025,2018,1,0,0,1,100.0
172030,2013,1,0,0,1,100.0
172030,2017,3,0,0,3,100.0
172030,2018,5,0,0,5,100.0
172049,2012,1,0,0,1,100.0
172049,2013,2,0,0,2,100.0
172049,2014,2,0,0,2,100.0
172049,2015,2,0,0,2,100.0
172049,2016,2,0,0,2,100.0
172049,2017,2,0,0,2,100.0
172065,2012,2,0,0,2,100.0
172065,2013,2,0,0,2,100.0
172065,2014,1,0,0,1,100.0
172065,2015,2,0,0,2,100.0
172065,2016,2,0,0,2,100.0
172065,2017,2,0,0,2,100.0
172065,2018,3,0,0,3,100.0
172065,2019,4,0,0,4,100.0
172065,2020,2,0,0,2,100.0
172080,2012,1,0,0,1,100.0
172080,2013,4,0,0,4,100.0
172080,2014,7,0,0,7,100.0
172080,2015,3,0,0,3,100.0
172080,2016,1,0,0,1,100.0
172080,2017,3,0,0,3,100.0
172080,2018,2,0,0,2,100.0
172080,2019,2,0,0,2,100.0
172080,2020,2,0,0,2,100.0
172085,2012,1,0,0,1,100.0
172085,2013,1,0,0,1,100.0
172085,2016,1,0,0,1,100.0
172085,2017,1,0,0,1,100.0
172085,2018,1,0,0,1,100.0
172085,2019,1,0,0,1,100.0
172090,2012,5,0,0,5,100.0
172090,2013,4,0,0,4,100.0
172090,2014,4,0,0,4,100.0
172090,2015,4,1,0,5,100.0
172090,2016,5,0,0,5,100.0
172090,2017,3,0,0,3,100.0
172090,2018,2,0,0,2,100.0
172090,2019,4,0,0,4,100.0
172090,2020,5,0,0,5,100.0
172093,2014,1,0,0,1,100.0
172093,2016,1,0,0,1,100.0
172093,2019,1,0,0,1,100.0
172093,2020,2,0,0,2,100.0
172097,2012,1,0,0,1,100.0
172097,2013,2,0,0,2,100.0
172097,2014,2,0,0,2,100.0
172097,2015,2,0,0,2,100.0
172097,2016,1,0,0,1,100.0
172097,2017,2,0,0,2,100.0
172097,2019,1,0,0,1,100.0
172097,2020,1,0,0,1,100.0
172100,2012,81,1,0,82,100.0
172100,2013,83,0,3,86,96.51162790697676
172100,2014,85,0,1,86,98.83720930232558
172100,2015,96,0,0,96,100.0
172100,2016,69,0,0,69,100.0
172100,2017,87,0,0,87,100.0
172100,2018,82,0,0,82,100.0
172100,2019,80,0,0,80,100.0
172100,2020,84,0,0,84,100.0
172110,2012,2,0,0,2,100.0
172110,2013,4,0,0,4,100.0
172110,2014,2,0,0,2,100.0
172110,2015,2,0,0,2,100.0
172110,2016,2,0,0,2,100.0
172110,2017,3,0,0,3,100.0
172110,2018,1,0,1,2,50.0
172110,2019,3,0,0,3,100.0
172110,2020,3,0,0,3,100.0
172120,2012,3,0,0,3,100.0
172120,2013,9,0,0,9,100.0
172120,2014,4,0,0,4,100.0
172120,2015,12,0,0,12,100.0
172120,2016,7,0,0,7,100.0
172120,2017,9,0,0,9,100.0
172120,2018,6,0,0,6,100.0
172120,2019,5,0,0,5,100.0
172120,2020,8,0,0,8,100.0
172125,2012,1,0,0,1,100.0
172125,2016,1,0,0,1,100.0
172130,2014,1,0,0,1,100.0
172130,2016,0,0,1,1,0.0
172208,2012,2,0,0,2,100.0
172208,2013,5,0,0,5,100.0
172208,2014,6,0,0,6,100.0
172208,2015,5,0,0,5,100.0
172208,2016,2,0,0,2,100.0
172208,2017,1,0,0,1,100.0
172208,2019,4,0,0,4,100.0
172208,2020,3,0,0,3,100.0
172210,2012,6,0,0,6,100.0
172210,2013,6,0,0,6,100.0
172210,2014,7,0,0,7,100.0
172210,2015,7,0,0,7,100.0
172210,2016,4,1,0,5,100.0
172210,2017,3,0,0,3,100.0
172210,2018,4,0,0,4,100.0
172210,2019,7,0,0,7,100.0
172210,2020,4,0,0,4,100.0
210000,2012,0,0,3,3,0.0
210000,2013,0,0,3,3,0.0
210000,2014,0,0,1,1,0.0
210000,2015,0,0,1,1,0.0
210000,2016,0,1,3,4,25.0
210000,2017,0,0,2,2,0.0
210000,2018,0,1,3,4,25.0
210000,2019,0,0,1,1,0.0
210000,2020,0,0,2,2,0.0
210005,2012,18,0,12,30,60.0
210005,2013,30,0,14,44,68.18181818181817
210005,2014,28,0,6,34,82.35294117647058
210005,2015,13,0,7,20,65.0
210005,2016,36,0,0,36,100.0
210005,2017,43,0,0,43,100.0
210005,2018,30,0,0,30,100.0
210005,2019,24,0,3,27,88.88888888888889
210005,2020,41,0,5,46,89.13043478260869
210010,2012,1,0,2,3,33.33333333333333
210010,2013,1,0,0,1,100.0
210010,2014,4,0,0,4,100.0
210010,2015,3,0,0,3,100.0
210010,2016,2,0,1,3,66.66666666666666
210010,2017,5,0,0,5,100.0
210010,2018,3,0,0,3,100.0
210010,2019,1,0,0,1,100.0
210010,2020,1,0,1,2,50.0
210015,2012,0,0,2,2,0.0
210015,2013,0,1,1,2,50.0
210015,2014,0,0,1,1,0.0
210015,2015,4,0,1,5,80.0
210015,2016,4,0,0,4,100.0
210015,2017,4,0,0,4,100.0
210015,2018,2,0,1,3,66.66666666666666
210015,2019,0,0,1,1,0.0
210020,2012,0,1,3,4,25.0
210020,2013,5,0,1,6,83.33333333333334
210020,2014,1,1,3,5,40.0
210020,2015,0,2,8,10,20.0
210020,2016,0,2,5,7,28.57142857142857
210020,2017,6,0,0,6,100.0
210020,2018,3,0,0,3,100.0
210020,2019,2,0,1,3,66.66666666666666
210020,2020,2,0,4,6,33.33333333333333
210030,2012,8,0,0,8,100.0
210030,2013,5,0,0,5,100.0
210030,2014,2,0,1,3,66.66666666666666
210030,2015,7,0,7,14,50.0
210030,2016,2,4,7,13,46.15384615384615
210030,2017,10,0,0,10,100.0
210030,2018,5,0,0,5,100.0
210030,2019,6,0,0,6,100.0
210030,2020,6,0,0,6,100.0
210040,2012,0,0,1,1,0.0
210040,2013,1,0,1,2,50.0
210040,2014,1,0,1,2,50.0
210040,2015,0,0,2,2,0.0
210040,2016,0,0,1,1,0.0
210040,2017,3,0,0,3,100.0
210040,2018,2,0,0,2,100.0
210040,2019,2,0,0,2,100.0
210040,2020,1,0,0,1,100.0
210043,2012,0,0,8,8,0.0
210043,2013,0,2,16,18,11.11111111111111
210043,2014,8,0,1,9,88.88888888888889
210043,2015,7,0,0,7,100.0
210043,2016,0,1,7,8,12.5
210043,2017,9,1,0,10,100.0
210043,2018,0,0,7,7,0.0
210043,2019,3,0,7,10,30.0
210043,2020,2,0,9,11,18.181818181818183
210047,2012,2,0,7,9,22.22222222222222
210047,2013,2,0,4,6,33.33333333333333
210047,2014,3,1,3,7,57.14285714285714
210047,2015,1,0,7,8,12.5
210047,2016,0,1,12,13,7.6923076923076925
210047,2017,7,0,0,7,100.0
210047,2018,7,0,0,7,100.0
210047,2019,3,0,0,3,100.0
210047,2020,7,0,0,7,100.0
210050,2012,0,0,3,3,0.0
210050,2013,0,0,4,4,0.0
210050,2015,1,0,4,5,20.0
210050,2016,0,0,1,1,0.0
210050,2017,3,0,0,3,100.0
210050,2018,2,0,0,2,100.0
210050,2019,4,0,0,4,100.0
210050,2020,2,0,0,2,100.0
210055,2012,0,0,2,2,0.0
210055,2015,0,1,3,4,25.0
210055,2016,0,0,3,3,0.0
210055,2017,0,1,0,1,100.0
210055,2019,0,0,4,4,0.0
210055,2020,0,0,3,3,0.0
210060,2012,11,0,2,13,84.61538461538461
210060,2013,12,0,1,13,92.3076923076923
210060,2014,14,0,0,14,100.0
210060,2015,13,0,0,13,100.0
210060,2016,17,0,0,17,100.0
210060,2017,17,0,0,17,100.0
210060,2018,12,0,0,12,100.0
210060,2019,6,0,1,7,85.71428571428571
210060,2020,21,0,0,21,100.0
210070,2012,0,0,3,3,0.0
210070,2013,0,0,9,9,0.0
210070,2014,1,0,2,3,33.33333333333333
210070,2015,7,0,0,7,100.0
210070,2016,6,0,3,9,66.66666666666666
210070,2017,6,0,0,6,100.0
210070,2018,4,0,1,5,80.0
210070,2019,4,0,0,4,100.0
210070,2020,7,0,0,7,100.0
210080,2012,2,0,0,2,100.0
210080,2013,1,1,2,4,50.0
210080,2014,0,1,3,4,25.0
210080,2015,0,1,1,2,50.0
210080,2016,6,0,1,7,85.71428571428571
210080,2017,5,0,0,5,100.0
210080,2019,4,0,0,4,100.0
210083,2012,0,0,4,4,0.0
210083,2013,1,0,1,2,50.0
210083,2014,0,2,2,4,50.0
210083,2015,3,0,2,5,60.0
210083,2016,6,0,0,6,100.0
210083,2017,6,0,0,6,100.0
210083,2018,2,0,2,4,50.0
210083,2019,1,0,2,3,33.33333333333333
210083,2020,6,0,0,6,100.0
210087,2013,1,0,2,3,33.33333333333333
210087,2014,0,0,5,5,0.0
210087,2015,1,1,0,2,100.0
210087,2016,0,0,2,2,0.0
210087,2017,3,1,0,4,100.0
210087,2018,1,0,0,1,100.0
210087,2019,1,0,0,1,100.0
210087,2020,1,0,2,3,33.33333333333333
210090,2012,0,1,15,16,6.25
210090,2013,9,0,0,9,100.0
210090,2014,7,0,0,7,100.0
210090,2015,9,0,0,9,100.0
210090,2016,11,0,0,11,100.0
210090,2017,6,0,0,6,100.0
210090,2018,6,0,0,6,100.0
210090,2019,7,0,1,8,87.5
210090,2020,6,4,3,13,76.92307692307693
210095,2012,0,4,7,11,36.36363636363637
210095,2013,0,0,8,8,0.0
210095,2014,4,0,5,9,44.44444444444444
210095,2015,4,0,4,8,50.0
210095,2016,1,0,7,8,12.5
210095,2017,10,0,0,10,100.0
210095,2018,9,0,0,9,100.0
210095,2019,15,0,1,16,93.75
210095,2020,8,0,1,9,88.88888888888889
210100,2012,0,1,6,7,14.285714285714285
210100,2013,0,0,10,10,0.0
210100,2014,0,0,11,11,0.0
210100,2015,2,1,11,14,21.428571428571427
210100,2016,5,0,3,8,62.5
210100,2017,10,0,0,10,100.0
210100,2018,5,0,0,5,100.0
210100,2019,9,0,0,9,100.0
210100,2020,11,0,0,11,100.0
210110,2012,0,1,0,1,100.0
210110,2013,1,0,2,3,33.33333333333333
210110,2014,3,0,0,3,100.0
210110,2016,1,0,0,1,100.0
210110,2017,1,0,0,1,100.0
210110,2018,4,0,0,4,100.0
210110,2019,1,0,0,1,100.0
210110,2020,3,0,0,3,100.0
210120,2012,35,4,4,43,90.69767441860465
210120,2013,36,1,0,37,100.0
210120,2014,36,1,1,38,97.36842105263158
210120,2015,27,2,7,36,80.55555555555556
210120,2016,2,6,28,36,22.22222222222222
210120,2017,32,0,0,32,100.0
210120,2018,39,0,0,39,100.0
210120,2019,31,0,0,31,100.0
210120,2020,52,1,0,53,100.0
210125,2012,0,0,2,2,0.0
210125,2013,1,0,0,1,100.0
210125,2014,1,1,3,5,40.0
210125,2015,7,0,1,8,87.5
210125,2016,3,0,1,4,75.0
210125,2017,10,0,0,10,100.0
210125,2018,3,0,0,3,100.0
210125,2019,2,0,0,2,100.0
210125,2020,7,1,4,12,66.66666666666666
210130,2012,0,1,4,5,20.0
210130,2013,0,2,4,6,33.33333333333333
210130,2014,0,9,4,13,69.23076923076923
210130,2015,0,1,1,2,50.0
210130,2016,4,0,0,4,100.0
210130,2017,6,0,0,6,100.0
210130,2018,4,0,1,5,80.0
210130,2019,3,0,0,3,100.0
210130,2020,3,0,0,3,100.0
210135,2013,0,0,3,3,0.0
210135,2014,0,0,1,1,0.0
210135,2015,0,0,1,1,0.0
210135,2016,1,0,0,1,100.0
210135,2017,4,0,0,4,100.0
210140,2012,22,0,2,24,91.66666666666666
210140,2013,26,1,9,36,75.0
210140,2014,23,0,6,29,79.3103448275862
210140,2015,28,0,1,29,96.55172413793103
210140,2016,33,0,8,41,80.48780487804879
210140,2017,35,0,0,35,100.0
210140,2018,39,0,0,39,100.0
210140,2019,49,0,0,49,100.0
210140,2020,47,0,0,47,100.0
210150,2012,0,0,7,7,0.0
210150,2013,0,0,4,4,0.0
210150,2014,0,0,4,4,0.0
210150,2015,0,0,3,3,0.0
210150,2016,0,0,5,5,0.0
210150,2017,5,0,1,6,83.33333333333334
210150,2018,1,0,3,4,25.0
210150,2019,0,0,8,8,0.0
210150,2020,0,0,7,7,0.0
210160,2012,19,0,2,21,90.47619047619048
210160,2013,29,1,2,32,93.75
210160,2014,25,2,2,29,93.10344827586206
210160,2015,21,5,2,28,92.85714285714286
210160,2016,29,1,3,33,90.9090909090909
210160,2017,31,0,0,31,100.0
210160,2018,25,0,0,25,100.0
210160,2019,25,0,0,25,100.0
210160,2020,36,0,8,44,81.81818181818183
210170,2012,5,4,2,11,81.81818181818183
210170,2013,14,0,1,15,93.33333333333333
210170,2014,13,0,0,13,100.0
210170,2015,18,0,0,18,100.0
210170,2016,14,0,0,14,100.0
210170,2017,15,0,0,15,100.0
210170,2018,12,0,1,13,92.3076923076923
210170,2019,20,0,0,20,100.0
210170,2020,15,0,0,15,100.0
210173,2013,0,0,2,2,0.0
210173,2014,1,0,0,1,100.0
210173,2015,3,0,0,3,100.0
210173,2017,4,0,0,4,100.0
210173,2018,5,0,0,5,100.0
210173,2019,3,0,0,3,100.0
210173,2020,1,0,0,1,100.0
210177,2012,3,0,1,4,75.0
210177,2013,5,0,0,5,100.0
210177,2014,5,1,0,6,100.0
210177,2015,3,0,0,3,100.0
210177,2016,6,0,0,6,100.0
210177,2018,3,0,0,3,100.0
210177,2019,4,0,0,4,100.0
210177,2020,4,0,0,4,100.0
210180,2012,0,0,1,1,0.0
210180,2013,0,0,1,1,0.0
210180,2014,1,0,1,2,50.0
210180,2016,0,0,1,1,0.0
210180,2018,0,0,4,4,0.0
210190,2012,0,2,3,5,40.0
210190,2013,1,0,1,2,50.0
210190,2014,2,0,1,3,66.66666666666666
210190,2015,0,0,1,1,0.0
210190,2016,0,0,3,3,0.0
210190,2017,8,0,0,8,100.0
210190,2018,5,0,0,5,100.0
210190,2019,6,0,0,6,100.0
210190,2020,9,0,0,9,100.0
210193,2012,1,0,2,3,33.33333333333333
210193,2013,0,0,1,1,0.0
210193,2014,0,0,1,1,0.0
210193,2015,0,0,1,1,0.0
210193,2016,0,0,2,2,0.0
210193,2017,1,0,0,1,100.0
210193,2018,3,0,0,3,100.0
210193,2019,1,0,1,2,50.0
210197,2012,0,0,5,5,0.0
210197,2014,1,0,1,2,50.0
210197,2015,0,0,1,1,0.0
210197,2016,0,0,3,3,0.0
210197,2017,1,0,0,1,100.0
210197,2018,3,0,0,3,100.0
210197,2020,0,0,2,2,0.0
210200,2012,12,0,0,12,100.0
210200,2013,10,2,3,15,80.0
210200,2014,9,0,1,10,90.0
210200,2015,9,0,0,9,100.0
210200,2016,14,0,0,14,100.0
210200,2017,10,0,0,10,100.0
210200,2018,17,0,0,17,100.0
210200,2019,14,0,0,14,100.0
210200,2020,10,0,0,10,100.0
210203,2012,10,0,1,11,90.9090909090909
210203,2013,4,0,0,4,100.0
210203,2014,12,0,0,12,100.0
210203,2015,9,0,3,12,75.0
210203,2016,10,0,1,11,90.9090909090909
210203,2017,9,0,0,9,100.0
210203,2018,8,0,0,8,100.0
210203,2019,4,0,1,5,80.0
210203,2020,13,0,0,13,100.0
210207,2012,1,0,5,6,16.666666666666664
210207,2013,0,0,2,2,0.0
210207,2014,0,0,4,4,0.0
210207,2015,0,0,2,2,0.0
210207,2016,3,0,3,6,50.0
210207,2017,4,0,0,4,100.0
210207,2018,2,2,0,4,100.0
210207,2019,2,0,0,2,100.0
210207,2020,1,0,3,4,25.0
210210,2012,6,0,1,7,85.71428571428571
210210,2013,5,0,2,7,71.42857142857143
210210,2014,8,0,1,9,88.88888888888889
210210,2015,2,0,2,4,50.0
210210,2016,8,0,1,9,88.88888888888889
210210,2017,11,0,0,11,100.0
210210,2018,7,0,1,8,87.5
210210,2019,4,0,7,11,36.36363636363637
210210,2020,13,0,0,13,100.0
210215,2012,0,0,7,7,0.0
210215,2014,0,0,3,3,0.0
210215,2015,0,1,1,2,50.0
210215,2016,2,0,0,2,100.0
210215,2017,3,0,0,3,100.0
210215,2018,1,0,1,2,50.0
210215,2019,3,0,1,4,75.0
210215,2020,1,0,0,1,100.0
210220,2012,2,0,5,7,28.57142857142857
210220,2013,1,1,4,6,33.33333333333333
210220,2014,0,0,6,6,0.0
210220,2015,1,1,2,4,50.0
210220,2016,3,0,1,4,75.0
210220,2017,12,0,0,12,100.0
210220,2018,5,0,0,5,100.0
210220,2019,9,0,0,9,100.0
210220,2020,3,0,2,5,60.0
210230,2012,1,2,3,6,50.0
210230,2013,0,0,7,7,0.0
210230,2014,0,0,11,11,0.0
210230,2015,5,0,0,5,100.0
210230,2016,6,5,0,11,100.0
210230,2017,1,3,0,4,100.0
210230,2018,0,4,1,5,80.0
210230,2019,2,0,5,7,28.57142857142857
210230,2020,1,0,8,9,11.11111111111111
210232,2012,1,0,17,18,5.555555555555555
210232,2013,23,0,2,25,92.0
210232,2014,14,0,6,20,70.0
210232,2015,17,0,1,18,94.44444444444444
210232,2016,24,0,0,24,100.0
210232,2017,21,0,0,21,100.0
210232,2018,25,0,1,26,96.15384615384616
210232,2019,14,0,4,18,77.77777777777779
210232,2020,22,0,5,27,81.48148148148148
210235,2012,3,0,0,3,100.0
210235,2013,4,0,1,5,80.0
210235,2014,3,0,0,3,100.0
210235,2015,2,0,2,4,50.0
210235,2016,3,0,0,3,100.0
210235,2017,2,0,4,6,33.33333333333333
210235,2018,8,0,0,8,100.0
210235,2019,2,0,0,2,100.0
210235,2020,2,0,0,2,100.0
210237,2012,0,0,4,4,0.0
210237,2013,0,1,3,4,25.0
210237,2014,0,2,1,3,66.66666666666666
210237,2015,1,0,0,1,100.0
210237,2016,0,0,3,3,0.0
210237,2017,3,0,0,3,100.0
210237,2018,4,0,0,4,100.0
210237,2020,3,0,0,3,100.0
210240,2012,0,0,3,3,0.0
210240,2013,0,0,1,1,0.0
210240,2014,0,1,1,2,50.0
210240,2015,0,0,3,3,0.0
210240,2017,1,0,0,1,100.0
210240,2018,3,0,1,4,75.0
210240,2019,1,0,1,2,50.0
210240,2020,0,0,4,4,0.0
210250,2012,0,0,2,2,0.0
210250,2013,0,0,6,6,0.0
210250,2014,1,2,10,13,23.076923076923077
210250,2015,0,1,1,2,50.0
210250,2016,5,0,1,6,83.33333333333334
210250,2017,7,0,0,7,100.0
210250,2018,3,0,1,4,75.0
210250,2019,2,0,1,3,66.66666666666666
210250,2020,0,0,3,3,0.0
210255,2012,2,0,1,3,66.66666666666666
210255,2013,4,0,1,5,80.0
210255,2014,5,0,0,5,100.0
210255,2015,4,0,0,4,100.0
210255,2016,3,0,0,3,100.0
210255,2017,6,0,0,6,100.0
210255,2018,10,0,0,10,100.0
210255,2019,6,0,0,6,100.0
210255,2020,7,0,1,8,87.5
210260,2012,10,0,0,10,100.0
210260,2013,1,0,0,1,100.0
210260,2014,5,0,0,5,100.0
210260,2015,6,0,0,6,100.0
210260,2016,7,0,0,7,100.0
210260,2017,5,0,0,5,100.0
210260,2018,6,0,0,6,100.0
210260,2019,4,0,0,4,100.0
210260,2020,4,0,0,4,100.0
210270,2012,6,0,1,7,85.71428571428571
210270,2013,2,0,1,3,66.66666666666666
210270,2014,0,1,10,11,9.090909090909092
210270,2015,7,0,0,7,100.0
210270,2016,9,0,0,9,100.0
210270,2017,6,0,0,6,100.0
210270,2018,4,0,0,4,100.0
210270,2019,4,0,0,4,100.0
210270,2020,10,0,0,10,100.0
210275,2012,5,0,0,5,100.0
210275,2013,6,0,0,6,100.0
210275,2014,4,0,1,5,80.0
210275,2015,1,0,0,1,100.0
210275,2016,2,0,0,2,100.0
210275,2017,4,0,0,4,100.0
210275,2018,3,0,0,3,100.0
210275,2019,5,0,0,5,100.0
210275,2020,3,0,0,3,100.0
210280,2012,1,0,6,7,14.285714285714285
210280,2013,3,0,0,3,100.0
210280,2014,7,0,2,9,77.77777777777779
210280,2015,2,3,7,12,41.66666666666667
210280,2016,8,0,1,9,88.88888888888889
210280,2017,3,1,2,6,66.66666666666666
210280,2018,9,0,1,10,90.0
210280,2019,7,0,3,10,70.0
210280,2020,13,0,0,13,100.0
210290,2012,0,5,4,9,55.55555555555556
210290,2013,0,0,10,10,0.0
210290,2014,0,0,2,2,0.0
210290,2015,1,0,5,6,16.666666666666664
210290,2016,9,0,2,11,81.81818181818183
210290,2017,9,0,0,9,100.0
210290,2018,6,0,0,6,100.0
210290,2019,10,0,0,10,100.0
210290,2020,4,0,2,6,66.66666666666666
210300,2012,54,0,0,54,100.0
210300,2013,48,2,2,52,96.15384615384616
210300,2014,58,0,0,58,100.0
210300,2015,47,0,0,47,100.0
210300,2016,57,0,0,57,100.0
210300,2017,53,0,0,53,100.0
210300,2018,52,0,0,52,100.0
210300,2019,34,0,0,34,100.0
210300,2020,61,0,0,61,100.0
210310,2012,0,1,2,3,33.33333333333333
210310,2015,1,0,0,1,100.0
210310,2016,2,0,1,3,66.66666666666666
210310,2017,3,0,0,3,100.0
210310,2018,2,0,0,2,100.0
210310,2019,0,0,1,1,0.0
210310,2020,0,0,3,3,0.0
210312,2013,0,0,2,2,0.0
210312,2015,0,0,1,1,0.0
210312,2016,2,0,3,5,40.0
210312,2017,2,0,1,3,66.66666666666666
210312,2019,3,0,0,3,100.0
210312,2020,0,0,1,1,0.0
210315,2012,1,0,3,4,25.0
210315,2013,0,0,1,1,0.0
210315,2014,0,0,3,3,0.0
210315,2015,1,0,1,2,50.0
210315,2018,0,0,1,1,0.0
210315,2019,0,0,4,4,0.0
210315,2020,1,0,0,1,100.0
210317,2012,3,0,0,3,100.0
210317,2013,1,0,0,1,100.0
210317,2015,4,0,0,4,100.0
210317,2016,7,0,0,7,100.0
210317,2017,5,0,0,5,100.0
210317,2018,3,0,3,6,50.0
210317,2019,4,0,5,9,44.44444444444444
210317,2020,5,0,0,5,100.0
210320,2012,16,0,3,19,84.21052631578947
210320,2013,20,0,0,20,100.0
210320,2014,36,0,0,36,100.0
210320,2015,23,0,0,23,100.0
210320,2016,22,0,4,26,84.61538461538461
210320,2017,23,0,0,23,100.0
210320,2018,26,0,1,27,96.29629629629629
210320,2019,32,0,2,34,94.11764705882352
210320,2020,25,0,4,29,86.20689655172413
210325,2012,0,0,5,5,0.0
210325,2013,0,0,3,3,0.0
210325,2014,0,0,3,3,0.0
210325,2015,5,0,4,9,55.55555555555556
210325,2016,3,0,3,6,50.0
210325,2018,3,0,0,3,100.0
210325,2019,5,0,0,5,100.0
210325,2020,1,0,1,2,50.0
210330,2012,36,0,0,36,100.0
210330,2013,33,0,1,34,97.05882352941177
210330,2014,39,0,1,40,97.5
210330,2015,43,0,0,43,100.0
210330,2016,50,0,0,50,100.0
210330,2017,39,0,0,39,100.0
210330,2018,40,0,0,40,100.0
210330,2019,40,0,1,41,97.5609756097561
210330,2020,56,0,0,56,100.0
210340,2012,18,0,1,19,94.73684210526315
210340,2013,18,0,1,19,94.73684210526315
210340,2014,12,0,0,12,100.0
210340,2015,11,1,0,12,100.0
210340,2016,20,0,0,20,100.0
210340,2017,15,0,0,15,100.0
210340,2018,13,0,0,13,100.0
210340,2019,13,0,0,13,100.0
210340,2020,20,0,0,20,100.0
210350,2012,2,0,10,12,16.666666666666664
210350,2013,3,1,2,6,66.66666666666666
210350,2014,3,1,5,9,44.44444444444444
210350,2015,7,2,6,15,60.0
210350,2016,9,1,7,17,58.82352941176471
210350,2017,15,0,0,15,100.0
210350,2018,8,0,0,8,100.0
210350,2019,14,0,0,14,100.0
210350,2020,19,0,3,22,86.36363636363636
210355,2012,0,1,3,4,25.0
210355,2013,0,1,4,5,20.0
210355,2014,0,1,3,4,25.0
210355,2015,0,0,1,1,0.0
210355,2016,1,0,3,4,25.0
210355,2018,6,0,0,6,100.0
210355,2019,4,0,0,4,100.0
210355,2020,4,0,0,4,100.0
210360,2012,2,2,24,28,14.285714285714285
210360,2013,7,1,9,17,47.05882352941176
210360,2014,21,2,1,24,95.83333333333334
210360,2015,1,1,19,21,9.523809523809524
210360,2016,22,0,1,23,95.65217391304348
210360,2017,14,0,1,15,93.33333333333333
210360,2018,22,0,0,22,100.0
210360,2019,23,0,1,24,95.83333333333334
210360,2020,19,0,1,20,95.0
210370,2012,3,1,7,11,36.36363636363637
210370,2013,12,0,0,12,100.0
210370,2014,9,0,0,9,100.0
210370,2015,7,0,0,7,100.0
210370,2016,7,0,1,8,87.5
210370,2017,7,0,0,7,100.0
210370,2018,11,0,0,11,100.0
210370,2019,12,0,0,12,100.0
210370,2020,13,0,2,15,86.66666666666667
210375,2012,0,0,4,4,0.0
210375,2013,2,0,0,2,100.0
210375,2014,7,0,0,7,100.0
210375,2015,1,0,4,5,20.0
210375,2016,0,0,6,6,0.0
210375,2017,4,0,0,4,100.0
210375,2018,6,0,0,6,100.0
210375,2019,3,0,2,5,60.0
210375,2020,3,0,1,4,75.0
210380,2012,2,0,11,13,15.384615384615385
210380,2013,1,0,8,9,11.11111111111111
210380,2014,1,1,0,2,100.0
210380,2015,3,0,6,9,33.33333333333333
210380,2016,2,6,5,13,61.53846153846154
210380,2017,9,0,0,9,100.0
210380,2018,3,0,1,4,75.0
210380,2019,4,0,1,5,80.0
210380,2020,6,0,0,6,100.0
210390,2012,2,1,0,3,100.0
210390,2013,0,1,0,1,100.0
210390,2014,2,0,0,2,100.0
210390,2015,1,0,0,1,100.0
210390,2016,2,0,1,3,66.66666666666666
210390,2017,2,0,0,2,100.0
210390,2018,3,0,0,3,100.0
210390,2019,4,0,0,4,100.0
210390,2020,3,0,0,3,100.0
210400,2012,3,0,0,3,100.0
210400,2013,5,0,0,5,100.0
210400,2014,3,1,3,7,57.14285714285714
210400,2015,3,0,0,3,100.0
210400,2016,6,0,0,6,100.0
210400,2017,9,0,0,9,100.0
210400,2018,3,0,0,3,100.0
210400,2019,6,0,0,6,100.0
210400,2020,9,0,0,9,100.0
210405,2012,8,0,0,8,100.0
210405,2013,9,0,0,9,100.0
210405,2014,9,0,0,9,100.0
210405,2015,11,0,0,11,100.0
210405,2016,14,0,0,14,100.0
210405,2017,13,0,0,13,100.0
210405,2018,17,0,0,17,100.0
210405,2019,11,0,0,11,100.0
210405,2020,12,0,0,12,100.0
210407,2012,0,0,2,2,0.0
210407,2013,0,0,5,5,0.0
210407,2016,2,0,1,3,66.66666666666666
210407,2017,2,0,0,2,100.0
210407,2019,2,0,0,2,100.0
210407,2020,0,0,3,3,0.0
210408,2012,0,0,2,2,0.0
210408,2013,0,1,1,2,50.0
210408,2014,0,0,2,2,0.0
210408,2015,0,0,4,4,0.0
210408,2016,0,1,2,3,33.33333333333333
210408,2017,4,0,0,4,100.0
210408,2018,2,0,0,2,100.0
210408,2019,4,0,0,4,100.0
210408,2020,6,0,0,6,100.0
210409,2012,0,0,1,1,0.0
210409,2013,4,0,0,4,100.0
210409,2014,5,0,2,7,71.42857142857143
210409,2015,1,0,0,1,100.0
210409,2016,6,0,1,7,85.71428571428571
210409,2017,2,0,0,2,100.0
210409,2018,4,0,0,4,100.0
210409,2019,7,0,0,7,100.0
210409,2020,5,0,1,6,83.33333333333334
210410,2012,0,0,3,3,0.0
210410,2013,4,0,0,4,100.0
210410,2014,5,0,0,5,100.0
210410,2015,7,0,0,7,100.0
210410,2016,0,0,6,6,0.0
210410,2017,5,0,0,5,100.0
210410,2018,3,0,0,3,100.0
210410,2019,3,0,0,3,100.0
210410,2020,2,0,0,2,100.0
210420,2012,0,3,1,4,75.0
210420,2013,1,1,2,4,50.0
210420,2014,0,3,5,8,37.5
210420,2015,3,4,1,8,87.5
210420,2016,3,3,1,7,85.71428571428571
210420,2017,4,0,0,4,100.0
210420,2018,9,0,0,9,100.0
210420,2019,1,0,0,1,100.0
210420,2020,10,0,2,12,83.33333333333334
210430,2012,2,0,2,4,50.0
210430,2013,2,0,3,5,40.0
210430,2014,0,0,4,4,0.0
210430,2015,1,0,0,1,100.0
210430,2016,2,0,0,2,100.0
210430,2017,4,0,0,4,100.0
210430,2018,2,0,0,2,100.0
210430,2019,3,0,1,4,75.0
210430,2020,4,0,1,5,80.0
210440,2012,4,0,4,8,50.0
210440,2013,1,0,1,2,50.0
210440,2014,1,0,1,2,50.0
210440,2015,1,0,2,3,33.33333333333333
210440,2016,1,0,0,1,100.0
210440,2017,2,0,1,3,66.66666666666666
210440,2018,1,0,0,1,100.0
210440,2019,1,0,3,4,25.0
210440,2020,1,0,4,5,20.0
210450,2013,0,0,4,4,0.0
210450,2014,0,0,6,6,0.0
210450,2015,1,0,2,3,33.33333333333333
210450,2016,2,0,2,4,50.0
210450,2017,4,0,2,6,66.66666666666666
210450,2018,1,0,1,2,50.0
210450,2019,1,0,2,3,33.33333333333333
210450,2020,1,0,3,4,25.0
210455,2012,0,0,6,6,0.0
210455,2013,4,0,0,4,100.0
210455,2014,9,0,0,9,100.0
210455,2015,8,0,0,8,100.0
210455,2016,8,0,0,8,100.0
210455,2017,10,0,0,10,100.0
210455,2018,4,0,0,4,100.0
210455,2019,6,0,0,6,100.0
210455,2020,5,0,0,5,100.0
210460,2012,1,0,2,3,33.33333333333333
210460,2013,2,0,4,6,33.33333333333333
210460,2014,0,0,5,5,0.0
210460,2015,1,0,3,4,25.0
210460,2016,3,2,2,7,71.42857142857143
210460,2017,4,0,0,4,100.0
210460,2018,2,0,3,5,40.0
210460,2019,8,0,1,9,88.88888888888889
210460,2020,2,0,0,2,100.0
210462,2012,0,0,2,2,0.0
210462,2013,1,0,1,2,50.0
210462,2014,0,0,1,1,0.0
210462,2015,2,0,2,4,50.0
210462,2016,0,0,1,1,0.0
210462,2019,2,0,2,4,50.0
210462,2020,1,0,3,4,25.0
210465,2012,1,0,0,1,100.0
210465,2013,0,1,0,1,100.0
210465,2014,5,0,0,5,100.0
210465,2015,1,0,1,2,50.0
210465,2016,4,0,0,4,100.0
210465,2017,2,0,0,2,100.0
210465,2018,2,0,0,2,100.0
210465,2019,3,0,0,3,100.0
210465,2020,2,0,0,2,100.0
210467,2012,0,0,12,12,0.0
210467,2013,0,1,6,7,14.285714285714285
210467,2014,0,1,6,7,14.285714285714285
210467,2015,0,1,6,7,14.285714285714285
210467,2016,2,1,1,4,75.0
210467,2017,6,0,2,8,75.0
210467,2018,5,0,0,5,100.0
210467,2019,3,1,2,6,66.66666666666666
210467,2020,8,0,4,12,66.66666666666666
210470,2012,0,0,3,3,0.0
210470,2013,0,1,2,3,33.33333333333333
210470,2014,1,1,1,3,66.66666666666666
210470,2015,0,0,1,1,0.0
210470,2016,3,0,1,4,75.0
210470,2017,1,0,0,1,100.0
210470,2018,0,0,2,2,0.0
210470,2019,1,0,2,3,33.33333333333333
210470,2020,0,0,2,2,0.0
210480,2012,7,0,14,21,33.33333333333333
210480,2013,25,0,0,25,100.0
210480,2014,30,0,0,30,100.0
210480,2015,16,0,7,23,69.56521739130434
210480,2016,22,0,9,31,70.96774193548387
210480,2017,24,0,0,24,100.0
210480,2018,28,0,0,28,100.0
210480,2019,18,0,0,18,100.0
210480,2020,36,0,0,36,100.0
210490,2012,0,0,3,3,0.0
210490,2013,1,0,1,2,50.0
210490,2014,0,0,2,2,0.0
210490,2015,1,0,0,1,100.0
210490,2016,6,0,0,6,100.0
210490,2017,1,0,0,1,100.0
210490,2019,3,0,0,3,100.0
210490,2020,3,0,0,3,100.0
210500,2012,10,0,0,10,100.0
210500,2013,11,0,1,12,91.66666666666666
210500,2014,3,0,0,3,100.0
210500,2015,7,0,0,7,100.0
210500,2016,10,0,0,10,100.0
210500,2017,7,0,0,7,100.0
210500,2018,9,0,0,9,100.0
210500,2019,5,0,0,5,100.0
210500,2020,8,0,2,10,80.0
210510,2012,1,0,3,4,25.0
210510,2013,0,1,3,4,25.0
210510,2014,0,1,4,5,20.0
210510,2015,1,1,2,4,50.0
210510,2016,7,0,1,8,87.5
210510,2017,5,0,0,5,100.0
210510,2018,4,0,2,6,66.66666666666666
210510,2019,9,0,0,9,100.0
210510,2020,4,3,2,9,77.77777777777779
210515,2012,3,0,0,3,100.0
210515,2013,2,0,2,4,50.0
210515,2014,3,4,2,9,77.77777777777779
210515,2015,2,1,2,5,60.0
210515,2016,1,0,1,2,50.0
210515,2017,7,0,1,8,87.5
210515,2018,5,0,2,7,71.42857142857143
210515,2019,6,0,0,6,100.0
210515,2020,5,0,0,5,100.0
210520,2012,2,0,2,4,50.0
210520,2013,0,0,3,3,0.0
210520,2014,0,0,2,2,0.0
210520,2015,0,0,2,2,0.0
210520,2016,2,1,0,3,100.0
210520,2017,2,0,0,2,100.0
210520,2018,4,0,0,4,100.0
210520,2019,2,0,0,2,100.0
210520,2020,1,0,0,1,100.0
210530,2012,112,0,0,112,100.0
210530,2013,107,1,3,111,97.2972972972973
210530,2014,106,0,0,106,100.0
210530,2015,104,0,0,104,100.0
210530,2016,118,0,1,119,99.15966386554622
210530,2017,102,0,1,103,99.02912621359224
210530,2018,99,0,0,99,100.0
210530,2019,101,0,0,101,100.0
210530,2020,105,0,2,107,98.13084112149532
210535,2012,3,0,0,3,100.0
210535,2013,4,0,0,4,100.0
210535,2014,0,0,6,6,0.0
210535,2015,2,0,0,2,100.0
210535,2016,6,0,0,6,100.0
210535,2017,6,0,0,6,100.0
210535,2018,3,0,0,3,100.0
210535,2019,1,0,1,2,50.0
210535,2020,9,0,2,11,81.81818181818183
210540,2012,15,0,3,18,83.33333333333334
210540,2013,24,0,2,26,92.3076923076923
210540,2014,17,0,0,17,100.0
210540,2015,21,2,2,25,92.0
210540,2016,17,0,0,17,100.0
210540,2017,17,0,0,17,100.0
210540,2018,25,0,0,25,100.0
210540,2019,22,0,0,22,100.0
210540,2020,25,0,3,28,89.28571428571429
210542,2012,4,0,6,10,40.0
210542,2013,2,0,6,8,25.0
210542,2014,14,0,1,15,93.33333333333333
210542,2015,11,0,0,11,100.0
210542,2016,11,0,0,11,100.0
210542,2017,10,0,1,11,90.9090909090909
210542,2018,5,0,0,5,100.0
210542,2019,2,0,2,4,50.0
210542,2020,6,0,9,15,40.0
210545,2012,4,0,0,4,100.0
210545,2013,2,0,0,2,100.0
210545,2014,2,0,2,4,50.0
210545,2015,2,0,0,2,100.0
210545,2016,1,0,2,3,33.33333333333333
210545,2017,0,0,1,1,0.0
210545,2019,1,0,1,2,50.0
210545,2020,1,0,3,4,25.0
210547,2012,1,0,1,2,50.0
210547,2013,0,0,2,2,0.0
210547,2014,0,1,3,4,25.0
210547,2015,0,1,2,3,33.33333333333333
210547,2016,0,0,3,3,0.0
210547,2017,4,0,0,4,100.0
210547,2018,3,0,0,3,100.0
210547,2019,5,0,0,5,100.0
210547,2020,6,0,0,6,100.0
210550,2012,4,0,1,5,80.0
210550,2013,7,0,2,9,77.77777777777779
210550,2014,12,0,0,12,100.0
210550,2015,10,0,0,10,100.0
210550,2016,10,0,3,13,76.92307692307693
210550,2017,3,0,2,5,60.0
210550,2018,5,0,0,5,100.0
210550,2019,7,0,5,12,58.333333333333336
210550,2020,8,0,7,15,53.333333333333336
210560,2013,1,1,2,4,50.0
210560,2014,2,0,0,2,100.0
210560,2015,4,0,0,4,100.0
210560,2016,4,0,0,4,100.0
210560,2017,1,0,0,1,100.0
210560,2018,4,0,0,4,100.0
210560,2019,5,0,0,5,100.0
210560,2020,8,0,0,8,100.0
210565,2013,1,0,0,1,100.0
210565,2014,0,0,1,1,0.0
210565,2015,0,0,1,1,0.0
210565,2016,2,0,0,2,100.0
210565,2017,3,0,0,3,100.0
210565,2018,1,0,0,1,100.0
210565,2019,2,0,0,2,100.0
210565,2020,1,0,0,1,100.0
210570,2012,9,0,1,10,90.0
210570,2013,15,0,0,15,100.0
210570,2014,10,0,0,10,100.0
210570,2015,14,0,0,14,100.0
210570,2016,10,0,0,10,100.0
210570,2017,11,0,0,11,100.0
210570,2018,13,0,0,13,100.0
210570,2019,15,0,0,15,100.0
210570,2020,14,0,0,14,100.0
210580,2012,0,0,6,6,0.0
210580,2013,0,1,1,2,50.0
210580,2014,0,1,0,1,100.0
210580,2015,0,0,2,2,0.0
210580,2016,1,0,3,4,25.0
210580,2017,2,0,0,2,100.0
210580,2018,1,0,2,3,33.33333333333333
210580,2019,4,0,1,5,80.0
210580,2020,1,0,0,1,100.0
210590,2012,0,0,5,5,0.0
210590,2013,0,0,4,4,0.0
210590,2014,0,0,1,1,0.0
210590,2015,0,1,6,7,14.285714285714285
210590,2016,1,1,0,2,100.0
210590,2017,3,0,0,3,100.0
210590,2018,3,0,0,3,100.0
210590,2019,5,0,0,5,100.0
210590,2020,2,0,4,6,33.33333333333333
210592,2013,1,0,0,1,100.0
210592,2014,1,0,0,1,100.0
210592,2015,4,0,0,4,100.0
210592,2016,0,0,1,1,0.0
210592,2017,2,0,0,2,100.0
210592,2018,2,0,0,2,100.0
210592,2019,3,0,0,3,100.0
210592,2020,4,0,0,4,100.0
210594,2012,0,0,7,7,0.0
210594,2013,1,0,2,3,33.33333333333333
210594,2014,0,1,2,3,33.33333333333333
210594,2015,0,0,1,1,0.0
210594,2016,1,0,3,4,25.0
210594,2017,4,0,0,4,100.0
210594,2018,8,0,0,8,100.0
210594,2019,3,0,0,3,100.0
210594,2020,2,0,1,3,66.66666666666666
210596,2012,0,0,5,5,0.0
210596,2013,1,1,3,5,40.0
210596,2014,0,0,1,1,0.0
210596,2015,0,0,3,3,0.0
210596,2016,0,0,1,1,0.0
210596,2017,1,0,0,1,100.0
210596,2018,1,0,0,1,100.0
210596,2019,6,0,0,6,100.0
210596,2020,2,0,0,2,100.0
210598,2013,1,0,0,1,100.0
210598,2014,3,0,0,3,100.0
210598,2016,1,1,0,2,100.0
210598,2017,1,0,0,1,100.0
210598,2018,1,0,1,2,50.0
210598,2019,3,0,0,3,100.0
210598,2020,5,0,0,5,100.0
210600,2012,0,1,2,3,33.33333333333333
210600,2013,1,0,3,4,25.0
210600,2014,0,0,5,5,0.0
210600,2015,0,1,4,5,20.0
210600,2016,0,0,5,5,0.0
210600,2017,4,0,0,4,100.0
210600,2018,2,0,1,3,66.66666666666666
210600,2019,4,1,1,6,83.33333333333334
210600,2020,0,1,4,5,20.0
210610,2012,6,0,0,6,100.0
210610,2013,2,0,0,2,100.0
210610,2014,1,0,0,1,100.0
210610,2015,0,0,3,3,0.0
210610,2016,2,0,0,2,100.0
210610,2017,6,0,0,6,100.0
210610,2018,5,0,0,5,100.0
210610,2019,4,0,0,4,100.0
210610,2020,1,0,0,1,100.0
210620,2014,0,0,1,1,0.0
210620,2015,1,0,4,5,20.0
210620,2016,0,0,1,1,0.0
210620,2017,0,0,1,1,0.0
210620,2018,1,0,2,3,33.33333333333333
210620,2019,2,0,1,3,66.66666666666666
210620,2020,0,2,3,5,40.0
210630,2012,0,0,7,7,0.0
210630,2013,0,0,5,5,0.0
210630,2014,0,0,5,5,0.0
210630,2015,3,0,1,4,75.0
210630,2016,3,0,0,3,100.0
210630,2017,3,0,0,3,100.0
210630,2018,2,0,0,2,100.0
210630,2019,3,0,0,3,100.0
210630,2020,3,0,0,3,100.0
210632,2012,1,0,6,7,14.285714285714285
210632,2013,5,1,0,6,100.0
210632,2014,3,0,2,5,60.0
210632,2015,2,0,4,6,33.33333333333333
210632,2016,0,0,4,4,0.0
210632,2017,8,0,0,8,100.0
210632,2018,6,0,1,7,85.71428571428571
210632,2019,7,0,1,8,87.5
210632,2020,5,0,0,5,100.0
210635,2012,0,0,1,1,0.0
210635,2013,0,1,2,3,33.33333333333333
210635,2014,0,1,0,1,100.0
210635,2015,0,0,3,3,0.0
210635,2016,1,1,0,2,100.0
210635,2017,2,0,0,2,100.0
210635,2018,2,0,1,3,66.66666666666666
210635,2019,1,0,0,1,100.0
210635,2020,1,0,2,3,33.33333333333333
210637,2012,2,0,0,2,100.0
210637,2013,4,0,0,4,100.0
210637,2014,0,0,2,2,0.0
210637,2015,0,0,4,4,0.0
210637,2016,2,0,1,3,66.66666666666666
210637,2017,3,0,1,4,75.0
210637,2018,2,0,1,3,66.66666666666666
210637,2019,1,0,0,1,100.0
210637,2020,0,1,4,5,20.0
210640,2012,2,0,0,2,100.0
210640,2013,1,0,3,4,25.0
210640,2014,0,1,1,2,50.0
210640,2015,1,0,1,2,50.0
210640,2016,2,0,0,2,100.0
210640,2017,7,0,0,7,100.0
210640,2018,4,0,0,4,100.0
210640,2019,2,0,0,2,100.0
210640,2020,10,0,0,10,100.0
210650,2012,0,0,4,4,0.0
210650,2013,0,0,4,4,0.0
210650,2014,0,0,5,5,0.0
210650,2015,0,0,3,3,0.0
210650,2016,3,0,2,5,60.0
210650,2017,9,0,0,9,100.0
210650,2018,12,0,1,13,92.3076923076923
210650,2019,9,0,0,9,100.0
210650,2020,4,0,0,4,100.0
210660,2012,6,0,0,6,100.0
210660,2013,2,0,8,10,20.0
210660,2014,1,0,6,7,14.285714285714285
210660,2015,0,0,4,4,0.0
210660,2016,1,0,4,5,20.0
210660,2017,9,0,0,9,100.0
210660,2018,6,0,0,6,100.0
210660,2019,10,0,0,10,100.0
210660,2020,12,0,2,14,85.71428571428571
210663,2012,2,0,0,2,100.0
210663,2013,1,0,0,1,100.0
210663,2014,0,0,2,2,0.0
210663,2015,2,1,1,4,75.0
210663,2016,2,0,0,2,100.0
210663,2017,2,0,0,2,100.0
210663,2018,5,0,0,5,100.0
210663,2019,2,0,0,2,100.0
210663,2020,6,0,0,6,100.0
210667,2012,0,0,1,1,0.0
210667,2014,0,0,1,1,0.0
210667,2015,0,0,1,1,0.0
210667,2017,3,0,0,3,100.0
210667,2019,1,0,1,2,50.0
210667,2020,2,0,0,2,100.0
210670,2012,1,0,8,9,11.11111111111111
210670,2013,0,0,5,5,0.0
210670,2014,0,0,3,3,0.0
210670,2015,0,0,2,2,0.0
210670,2016,1,0,0,1,100.0
210670,2017,7,0,0,7,100.0
210670,2018,5,0,6,11,45.45454545454545
210670,2019,1,0,1,2,50.0
210670,2020,7,0,0,7,100.0
210675,2012,5,1,3,9,66.66666666666666
210675,2013,3,0,2,5,60.0
210675,2014,0,0,4,4,0.0
210675,2015,0,1,5,6,16.666666666666664
210675,2016,10,0,0,10,100.0
210675,2017,6,0,0,6,100.0
210675,2018,7,0,0,7,100.0
210675,2019,7,0,0,7,100.0
210675,2020,10,0,0,10,100.0
210680,2012,0,0,2,2,0.0
210680,2013,0,0,1,1,0.0
210680,2014,0,0,3,3,0.0
210680,2015,0,1,2,3,33.33333333333333
210680,2016,4,0,0,4,100.0
210680,2017,4,0,0,4,100.0
210680,2018,3,0,0,3,100.0
210680,2019,6,0,1,7,85.71428571428571
210680,2020,3,0,0,3,100.0
210690,2012,9,0,2,11,81.81818181818183
210690,2013,10,0,4,14,71.42857142857143
210690,2014,3,0,5,8,37.5
210690,2015,14,0,0,14,100.0
210690,2016,12,0,3,15,80.0
210690,2017,11,0,0,11,100.0
210690,2018,13,0,0,13,100.0
210690,2019,7,1,0,8,100.0
210690,2020,8,0,0,8,100.0
210700,2012,0,0,2,2,0.0
210700,2013,1,0,0,1,100.0
210700,2014,1,0,3,4,25.0
210700,2015,3,0,1,4,75.0
210700,2016,4,0,0,4,100.0
210700,2017,4,0,0,4,100.0
210700,2018,1,0,0,1,100.0
210700,2019,3,0,0,3,100.0
210700,2020,3,0,0,3,100.0
210710,2012,0,1,3,4,25.0
210710,2013,0,1,2,3,33.33333333333333
210710,2014,1,0,1,2,50.0
210710,2015,0,3,4,7,42.857142857142854
210710,2016,0,1,3,4,25.0
210710,2017,5,0,1,6,83.33333333333334
210710,2018,2,0,3,5,40.0
210710,2019,1,0,1,2,50.0
210710,2020,0,0,4,4,0.0
210720,2012,1,0,2,3,33.33333333333333
210720,2013,0,0,1,1,0.0
210720,2014,4,0,0,4,100.0
210720,2015,5,0,0,5,100.0
210720,2016,4,0,0,4,100.0
210720,2017,4,0,0,4,100.0
210720,2018,5,0,0,5,100.0
210720,2019,1,0,0,1,100.0
210720,2020,1,0,0,1,100.0
210725,2014,0,0,3,3,0.0
210725,2015,0,0,1,1,0.0
210725,2016,0,0,1,1,0.0
210725,2017,2,0,0,2,100.0
210725,2019,2,0,0,2,100.0
210725,2020,1,0,0,1,100.0
210730,2012,0,0,1,1,0.0
210730,2013,1,0,0,1,100.0
210730,2016,0,0,1,1,0.0
210730,2018,1,0,0,1,100.0
210735,2012,0,0,3,3,0.0
210735,2013,0,0,6,6,0.0
210735,2014,0,1,4,5,20.0
210735,2015,0,0,4,4,0.0
210735,2016,0,0,6,6,0.0
210735,2017,3,0,0,3,100.0
210735,2018,14,0,0,14,100.0
210735,2019,6,0,0,6,100.0
210735,2020,1,0,2,3,33.33333333333333
210740,2012,2,3,4,9,55.55555555555556
210740,2013,0,4,0,4,100.0
210740,2014,1,0,3,4,25.0
210740,2015,0,1,2,3,33.33333333333333
210740,2016,2,0,6,8,25.0
210740,2017,6,0,0,6,100.0
210740,2018,3,0,0,3,100.0
210740,2019,6,0,3,9,66.66666666666666
210740,2020,2,0,0,2,100.0
210745,2012,0,0,2,2,0.0
210745,2013,0,0,3,3,0.0
210745,2014,2,0,2,4,50.0
210745,2015,6,0,0,6,100.0
210745,2016,1,0,0,1,100.0
210745,2018,3,0,0,3,100.0
210745,2019,4,0,0,4,100.0
210745,2020,4,0,0,4,100.0
210750,2012,25,0,0,25,100.0
210750,2013,37,0,0,37,100.0
210750,2014,29,0,2,31,93.54838709677419
210750,2015,25,1,1,27,96.29629629629629
210750,2016,29,0,0,29,100.0
210750,2017,35,1,1,37,97.2972972972973
210750,2018,49,0,0,49,100.0
210750,2019,37,0,0,37,100.0
210750,2020,63,0,1,64,98.4375
210760,2012,1,0,3,4,25.0
210760,2013,0,2,2,4,50.0
210760,2014,1,0,0,1,100.0
210760,2015,2,1,2,5,60.0
210760,2016,0,1,3,4,25.0
210760,2017,5,0,0,5,100.0
210760,2018,7,0,0,7,100.0
210760,2019,6,0,0,6,100.0
210760,2020,5,0,0,5,100.0
210770,2012,5,0,4,9,55.55555555555556
210770,2013,5,0,1,6,83.33333333333334
210770,2014,5,0,1,6,83.33333333333334
210770,2015,5,0,1,6,83.33333333333334
210770,2016,0,0,5,5,0.0
210770,2017,11,0,1,12,91.66666666666666
210770,2018,4,0,0,4,100.0
210770,2019,3,0,0,3,100.0
210770,2020,8,0,0,8,100.0
210780,2012,7,0,0,7,100.0
210780,2013,11,0,1,12,91.66666666666666
210780,2014,6,0,3,9,66.66666666666666
210780,2015,1,0,5,6,16.666666666666664
210780,2016,0,1,9,10,10.0
210780,2017,8,0,1,9,88.88888888888889
210780,2018,12,0,1,13,92.3076923076923
210780,2019,4,0,4,8,50.0
210780,2020,12,0,0,12,100.0
210790,2012,3,0,1,4,75.0
210790,2013,3,0,1,4,75.0
210790,2014,2,0,3,5,40.0
210790,2015,6,0,2,8,75.0
210790,2016,8,0,0,8,100.0
210790,2017,7,0,0,7,100.0
210790,2018,4,0,0,4,100.0
210790,2019,6,0,1,7,85.71428571428571
210790,2020,6,0,0,6,100.0
210800,2012,0,0,7,7,0.0
210800,2013,2,0,8,10,20.0
210800,2014,0,1,9,10,10.0
210800,2015,0,0,6,6,0.0
210800,2016,0,1,5,6,16.666666666666664
210800,2017,4,0,0,4,100.0
210800,2018,4,0,1,5,80.0
210800,2019,4,0,0,4,100.0
210800,2020,4,0,0,4,100.0
210805,2012,3,0,0,3,100.0
210805,2013,5,0,0,5,100.0
210805,2014,6,0,0,6,100.0
210805,2015,2,0,0,2,100.0
210805,2016,2,0,0,2,100.0
210805,2017,5,0,0,5,100.0
210805,2018,3,0,0,3,100.0
210805,2019,11,0,0,11,100.0
210805,2020,5,0,0,5,100.0
210810,2012,0,4,2,6,66.66666666666666
210810,2013,1,1,5,7,28.57142857142857
210810,2014,0,0,4,4,0.0
210810,2015,1,0,10,11,9.090909090909092
210810,2016,0,0,3,3,0.0
210810,2017,7,0,0,7,100.0
210810,2018,1,0,2,3,33.33333333333333
210810,2019,3,0,7,10,30.0
210810,2020,8,0,0,8,100.0
210820,2012,17,0,0,17,100.0
210820,2013,19,0,0,19,100.0
210820,2014,12,0,3,15,80.0
210820,2015,12,4,1,17,94.11764705882352
210820,2016,9,0,0,9,100.0
210820,2017,15,0,0,15,100.0
210820,2018,16,0,0,16,100.0
210820,2019,22,0,0,22,100.0
210820,2020,15,0,0,15,100.0
210825,2012,0,2,5,7,28.57142857142857
210825,2013,0,2,5,7,28.57142857142857
210825,2014,0,2,2,4,50.0
210825,2015,3,0,2,5,60.0
210825,2016,1,0,3,4,25.0
210825,2017,5,0,0,5,100.0
210825,2018,4,0,2,6,66.66666666666666
210825,2019,4,0,3,7,57.14285714285714
210825,2020,2,0,0,2,100.0
210830,2012,0,1,8,9,11.11111111111111
210830,2013,0,0,7,7,0.0
210830,2014,2,1,10,13,23.076923076923077
210830,2015,5,0,1,6,83.33333333333334
210830,2016,18,0,0,18,100.0
210830,2017,13,0,0,13,100.0
210830,2018,15,0,0,15,100.0
210830,2019,8,0,0,8,100.0
210830,2020,9,0,0,9,100.0
210840,2012,0,1,3,4,25.0
210840,2013,0,0,3,3,0.0
210840,2014,0,0,4,4,0.0
210840,2015,2,3,0,5,100.0
210840,2016,2,0,0,2,100.0
210840,2017,3,0,0,3,100.0
210840,2018,2,0,0,2,100.0
210840,2019,4,0,0,4,100.0
210840,2020,2,0,0,2,100.0
210845,2012,3,0,4,7,42.857142857142854
210845,2013,5,0,0,5,100.0
210845,2014,12,0,0,12,100.0
210845,2015,11,0,0,11,100.0
210845,2016,9,0,0,9,100.0
210845,2017,5,0,0,5,100.0
210845,2018,6,0,0,6,100.0
210845,2019,8,0,0,8,100.0
210845,2020,7,0,0,7,100.0
210850,2012,8,0,3,11,72.72727272727273
210850,2013,7,0,0,7,100.0
210850,2014,7,0,0,7,100.0
210850,2015,11,1,3,15,80.0
210850,2016,12,0,0,12,100.0
210850,2017,10,0,0,10,100.0
210850,2018,11,0,1,12,91.66666666666666
210850,2019,7,1,6,14,57.14285714285714
210850,2020,10,0,1,11,90.9090909090909
210860,2012,17,0,0,17,100.0
210860,2013,9,4,4,17,76.47058823529412
210860,2014,4,17,5,26,80.76923076923077
210860,2015,14,11,4,29,86.20689655172413
210860,2016,25,3,2,30,93.33333333333333
210860,2017,30,0,0,30,100.0
210860,2018,21,2,0,23,100.0
210860,2019,27,1,2,30,93.33333333333333
210860,2020,21,0,0,21,100.0
210870,2012,2,0,0,2,100.0
210870,2013,8,0,2,10,80.0
210870,2014,6,0,1,7,85.71428571428571
210870,2015,3,0,2,5,60.0
210870,2016,10,0,0,10,100.0
210870,2017,5,0,0,5,100.0
210870,2018,9,0,0,9,100.0
210870,2019,6,0,0,6,100.0
210870,2020,5,0,0,5,100.0
210880,2012,6,0,1,7,85.71428571428571
210880,2013,6,0,0,6,100.0
210880,2014,5,0,0,5,100.0
210880,2015,8,0,0,8,100.0
210880,2016,6,0,0,6,100.0
210880,2017,3,0,0,3,100.0
210880,2018,3,0,0,3,100.0
210880,2019,5,0,0,5,100.0
210880,2020,5,0,0,5,100.0
210890,2012,0,2,4,6,33.33333333333333
210890,2013,0,2,3,5,40.0
210890,2014,0,0,9,9,0.0
210890,2015,0,0,10,10,0.0
210890,2016,1,0,4,5,20.0
210890,2017,7,0,0,7,100.0
210890,2018,5,0,0,5,100.0
210890,2019,3,0,2,5,60.0
210890,2020,4,0,0,4,100.0
210900,2012,8,0,0,8,100.0
210900,2013,5,0,0,5,100.0
210900,2014,8,0,0,8,100.0
210900,2015,8,0,1,9,88.88888888888889
210900,2016,9,1,0,10,100.0
210900,2017,11,0,0,11,100.0
210900,2018,12,0,0,12,100.0
210900,2019,7,0,0,7,100.0
210900,2020,10,0,0,10,100.0
210905,2012,0,0,3,3,0.0
210905,2013,1,0,0,1,100.0
210905,2014,1,0,0,1,100.0
210905,2016,0,0,2,2,0.0
210905,2017,1,0,0,1,100.0
210905,2018,2,0,0,2,100.0
210905,2019,2,0,0,2,100.0
210905,2020,1,0,0,1,100.0
210910,2012,3,13,3,19,84.21052631578947
210910,2013,15,0,0,15,100.0
210910,2014,10,0,1,11,90.9090909090909
210910,2015,13,0,0,13,100.0
210910,2016,14,0,0,14,100.0
210910,2017,13,0,0,13,100.0
210910,2018,15,0,0,15,100.0
210910,2019,15,0,1,16,93.75
210910,2020,15,0,0,15,100.0
210920,2012,6,0,0,6,100.0
210920,2013,4,0,0,4,100.0
210920,2014,0,1,4,5,20.0
210920,2015,2,0,0,2,100.0
210920,2016,3,0,0,3,100.0
210920,2017,1,0,0,1,100.0
210920,2018,1,0,0,1,100.0
210920,2019,1,1,0,2,100.0
210920,2020,1,0,0,1,100.0
210923,2012,2,0,0,2,100.0
210923,2013,2,0,0,2,100.0
210923,2014,1,0,0,1,100.0
210923,2015,1,0,0,1,100.0
210923,2016,1,0,3,4,25.0
210923,2019,0,0,2,2,0.0
210923,2020,4,0,0,4,100.0
210927,2012,1,1,3,5,40.0
210927,2013,2,0,1,3,66.66666666666666
210927,2014,2,1,2,5,60.0
210927,2015,4,0,1,5,80.0
210927,2016,1,0,3,4,25.0
210927,2017,5,0,3,8,62.5
210927,2018,3,0,0,3,100.0
210927,2019,4,0,4,8,50.0
210927,2020,5,0,1,6,83.33333333333334
210930,2012,0,0,2,2,0.0
210930,2013,0,1,3,4,25.0
210930,2014,2,0,0,2,100.0
210930,2015,1,0,0,1,100.0
210930,2016,3,0,0,3,100.0
210930,2017,2,0,0,2,100.0
210930,2018,5,0,0,5,100.0
210930,2019,6,0,0,6,100.0
210930,2020,3,0,0,3,100.0
210940,2012,0,0,3,3,0.0
210940,2013,0,0,7,7,0.0
210940,2014,0,0,1,1,0.0
210940,2015,0,0,2,2,0.0
210940,2016,0,1,3,4,25.0
210940,2017,2,0,1,3,66.66666666666666
210940,2018,3,0,0,3,100.0
210940,2019,2,0,0,2,100.0
210940,2020,4,0,0,4,100.0
210945,2012,0,0,9,9,0.0
210945,2013,7,0,0,7,100.0
210945,2014,9,0,1,10,90.0
210945,2015,6,0,0,6,100.0
210945,2016,7,0,0,7,100.0
210945,2017,8,0,0,8,100.0
210945,2018,8,0,0,8,100.0
210945,2019,7,0,0,7,100.0
210945,2020,13,0,0,13,100.0
210950,2012,7,0,0,7,100.0
210950,2013,7,0,0,7,100.0
210950,2014,3,0,3,6,50.0
210950,2015,7,0,1,8,87.5
210950,2016,1,0,5,6,16.666666666666664
210950,2017,11,0,1,12,91.66666666666666
210950,2018,4,0,2,6,66.66666666666666
210950,2019,4,0,0,4,100.0
210950,2020,6,0,0,6,100.0
210955,2012,2,0,0,2,100.0
210955,2013,3,0,0,3,100.0
210955,2014,1,0,0,1,100.0
210955,2015,1,0,0,1,100.0
210955,2016,2,0,0,2,100.0
210955,2017,4,0,0,4,100.0
210955,2018,3,0,0,3,100.0
210955,2019,1,0,0,1,100.0
210955,2020,6,0,0,6,100.0
210960,2012,0,1,9,10,10.0
210960,2013,8,1,7,16,56.25
210960,2014,5,4,5,14,64.28571428571429
210960,2015,0,1,5,6,16.666666666666664
210960,2016,5,2,9,16,43.75
210960,2017,13,0,0,13,100.0
210960,2018,13,0,0,13,100.0
210960,2019,7,1,3,11,72.72727272727273
210960,2020,5,1,10,16,37.5
210970,2012,1,0,0,1,100.0
210970,2013,1,0,0,1,100.0
210970,2014,4,0,0,4,100.0
210970,2015,1,0,1,2,50.0
210970,2017,1,0,0,1,100.0
210970,2018,1,0,0,1,100.0
210970,2020,1,0,0,1,100.0
210975,2012,0,0,1,1,0.0
210975,2013,0,0,1,1,0.0
210975,2014,0,0,2,2,0.0
210975,2016,2,1,1,4,75.0
210975,2018,1,0,1,2,50.0
210980,2012,0,2,15,17,11.76470588235294
210980,2013,7,1,6,14,57.14285714285714
210980,2014,4,0,4,8,50.0
210980,2015,6,2,5,13,61.53846153846154
210980,2016,5,0,4,9,55.55555555555556
210980,2017,9,0,0,9,100.0
210980,2018,16,0,0,16,100.0
210980,2019,13,0,0,13,100.0
210980,2020,14,0,0,14,100.0
210990,2012,37,0,1,38,97.36842105263158
210990,2013,31,0,0,31,100.0
210990,2014,27,0,0,27,100.0
210990,2015,36,0,1,37,97.2972972972973
210990,2016,27,0,0,27,100.0
210990,2017,34,0,0,34,100.0
210990,2018,36,0,0,36,100.0
210990,2019,32,0,0,32,100.0
210990,2020,37,0,1,38,97.36842105263158
211000,2012,16,0,12,28,57.14285714285714
211000,2013,24,0,1,25,96.0
211000,2014,20,1,0,21,100.0
211000,2015,19,0,3,22,86.36363636363636
211000,2016,33,0,1,34,97.05882352941177
211000,2017,31,0,0,31,100.0
211000,2018,26,1,0,27,100.0
211000,2019,25,0,3,28,89.28571428571429
211000,2020,31,0,0,31,100.0
211003,2012,1,0,6,7,14.285714285714285
211003,2013,1,1,4,6,33.33333333333333
211003,2014,0,1,4,5,20.0
211003,2015,1,0,7,8,12.5
211003,2016,1,0,9,10,10.0
211003,2017,5,0,0,5,100.0
211003,2018,8,0,1,9,88.88888888888889
211003,2019,5,0,0,5,100.0
211003,2020,2,1,5,8,37.5
211010,2012,4,0,0,4,100.0
211010,2013,6,0,0,6,100.0
211010,2014,0,0,3,3,0.0
211010,2015,2,0,1,3,66.66666666666666
211010,2016,6,0,2,8,75.0
211010,2017,8,0,0,8,100.0
211010,2018,7,0,0,7,100.0
211010,2019,7,0,0,7,100.0
211010,2020,4,0,0,4,100.0
211020,2012,9,0,1,10,90.0
211020,2013,15,2,5,22,77.27272727272727
211020,2014,1,2,8,11,27.27272727272727
211020,2015,8,0,1,9,88.88888888888889
211020,2016,6,0,0,6,100.0
211020,2017,7,0,0,7,100.0
211020,2018,8,0,1,9,88.88888888888889
211020,2019,17,0,0,17,100.0
211020,2020,16,0,0,16,100.0
211023,2012,2,0,0,2,100.0
211023,2013,0,0,3,3,0.0
211023,2014,0,0,1,1,0.0
211023,2015,1,0,0,1,100.0
211023,2016,2,0,0,2,100.0
211023,2017,2,0,0,2,100.0
211023,2018,1,0,0,1,100.0
211023,2020,1,0,0,1,100.0
211027,2012,0,1,0,1,100.0
211027,2013,0,0,1,1,0.0
211027,2014,0,1,1,2,50.0
211027,2015,0,0,1,1,0.0
211027,2016,0,0,1,1,0.0
211027,2017,1,0,0,1,100.0
211027,2018,3,0,0,3,100.0
211027,2019,1,0,0,1,100.0
211027,2020,2,0,0,2,100.0
211030,2012,0,0,2,2,0.0
211030,2013,1,0,5,6,16.666666666666664
211030,2014,0,1,1,2,50.0
211030,2015,4,2,3,9,66.66666666666666
211030,2016,1,0,4,5,20.0
211030,2017,4,0,0,4,100.0
211030,2018,4,0,0,4,100.0
211030,2019,6,0,0,6,100.0
211030,2020,5,0,0,5,100.0
211040,2012,1,1,1,3,66.66666666666666
211040,2013,5,0,0,5,100.0
211040,2014,4,0,0,4,100.0
211040,2015,3,0,0,3,100.0
211040,2016,5,0,0,5,100.0
211040,2017,7,0,1,8,87.5
211040,2018,5,0,0,5,100.0
211040,2019,6,0,0,6,100.0
211040,2020,2,0,0,2,100.0
211050,2012,0,1,7,8,12.5
211050,2013,0,0,9,9,0.0
211050,2014,0,2,10,12,16.666666666666664
211050,2015,0,1,5,6,16.666666666666664
211050,2016,0,2,8,10,20.0
211050,2017,6,0,0,6,100.0
211050,2018,8,0,0,8,100.0
211050,2019,11,0,1,12,91.66666666666666
211050,2020,10,0,2,12,83.33333333333334
211060,2012,6,0,0,6,100.0
211060,2013,8,0,0,8,100.0
211060,2014,6,0,0,6,100.0
211060,2015,7,0,0,7,100.0
211060,2016,10,0,0,10,100.0
211060,2017,7,0,0,7,100.0
211060,2018,1,0,0,1,100.0
211060,2019,7,0,0,7,100.0
211060,2020,8,0,0,8,100.0
211065,2012,0,0,4,4,0.0
211065,2013,0,0,4,4,0.0
211065,2014,0,0,1,1,0.0
211065,2015,1,0,1,2,50.0
211065,2016,0,0,1,1,0.0
211065,2017,0,0,3,3,0.0
211065,2018,0,0,1,1,0.0
211065,2019,0,0,6,6,0.0
211065,2020,0,0,3,3,0.0
211070,2012,11,0,0,11,100.0
211070,2013,9,0,0,9,100.0
211070,2014,16,0,0,16,100.0
211070,2015,10,0,0,10,100.0
211070,2016,2,0,3,5,40.0
211070,2017,13,0,0,13,100.0
211070,2018,15,0,1,16,93.75
211070,2019,8,0,5,13,61.53846153846154
211070,2020,0,0,9,9,0.0
211080,2012,2,0,0,2,100.0
211080,2013,2,0,0,2,100.0
211080,2014,1,0,0,1,100.0
211080,2015,0,0,2,2,0.0
211080,2016,2,0,0,2,100.0
211080,2017,1,0,0,1,100.0
211080,2018,5,0,0,5,100.0
211080,2019,1,0,0,1,100.0
211085,2012,0,0,2,2,0.0
211085,2013,3,0,0,3,100.0
211085,2014,2,0,0,2,100.0
211085,2015,7,0,0,7,100.0
211085,2016,1,0,0,1,100.0
211085,2017,2,0,0,2,100.0
211085,2018,4,0,0,4,100.0
211085,2019,5,0,0,5,100.0
211085,2020,1,0,0,1,100.0
211090,2012,4,1,0,5,100.0
211090,2013,4,0,0,4,100.0
211090,2014,2,0,0,2,100.0
211090,2015,0,0,2,2,0.0
211090,2016,2,0,0,2,100.0
211090,2017,3,0,0,3,100.0
211090,2018,2,0,0,2,100.0
211090,2019,2,0,2,4,50.0
211090,2020,3,0,0,3,100.0
211100,2012,0,0,4,4,0.0
211100,2013,0,0,4,4,0.0
211100,2014,1,0,5,6,16.666666666666664
211100,2015,0,1,9,10,10.0
211100,2016,0,0,3,3,0.0
211100,2017,2,0,0,2,100.0
211100,2018,5,0,0,5,100.0
211100,2019,3,0,1,4,75.0
211100,2020,7,0,0,7,100.0
211102,2012,4,0,0,4,100.0
211102,2013,7,0,0,7,100.0
211102,2014,2,0,0,2,100.0
211102,2015,3,0,0,3,100.0
211102,2016,4,0,2,6,66.66666666666666
211102,2017,1,0,0,1,100.0
211102,2019,2,1,1,4,75.0
211102,2020,3,2,1,6,83.33333333333334
211105,2012,0,0,4,4,0.0
211105,2013,0,0,2,2,0.0
211105,2015,5,0,0,5,100.0
211105,2016,4,0,0,4,100.0
211105,2017,3,0,0,3,100.0
211105,2018,3,0,0,3,100.0
211105,2019,1,0,1,2,50.0
211105,2020,4,0,0,4,100.0
211107,2012,4,0,3,7,57.14285714285714
211107,2013,1,0,7,8,12.5
211107,2014,1,0,0,1,100.0
211107,2015,5,0,0,5,100.0
211107,2017,6,0,0,6,100.0
211107,2018,4,0,0,4,100.0
211107,2019,6,0,1,7,85.71428571428571
211107,2020,3,0,0,3,100.0
211110,2012,10,0,3,13,76.92307692307693
211110,2013,8,0,0,8,100.0
211110,2014,9,2,1,12,91.66666666666666
211110,2015,1,1,8,10,20.0
211110,2016,0,3,12,15,20.0
211110,2017,10,0,0,10,100.0
211110,2018,7,0,0,7,100.0
211110,2019,10,0,4,14,71.42857142857143
211110,2020,8,1,1,10,90.0
211120,2012,31,4,17,52,67.3076923076923
211120,2013,41,4,12,57,78.94736842105263
211120,2014,39,3,13,55,76.36363636363637
211120,2015,31,4,19,54,64.81481481481481
211120,2016,35,11,22,68,67.64705882352942
211120,2017,54,2,3,59,94.91525423728814
211120,2018,59,1,2,62,96.7741935483871
211120,2019,63,1,5,69,92.7536231884058
211120,2020,66,6,10,82,87.8048780487805
211125,2012,0,0,1,1,0.0
211125,2013,4,0,0,4,100.0
211125,2014,2,0,0,2,100.0
211125,2015,2,0,0,2,100.0
211125,2016,1,0,0,1,100.0
211125,2017,1,0,0,1,100.0
211125,2018,2,0,0,2,100.0
211125,2019,0,2,1,3,66.66666666666666
211125,2020,3,0,0,3,100.0
211130,2012,327,11,35,373,90.61662198391421
211130,2013,333,7,44,384,88.54166666666666
211130,2014,390,0,1,391,99.74424552429667
211130,2015,400,1,1,402,99.75124378109453
211130,2016,410,2,2,414,99.51690821256038
211130,2017,400,0,0,400,100.0
211130,2018,380,0,1,381,99.73753280839895
211130,2019,349,0,1,350,99.71428571428571
211130,2020,445,0,0,445,100.0
211140,2012,0,0,8,8,0.0
211140,2013,0,1,11,12,8.333333333333332
211140,2014,0,0,8,8,0.0
211140,2015,0,4,3,7,57.14285714285714
211140,2016,1,0,2,3,33.33333333333333
211140,2017,7,0,0,7,100.0
211140,2018,2,0,5,7,28.57142857142857
211140,2019,2,0,6,8,25.0
211140,2020,3,0,1,4,75.0
211150,2012,0,2,13,15,13.333333333333334
211150,2013,0,2,13,15,13.333333333333334
211150,2014,2,0,12,14,14.285714285714285
211150,2015,13,2,1,16,93.75
211150,2016,22,0,0,22,100.0
211150,2017,20,0,0,20,100.0
211150,2018,21,0,2,23,91.30434782608695
211150,2019,15,0,1,16,93.75
211150,2020,10,0,1,11,90.9090909090909
211153,2012,0,1,4,5,20.0
211153,2013,2,0,3,5,40.0
211153,2014,3,0,3,6,50.0
211153,2015,5,0,0,5,100.0
211153,2016,4,0,0,4,100.0
211153,2017,5,0,1,6,83.33333333333334
211153,2018,5,0,0,5,100.0
211153,2019,7,0,1,8,87.5
211153,2020,0,0,2,2,0.0
211157,2012,0,0,4,4,0.0
211157,2013,0,0,1,1,0.0
211157,2014,1,0,0,1,100.0
211157,2015,2,0,0,2,100.0
211157,2017,1,0,0,1,100.0
211157,2018,1,0,0,1,100.0
211157,2019,1,0,0,1,100.0
211157,2020,1,0,0,1,100.0
211160,2012,0,0,7,7,0.0
211160,2013,6,0,1,7,85.71428571428571
211160,2014,3,0,0,3,100.0
211160,2015,5,0,0,5,100.0
211160,2016,2,0,4,6,33.33333333333333
211160,2017,5,0,0,5,100.0
211160,2018,4,0,0,4,100.0
211160,2019,4,0,0,4,100.0
211160,2020,7,0,0,7,100.0
211163,2012,0,0,2,2,0.0
211163,2014,0,0,1,1,0.0
211163,2018,2,0,0,2,100.0
211163,2019,3,0,0,3,100.0
211163,2020,2,0,0,2,100.0
211167,2013,0,0,1,1,0.0
211167,2014,0,0,1,1,0.0
211167,2015,0,0,1,1,0.0
211167,2016,1,0,0,1,100.0
211167,2018,2,0,0,2,100.0
211167,2019,2,0,0,2,100.0
211167,2020,5,0,0,5,100.0
211170,2012,0,1,9,10,10.0
211170,2013,0,0,6,6,0.0
211170,2014,0,0,5,5,0.0
211170,2015,0,0,5,5,0.0
211170,2016,0,0,4,4,0.0
211170,2017,4,0,0,4,100.0
211170,2018,5,0,0,5,100.0
211170,2019,6,0,0,6,100.0
211170,2020,3,0,0,3,100.0
211172,2012,1,0,0,1,100.0
211172,2015,0,0,2,2,0.0
211172,2016,0,0,1,1,0.0
211172,2017,0,0,3,3,0.0
211172,2020,2,0,0,2,100.0
211174,2012,0,0,4,4,0.0
211174,2013,3,0,1,4,75.0
211174,2014,0,0,2,2,0.0
211174,2015,3,0,5,8,37.5
211174,2016,1,0,2,3,33.33333333333333
211174,2017,0,0,4,4,0.0
211174,2018,1,0,4,5,20.0
211174,2019,2,0,1,3,66.66666666666666
211174,2020,1,0,0,1,100.0
211176,2012,0,2,8,10,20.0
211176,2013,6,0,2,8,75.0
211176,2014,11,0,1,12,91.66666666666666
211176,2015,7,0,0,7,100.0
211176,2016,7,0,0,7,100.0
211176,2017,5,0,0,5,100.0
211176,2018,6,0,0,6,100.0
211176,2019,2,0,0,2,100.0
211176,2020,8,0,0,8,100.0
211178,2013,0,0,8,8,0.0
211178,2014,0,1,0,1,100.0
211178,2015,0,0,3,3,0.0
211178,2016,0,0,1,1,0.0
211178,2017,3,0,1,4,75.0
211178,2018,0,0,1,1,0.0
211178,2019,3,0,0,3,100.0
211178,2020,5,0,0,5,100.0
211180,2012,5,0,0,5,100.0
211180,2013,6,0,0,6,100.0
211180,2014,4,0,0,4,100.0
211180,2015,5,0,0,5,100.0
211180,2016,5,0,0,5,100.0
211180,2017,1,1,0,2,100.0
211180,2018,4,0,0,4,100.0
211180,2019,5,0,0,5,100.0
211180,2020,5,0,3,8,62.5
211190,2012,0,0,3,3,0.0
211190,2013,0,1,1,2,50.0
211190,2014,0,0,5,5,0.0
211190,2015,0,0,5,5,0.0
211190,2016,0,0,3,3,0.0
211190,2017,0,0,2,2,0.0
211190,2018,0,0,2,2,0.0
211190,2019,3,0,2,5,60.0
211190,2020,0,0,3,3,0.0
211195,2013,0,0,1,1,0.0
211195,2014,0,0,2,2,0.0
211195,2015,2,0,0,2,100.0
211195,2016,3,0,1,4,75.0
211195,2017,2,0,1,3,66.66666666666666
211195,2018,1,0,0,1,100.0
211195,2020,0,0,2,2,0.0
211200,2012,0,0,1,1,0.0
211200,2013,0,0,2,2,0.0
211200,2014,0,0,3,3,0.0
211200,2015,0,0,1,1,0.0
211200,2016,0,0,2,2,0.0
211200,2017,3,0,0,3,100.0
211200,2018,4,0,0,4,100.0
211200,2019,1,0,0,1,100.0
211200,2020,2,0,0,2,100.0
211210,2012,5,1,2,8,75.0
211210,2013,0,1,5,6,16.666666666666664
211210,2014,2,0,2,4,50.0
211210,2015,2,0,11,13,15.384615384615385
211210,2016,0,1,3,4,25.0
211210,2017,5,0,0,5,100.0
211210,2018,9,0,0,9,100.0
211210,2019,4,0,1,5,80.0
211210,2020,5,0,0,5,100.0
211220,2012,42,3,22,67,67.16417910447761
211220,2013,51,2,5,58,91.37931034482759
211220,2014,66,0,3,69,95.65217391304348
211220,2015,56,0,5,61,91.80327868852459
211220,2016,53,0,14,67,79.1044776119403
211220,2017,51,0,0,51,100.0
211220,2018,68,0,0,68,100.0
211220,2019,56,0,0,56,100.0
211220,2020,48,0,20,68,70.58823529411765
211223,2012,0,1,8,9,11.11111111111111
211223,2013,2,3,10,15,33.33333333333333
211223,2014,4,3,3,10,70.0
211223,2015,0,3,5,8,37.5
211223,2016,0,1,7,8,12.5
211223,2017,8,0,0,8,100.0
211223,2018,3,0,3,6,50.0
211223,2019,10,0,1,11,90.9090909090909
211223,2020,9,0,0,9,100.0
211227,2012,2,0,1,3,66.66666666666666
211227,2013,1,1,2,4,50.0
211227,2014,0,1,0,1,100.0
211227,2016,0,0,2,2,0.0
211227,2017,3,0,0,3,100.0
211227,2018,5,1,0,6,100.0
211227,2019,2,0,0,2,100.0
211227,2020,1,0,1,2,50.0
211230,2012,9,0,0,9,100.0
211230,2013,12,0,0,12,100.0
211230,2014,1,0,0,1,100.0
211230,2015,19,0,0,19,100.0
211230,2016,14,0,0,14,100.0
211230,2017,11,0,0,11,100.0
211230,2018,12,0,0,12,100.0
211230,2019,6,0,0,6,100.0
211230,2020,14,0,0,14,100.0
211240,2012,6,0,1,7,85.71428571428571
211240,2013,0,6,4,10,60.0
211240,2014,0,9,3,12,75.0
211240,2015,0,3,9,12,25.0
211240,2016,0,0,3,3,0.0
211240,2017,4,0,0,4,100.0
211240,2018,8,0,0,8,100.0
211240,2019,7,0,0,7,100.0
211240,2020,11,0,0,11,100.0
211245,2012,0,1,1,2,50.0
211245,2013,0,1,4,5,20.0
211245,2014,6,1,1,8,87.5
211245,2015,6,0,0,6,100.0
211245,2016,6,0,0,6,100.0
211245,2017,7,0,0,7,100.0
211245,2018,6,0,0,6,100.0
211245,2019,6,0,2,8,75.0
211245,2020,2,0,5,7,28.57142857142857
211250,2012,13,0,0,13,100.0
211250,2013,20,0,0,20,100.0
211250,2014,16,0,0,16,100.0
211250,2015,15,0,0,15,100.0
211250,2016,17,0,0,17,100.0
211250,2017,13,0,0,13,100.0
211250,2018,10,0,0,10,100.0
211250,2019,21,0,0,21,100.0
211250,2020,20,0,0,20,100.0
211260,2012,1,0,5,6,16.666666666666664
211260,2013,0,0,1,1,0.0
211260,2014,6,0,0,6,100.0
211260,2015,8,0,0,8,100.0
211260,2016,6,0,0,6,100.0
211260,2017,14,0,0,14,100.0
211260,2018,7,0,0,7,100.0
211260,2019,9,0,0,9,100.0
211260,2020,10,0,0,10,100.0
211270,2012,7,0,5,12,58.333333333333336
211270,2013,1,0,9,10,10.0
211270,2014,9,0,1,10,90.0
211270,2015,17,0,0,17,100.0
211270,2016,11,0,0,11,100.0
211270,2017,11,0,0,11,100.0
211270,2018,13,0,0,13,100.0
211270,2019,11,0,0,11,100.0
211270,2020,21,0,0,21,100.0
211280,2012,2,0,12,14,14.285714285714285
211280,2013,0,1,9,10,10.0
211280,2014,0,4,12,16,25.0
211280,2015,1,6,14,21,33.33333333333333
211280,2016,21,0,0,21,100.0
211280,2017,14,0,0,14,100.0
211280,2018,19,0,0,19,100.0
211280,2019,20,0,0,20,100.0
211280,2020,21,0,0,21,100.0
211285,2012,0,0,4,4,0.0
211285,2013,0,0,4,4,0.0
211285,2014,0,0,3,3,0.0
211285,2015,3,0,1,4,75.0
211285,2016,6,0,0,6,100.0
211285,2017,4,0,0,4,100.0
211285,2018,3,0,2,5,60.0
211285,2019,3,0,0,3,100.0
211285,2020,1,0,0,1,100.0
211290,2012,0,0,11,11,0.0
211290,2013,6,0,7,13,46.15384615384615
211290,2014,10,0,0,10,100.0
211290,2015,16,0,0,16,100.0
211290,2016,5,0,1,6,83.33333333333334
211290,2017,10,0,0,10,100.0
211290,2018,12,0,0,12,100.0
211290,2019,12,0,0,12,100.0
211290,2020,11,0,0,11,100.0
211300,2012,3,0,5,8,37.5
211300,2013,0,2,5,7,28.57142857142857
211300,2014,0,0,14,14,0.0
211300,2015,1,2,3,6,50.0
211300,2016,6,0,1,7,85.71428571428571
211300,2017,8,0,0,8,100.0
211300,2018,9,0,0,9,100.0
211300,2019,10,0,0,10,100.0
211300,2020,9,0,0,9,100.0
211400,2012,18,0,2,20,90.0
211400,2013,17,0,0,17,100.0
211400,2014,14,0,0,14,100.0
211400,2015,15,0,0,15,100.0
211400,2016,17,0,0,17,100.0
211400,2017,15,0,0,15,100.0
211400,2018,10,0,0,10,100.0
211400,2019,18,0,0,18,100.0
211400,2020,22,0,3,25,88.0
220000,2012,0,0,5,5,0.0
220000,2014,1,0,4,5,20.0
220000,2015,0,0,3,3,0.0
220000,2016,0,0,1,1,0.0
220000,2017,1,0,0,1,100.0
220000,2018,0,0,1,1,0.0
220000,2019,1,0,0,1,100.0
220000,2020,0,1,1,2,50.0
220005,2012,2,0,2,4,50.0
220005,2014,3,0,1,4,75.0
220005,2015,1,0,0,1,100.0
220005,2016,1,0,1,2,50.0
220005,2017,4,0,0,4,100.0
220005,2018,2,0,1,3,66.66666666666666
220005,2019,3,0,0,3,100.0
220005,2020,3,0,0,3,100.0
220010,2012,2,0,0,2,100.0
220010,2013,1,0,0,1,100.0
220010,2014,1,0,1,2,50.0
220010,2015,2,0,0,2,100.0
220010,2016,0,0,1,1,0.0
220010,2017,1,0,0,1,100.0
220010,2018,1,0,0,1,100.0
220010,2019,0,0,1,1,0.0
220010,2020,3,0,0,3,100.0
220020,2012,8,0,0,8,100.0
220020,2013,8,0,0,8,100.0
220020,2014,7,0,0,7,100.0
220020,2015,11,0,0,11,100.0
220020,2016,6,0,0,6,100.0
220020,2017,6,0,0,6,100.0
220020,2018,6,0,0,6,100.0
220020,2019,4,0,1,5,80.0
220020,2020,5,0,1,6,83.33333333333334
220025,2013,4,0,0,4,100.0
220025,2014,2,0,0,2,100.0
220025,2016,3,0,1,4,75.0
220025,2017,3,0,0,3,100.0
220025,2018,2,0,0,2,100.0
220025,2019,3,0,0,3,100.0
220025,2020,4,0,0,4,100.0
220027,2012,1,0,0,1,100.0
220027,2013,1,0,1,2,50.0
220027,2014,1,0,0,1,100.0
220027,2015,5,0,0,5,100.0
220027,2016,1,0,0,1,100.0
220027,2017,1,0,1,2,50.0
220027,2019,0,0,3,3,0.0
220027,2020,0,0,4,4,0.0
220030,2012,4,0,0,4,100.0
220030,2013,4,0,4,8,50.0
220030,2015,1,0,2,3,33.33333333333333
220030,2016,3,0,0,3,100.0
220030,2017,6,0,0,6,100.0
220030,2018,3,0,1,4,75.0
220030,2019,3,1,2,6,66.66666666666666
220030,2020,0,1,1,2,50.0
220040,2012,6,1,2,9,77.77777777777779
220040,2013,12,0,0,12,100.0
220040,2014,12,0,0,12,100.0
220040,2015,11,0,0,11,100.0
220040,2016,5,0,0,5,100.0
220040,2017,16,0,0,16,100.0
220040,2018,11,0,0,11,100.0
220040,2019,15,0,3,18,83.33333333333334
220040,2020,7,2,2,11,81.81818181818183
220045,2012,4,0,0,4,100.0
220045,2013,1,0,0,1,100.0
220045,2014,1,0,0,1,100.0
220045,2016,2,0,0,2,100.0
220045,2018,2,0,0,2,100.0
220045,2019,1,0,1,2,50.0
220045,2020,1,0,2,3,33.33333333333333
220050,2012,3,0,0,3,100.0
220050,2013,1,0,0,1,100.0
220050,2014,4,0,3,7,57.14285714285714
220050,2015,1,0,1,2,50.0
220050,2016,5,0,0,5,100.0
220050,2017,3,0,0,3,100.0
220050,2018,6,0,0,6,100.0
220050,2019,6,1,0,7,100.0
220050,2020,4,0,0,4,100.0
220060,2012,0,0,3,3,0.0
220060,2013,0,0,4,4,0.0
220060,2014,0,1,3,4,25.0
220060,2015,0,0,1,1,0.0
220060,2016,1,0,2,3,33.33333333333333
220060,2017,3,0,0,3,100.0
220060,2018,1,0,0,1,100.0
220060,2019,1,0,0,1,100.0
220060,2020,3,0,0,3,100.0
220070,2013,2,0,3,5,40.0
220070,2014,5,0,0,5,100.0
220070,2015,5,0,0,5,100.0
220070,2017,0,0,1,1,0.0
220070,2018,1,0,0,1,100.0
220070,2019,1,0,0,1,100.0
220070,2020,4,0,0,4,100.0
220080,2012,2,0,0,2,100.0
220080,2013,1,0,0,1,100.0
220080,2015,1,0,0,1,100.0
220080,2017,3,0,0,3,100.0
220080,2018,1,0,0,1,100.0
220080,2020,1,0,0,1,100.0
220090,2012,2,0,0,2,100.0
220090,2013,2,0,0,2,100.0
220090,2014,1,0,0,1,100.0
220090,2016,1,0,0,1,100.0
220090,2018,2,0,0,2,100.0
220090,2019,5,0,0,5,100.0
220095,2019,0,0,4,4,0.0
220100,2012,1,0,0,1,100.0
220100,2013,1,0,0,1,100.0
220100,2014,2,0,0,2,100.0
220100,2015,1,0,0,1,100.0
220100,2016,1,0,0,1,100.0
220100,2018,2,0,0,2,100.0
220100,2019,3,0,0,3,100.0
220100,2020,1,0,1,2,50.0
220105,2012,2,0,1,3,66.66666666666666
220105,2013,0,0,3,3,0.0
220105,2014,1,0,0,1,100.0
220105,2015,3,0,0,3,100.0
220105,2016,2,0,0,2,100.0
220105,2017,2,0,0,2,100.0
220105,2018,3,0,0,3,100.0
220105,2020,0,0,1,1,0.0
220110,2013,2,0,0,2,100.0
220110,2014,5,0,0,5,100.0
220110,2015,1,0,0,1,100.0
220110,2016,0,0,3,3,0.0
220110,2017,4,0,0,4,100.0
220110,2018,1,0,0,1,100.0
220110,2019,1,0,0,1,100.0
220110,2020,4,0,0,4,100.0
220115,2012,2,0,3,5,40.0
220115,2013,2,0,0,2,100.0
220115,2014,4,0,0,4,100.0
220115,2015,4,0,0,4,100.0
220115,2016,6,0,0,6,100.0
220115,2017,2,0,0,2,100.0
220115,2018,6,0,0,6,100.0
220115,2019,4,0,0,4,100.0
220115,2020,2,0,0,2,100.0
220117,2012,2,0,0,2,100.0
220117,2013,2,0,0,2,100.0
220117,2016,2,0,0,2,100.0
220117,2017,1,0,0,1,100.0
220117,2018,1,0,0,1,100.0
220117,2019,2,0,0,2,100.0
220117,2020,1,0,0,1,100.0
220120,2012,6,2,4,12,66.66666666666666
220120,2013,11,0,6,17,64.70588235294117
220120,2014,13,0,0,13,100.0
220120,2015,15,0,0,15,100.0
220120,2016,7,0,0,7,100.0
220120,2017,10,0,0,10,100.0
220120,2018,8,0,0,8,100.0
220120,2019,12,0,1,13,92.3076923076923
220120,2020,13,0,0,13,100.0
220130,2012,0,0,2,2,0.0
220130,2014,1,0,1,2,50.0
220130,2015,2,1,0,3,100.0
220130,2016,4,0,0,4,100.0
220130,2017,2,0,1,3,66.66666666666666
220130,2019,0,0,1,1,0.0
220140,2012,2,0,0,2,100.0
220140,2013,2,0,1,3,66.66666666666666
220140,2014,0,0,2,2,0.0
220140,2016,1,0,2,3,33.33333333333333
220140,2017,1,0,0,1,100.0
220140,2018,1,0,0,1,100.0
220140,2019,1,0,0,1,100.0
220140,2020,0,0,1,1,0.0
220150,2012,6,0,0,6,100.0
220150,2013,7,0,0,7,100.0
220150,2014,7,0,0,7,100.0
220150,2015,9,0,0,9,100.0
220150,2016,10,0,0,10,100.0
220150,2017,5,0,0,5,100.0
220150,2018,5,0,0,5,100.0
220150,2019,7,0,1,8,87.5
220150,2020,5,0,0,5,100.0
220155,2012,3,0,0,3,100.0
220155,2013,2,0,0,2,100.0
220155,2014,1,0,0,1,100.0
220155,2015,2,0,0,2,100.0
220155,2016,1,0,0,1,100.0
220155,2017,2,0,0,2,100.0
220155,2018,1,0,0,1,100.0
220155,2019,0,0,1,1,0.0
220155,2020,1,0,0,1,100.0
220157,2012,3,0,0,3,100.0
220157,2013,1,0,0,1,100.0
220157,2014,1,0,0,1,100.0
220157,2015,1,0,0,1,100.0
220157,2016,2,0,0,2,100.0
220157,2017,1,0,0,1,100.0
220157,2018,2,0,0,2,100.0
220160,2012,2,0,0,2,100.0
220160,2013,1,0,0,1,100.0
220160,2014,2,0,0,2,100.0
220160,2015,2,0,0,2,100.0
220160,2016,2,0,1,3,66.66666666666666
220160,2017,1,0,0,1,100.0
220160,2018,3,0,0,3,100.0
220160,2019,0,0,2,2,0.0
220160,2020,0,0,1,1,0.0
220170,2012,3,0,0,3,100.0
220170,2013,1,0,0,1,100.0
220170,2014,2,0,0,2,100.0
220170,2015,2,0,0,2,100.0
220170,2016,4,0,0,4,100.0
220170,2017,2,0,0,2,100.0
220170,2018,3,0,0,3,100.0
220170,2019,1,0,1,2,50.0
220170,2020,1,0,0,1,100.0
220173,2012,3,0,1,4,75.0
220173,2013,3,0,0,3,100.0
220173,2014,2,0,0,2,100.0
220173,2015,6,0,0,6,100.0
220173,2016,5,0,0,5,100.0
220173,2017,2,0,0,2,100.0
220173,2018,2,0,0,2,100.0
220173,2019,2,0,0,2,100.0
220173,2020,1,0,0,1,100.0
220177,2012,2,0,0,2,100.0
220177,2013,0,0,1,1,0.0
220177,2015,2,0,1,3,66.66666666666666
220177,2016,0,0,1,1,0.0
220177,2018,4,0,0,4,100.0
220177,2020,0,0,2,2,0.0
220180,2013,2,0,0,2,100.0
220180,2014,3,0,0,3,100.0
220180,2015,2,0,0,2,100.0
220180,2016,2,0,0,2,100.0
220180,2017,0,0,1,1,0.0
220180,2019,1,0,0,1,100.0
220180,2020,5,0,0,5,100.0
220190,2012,5,0,0,5,100.0
220190,2013,9,0,0,9,100.0
220190,2014,7,0,0,7,100.0
220190,2015,9,0,0,9,100.0
220190,2016,7,0,0,7,100.0
220190,2017,7,0,0,7,100.0
220190,2018,8,0,0,8,100.0
220190,2019,7,0,0,7,100.0
220190,2020,10,0,1,11,90.9090909090909
220191,2012,0,1,1,2,50.0
220191,2013,0,2,0,2,100.0
220191,2014,1,0,0,1,100.0
220191,2015,2,0,0,2,100.0
220191,2016,1,0,0,1,100.0
220191,2017,1,0,0,1,100.0
220191,2018,1,0,0,1,100.0
220191,2020,0,0,2,2,0.0
220192,2012,1,0,0,1,100.0
220192,2013,3,0,0,3,100.0
220192,2014,2,0,0,2,100.0
220192,2015,1,0,0,1,100.0
220192,2016,1,0,0,1,100.0
220192,2017,1,0,0,1,100.0
220192,2018,2,0,0,2,100.0
220192,2019,1,0,0,1,100.0
220194,2012,3,0,0,3,100.0
220194,2014,0,0,3,3,0.0
220194,2015,1,0,1,2,50.0
220194,2016,1,0,0,1,100.0
220194,2017,1,0,0,1,100.0
220194,2018,1,0,0,1,100.0
220194,2019,0,0,1,1,0.0
220194,2020,2,0,0,2,100.0
220196,2012,2,0,0,2,100.0
220196,2013,1,0,0,1,100.0
220196,2014,5,0,0,5,100.0
220196,2015,5,0,0,5,100.0
220196,2016,2,0,0,2,100.0
220196,2018,1,0,0,1,100.0
220196,2019,1,0,0,1,100.0
220196,2020,1,0,0,1,100.0
220198,2013,1,0,1,2,50.0
220198,2015,1,0,0,1,100.0
220198,2016,0,0,1,1,0.0
220198,2017,0,0,1,1,0.0
220198,2020,0,0,1,1,0.0
220200,2012,5,0,1,6,83.33333333333334
220200,2013,0,1,3,4,25.0
220200,2014,0,3,8,11,27.27272727272727
220200,2015,2,1,2,5,60.0
220200,2016,1,0,4,5,20.0
220200,2017,4,0,0,4,100.0
220200,2018,5,0,1,6,83.33333333333334
220200,2019,7,0,1,8,87.5
220200,2020,12,0,0,12,100.0
220202,2012,1,0,0,1,100.0
220202,2013,0,1,0,1,100.0
220202,2014,1,0,0,1,100.0
220202,2015,2,0,0,2,100.0
220202,2016,1,0,0,1,100.0
220202,2017,1,0,0,1,100.0
220202,2018,1,0,0,1,100.0
220202,2019,1,0,0,1,100.0
220202,2020,0,0,1,1,0.0
220205,2012,2,0,0,2,100.0
220205,2013,2,0,1,3,66.66666666666666
220205,2014,2,0,0,2,100.0
220205,2015,4,0,0,4,100.0
220205,2016,2,0,0,2,100.0
220205,2017,4,0,0,4,100.0
220205,2018,4,0,0,4,100.0
220205,2020,3,0,0,3,100.0
220207,2012,1,0,0,1,100.0
220207,2014,1,0,2,3,33.33333333333333
220207,2015,1,0,0,1,100.0
220207,2016,2,0,0,2,100.0
220207,2017,1,0,0,1,100.0
220207,2018,1,0,0,1,100.0
220207,2019,3,0,0,3,100.0
220208,2012,1,0,0,1,100.0
220208,2013,1,0,0,1,100.0
220208,2014,1,0,0,1,100.0
220208,2015,3,0,0,3,100.0
220208,2016,1,0,0,1,100.0
220208,2017,1,0,0,1,100.0
220208,2018,2,0,0,2,100.0
220208,2019,1,1,0,2,100.0
220208,2020,1,0,0,1,100.0
220209,2012,1,0,0,1,100.0
220209,2013,2,0,0,2,100.0
220209,2014,1,0,0,1,100.0
220209,2015,1,0,0,1,100.0
220209,2016,1,0,0,1,100.0
220209,2017,3,0,0,3,100.0
220209,2018,3,0,0,3,100.0
220209,2019,2,0,0,2,100.0
220209,2020,2,0,0,2,100.0
220210,2014,2,0,0,2,100.0
220210,2015,3,0,0,3,100.0
220210,2016,2,0,0,2,100.0
220210,2017,4,0,0,4,100.0
220210,2019,1,0,0,1,100.0
220210,2020,2,0,0,2,100.0
220211,2012,1,0,0,1,100.0
220211,2013,0,0,1,1,0.0
220211,2014,0,0,1,1,0.0
220211,2015,0,1,1,2,50.0
220211,2016,0,0,1,1,0.0
220211,2017,0,0,2,2,0.0
220211,2018,1,0,0,1,100.0
220211,2019,1,0,1,2,50.0
220211,2020,1,0,4,5,20.0
220213,2013,5,0,0,5,100.0
220213,2014,2,0,0,2,100.0
220213,2016,3,0,0,3,100.0
220213,2017,1,0,0,1,100.0
220213,2018,3,0,0,3,100.0
220213,2020,3,0,0,3,100.0
220217,2012,0,0,2,2,0.0
220217,2013,0,0,1,1,0.0
220217,2014,4,0,0,4,100.0
220217,2015,2,0,0,2,100.0
220217,2017,1,0,0,1,100.0
220217,2018,1,0,0,1,100.0
220220,2012,10,0,0,10,100.0
220220,2013,17,0,0,17,100.0
220220,2014,18,0,0,18,100.0
220220,2015,14,0,1,15,93.33333333333333
220220,2016,16,0,1,17,94.11764705882352
220220,2017,13,0,1,14,92.85714285714286
220220,2018,26,0,2,28,92.85714285714286
220220,2019,17,0,5,22,77.27272727272727
220220,2020,8,2,1,11,90.9090909090909
220225,2012,2,0,0,2,100.0
220225,2014,3,0,0,3,100.0
220225,2015,1,0,0,1,100.0
220225,2016,1,0,0,1,100.0
220225,2017,3,0,0,3,100.0
220225,2018,1,0,0,1,100.0
220225,2019,1,0,0,1,100.0
220225,2020,2,0,1,3,66.66666666666666
220230,2012,1,0,1,2,50.0
220230,2013,7,0,0,7,100.0
220230,2014,8,0,0,8,100.0
220230,2015,2,0,0,2,100.0
220230,2016,4,0,0,4,100.0
220230,2017,10,0,1,11,90.9090909090909
220230,2018,5,0,0,5,100.0
220230,2019,9,0,4,13,69.23076923076923
220230,2020,2,1,3,6,50.0
220240,2012,1,0,0,1,100.0
220240,2013,2,0,0,2,100.0
220240,2014,2,0,0,2,100.0
220240,2015,2,0,0,2,100.0
220240,2016,2,0,0,2,100.0
220240,2017,4,0,0,4,100.0
220240,2018,3,0,0,3,100.0
220240,2019,3,0,0,3,100.0
220240,2020,2,0,0,2,100.0
220245,2012,1,0,1,2,50.0
220245,2013,0,0,1,1,0.0
220245,2014,3,0,0,3,100.0
220245,2015,1,0,2,3,33.33333333333333
220245,2016,1,0,0,1,100.0
220245,2018,1,0,0,1,100.0
220245,2020,2,0,0,2,100.0
220250,2012,4,0,1,5,80.0
220250,2013,1,0,0,1,100.0
220250,2014,1,0,2,3,33.33333333333333
220250,2015,1,0,4,5,20.0
220250,2016,0,0,4,4,0.0
220250,2017,2,0,1,3,66.66666666666666
220250,2018,1,0,0,1,100.0
220250,2019,1,0,0,1,100.0
220250,2020,0,0,7,7,0.0
220253,2013,1,0,0,1,100.0
220253,2014,4,1,0,5,100.0
220253,2015,1,0,0,1,100.0
220253,2016,2,0,0,2,100.0
220253,2018,3,0,0,3,100.0
220253,2019,5,0,0,5,100.0
220253,2020,3,0,0,3,100.0
220255,2012,2,0,0,2,100.0
220255,2013,2,0,0,2,100.0
220255,2015,2,0,0,2,100.0
220255,2016,1,0,0,1,100.0
220255,2019,2,0,0,2,100.0
220255,2020,1,0,0,1,100.0
220260,2012,11,0,1,12,91.66666666666666
220260,2013,6,0,0,6,100.0
220260,2014,9,0,0,9,100.0
220260,2015,6,0,0,6,100.0
220260,2016,5,0,1,6,83.33333333333334
220260,2017,8,0,0,8,100.0
220260,2018,6,0,0,6,100.0
220260,2019,5,0,2,7,71.42857142857143
220260,2020,5,0,0,5,100.0
220265,2013,1,0,0,1,100.0
220265,2015,1,0,0,1,100.0
220265,2018,1,0,0,1,100.0
220265,2019,1,0,0,1,100.0
220265,2020,2,0,0,2,100.0
220270,2012,3,3,6,12,50.0
220270,2013,0,1,2,3,33.33333333333333
220270,2014,1,0,4,5,20.0
220270,2015,8,0,1,9,88.88888888888889
220270,2016,6,0,2,8,75.0
220270,2017,13,0,0,13,100.0
220270,2018,9,0,0,9,100.0
220270,2019,13,0,2,15,86.66666666666667
220270,2020,16,0,1,17,94.11764705882352
220271,2012,1,0,0,1,100.0
220271,2013,3,0,0,3,100.0
220271,2014,5,0,0,5,100.0
220271,2015,2,0,0,2,100.0
220271,2016,2,0,0,2,100.0
220271,2017,3,0,0,3,100.0
220271,2018,3,0,0,3,100.0
220271,2020,1,0,0,1,100.0
220272,2012,0,0,1,1,0.0
220272,2013,2,0,0,2,100.0
220272,2014,1,0,0,1,100.0
220272,2015,1,0,0,1,100.0
220272,2019,1,0,0,1,100.0
220272,2020,3,0,0,3,100.0
220273,2013,1,0,1,2,50.0
220273,2015,0,0,1,1,0.0
220273,2017,1,0,0,1,100.0
220273,2020,1,0,0,1,100.0
220275,2012,2,0,0,2,100.0
220275,2013,2,0,0,2,100.0
220275,2014,4,0,0,4,100.0
220275,2015,4,0,0,4,100.0
220275,2016,3,0,0,3,100.0
220275,2017,4,0,0,4,100.0
220275,2019,1,0,1,2,50.0
220275,2020,1,0,0,1,100.0
220277,2012,0,0,1,1,0.0
220277,2013,0,0,3,3,0.0
220277,2014,3,0,0,3,100.0
220277,2015,7,0,0,7,100.0
220277,2016,4,0,0,4,100.0
220277,2017,0,0,1,1,0.0
220277,2018,1,0,0,1,100.0
220277,2019,1,0,1,2,50.0
220277,2020,2,0,0,2,100.0
220280,2013,1,0,0,1,100.0
220280,2014,1,0,1,2,50.0
220280,2015,1,0,0,1,100.0
220280,2016,1,0,1,2,50.0
220280,2019,0,0,3,3,0.0
220280,2020,0,0,5,5,0.0
220285,2012,2,0,1,3,66.66666666666666
220285,2013,0,0,1,1,0.0
220285,2015,0,0,1,1,0.0
220285,2017,0,0,1,1,0.0
220285,2019,0,0,1,1,0.0
220285,2020,0,1,1,2,50.0
220290,2012,7,0,1,8,87.5
220290,2013,6,0,0,6,100.0
220290,2014,9,0,1,10,90.0
220290,2015,7,2,0,9,100.0
220290,2016,7,0,0,7,100.0
220290,2017,14,0,0,14,100.0
220290,2018,5,0,0,5,100.0
220290,2019,8,0,1,9,88.88888888888889
220290,2020,1,4,12,17,29.411764705882355
220300,2012,2,0,1,3,66.66666666666666
220300,2013,1,1,0,2,100.0
220300,2014,1,0,0,1,100.0
220300,2015,1,0,0,1,100.0
220300,2017,3,0,0,3,100.0
220300,2018,5,0,0,5,100.0
220300,2019,2,0,0,2,100.0
220300,2020,0,0,1,1,0.0
220310,2012,4,0,0,4,100.0
220310,2013,5,0,0,5,100.0
220310,2014,3,0,0,3,100.0
220310,2015,2,0,0,2,100.0
220310,2016,2,0,0,2,100.0
220310,2017,1,0,0,1,100.0
220310,2018,2,0,0,2,100.0
220310,2020,3,0,0,3,100.0
220320,2012,6,0,1,7,85.71428571428571
220320,2014,2,0,2,4,50.0
220320,2015,2,0,3,5,40.0
220320,2016,3,0,2,5,60.0
220320,2017,2,0,0,2,100.0
220320,2018,3,0,1,4,75.0
220320,2019,0,0,3,3,0.0
220320,2020,0,0,1,1,0.0
220323,2012,2,0,0,2,100.0
220323,2014,0,0,1,1,0.0
220323,2015,4,0,0,4,100.0
220323,2017,1,0,0,1,100.0
220323,2018,3,0,0,3,100.0
220323,2020,3,0,0,3,100.0
220325,2013,0,0,2,2,0.0
220325,2015,1,0,0,1,100.0
220325,2016,1,0,0,1,100.0
220325,2017,1,0,0,1,100.0
220325,2020,0,0,1,1,0.0
220327,2012,1,0,0,1,100.0
220327,2013,1,0,0,1,100.0
220327,2014,0,0,2,2,0.0
220327,2015,0,0,2,2,0.0
220327,2016,0,0,1,1,0.0
220327,2017,1,0,0,1,100.0
220327,2018,2,0,0,2,100.0
220327,2019,2,0,0,2,100.0
220327,2020,1,0,0,1,100.0
220330,2012,1,0,3,4,25.0
220330,2013,6,0,0,6,100.0
220330,2014,5,0,0,5,100.0
220330,2015,3,0,0,3,100.0
220330,2016,4,0,0,4,100.0
220330,2017,8,0,0,8,100.0
220330,2018,4,0,0,4,100.0
220330,2019,9,0,0,9,100.0
220330,2020,4,0,0,4,100.0
220335,2013,1,0,3,4,25.0
220335,2014,0,1,1,2,50.0
220335,2015,0,0,1,1,0.0
220335,2017,0,0,1,1,0.0
220335,2020,0,1,0,1,100.0
220340,2012,2,0,0,2,100.0
220340,2013,4,0,0,4,100.0
220340,2014,1,0,0,1,100.0
220340,2015,4,0,0,4,100.0
220340,2016,2,0,0,2,100.0
220340,2018,2,0,0,2,100.0
220340,2019,0,0,2,2,0.0
220342,2013,1,0,0,1,100.0
220342,2014,2,0,0,2,100.0
220342,2015,1,0,0,1,100.0
220342,2016,1,0,0,1,100.0
220342,2017,1,0,0,1,100.0
220342,2018,1,0,0,1,100.0
220342,2020,3,0,0,3,100.0
220345,2012,1,1,0,2,100.0
220345,2015,4,0,0,4,100.0
220345,2016,4,0,0,4,100.0
220345,2017,6,0,0,6,100.0
220345,2018,2,0,0,2,100.0
220345,2019,1,0,0,1,100.0
220345,2020,1,0,1,2,50.0
220350,2012,1,0,3,4,25.0
220350,2013,1,0,6,7,14.285714285714285
220350,2014,1,0,0,1,100.0
220350,2015,1,0,1,2,50.0
220350,2016,1,0,4,5,20.0
220350,2017,5,0,0,5,100.0
220350,2018,4,0,0,4,100.0
220350,2019,3,0,0,3,100.0
220350,2020,7,0,0,7,100.0
220360,2012,1,0,0,1,100.0
220360,2013,2,0,0,2,100.0
220360,2015,2,0,0,2,100.0
220360,2016,1,0,0,1,100.0
220360,2018,0,0,1,1,0.0
220360,2019,0,0,3,3,0.0
220370,2012,7,0,1,8,87.5
220370,2013,9,0,1,10,90.0
220370,2014,7,0,0,7,100.0
220370,2015,11,0,0,11,100.0
220370,2016,15,0,0,15,100.0
220370,2017,13,0,0,13,100.0
220370,2018,24,0,0,24,100.0
220370,2019,14,0,1,15,93.33333333333333
220370,2020,10,3,1,14,92.85714285714286
220375,2012,1,0,2,3,33.33333333333333
220375,2013,0,0,1,1,0.0
220375,2014,0,1,0,1,100.0
220375,2015,0,0,1,1,0.0
220375,2017,3,0,0,3,100.0
220375,2019,0,0,2,2,0.0
220375,2020,0,0,1,1,0.0
220380,2012,4,0,0,4,100.0
220380,2013,0,0,1,1,0.0
220380,2014,1,0,0,1,100.0
220380,2015,2,0,2,4,50.0
220380,2019,1,0,0,1,100.0
220380,2020,0,0,1,1,0.0
220385,2012,1,0,0,1,100.0
220385,2015,2,0,0,2,100.0
220385,2016,1,0,0,1,100.0
220390,2012,21,0,1,22,95.45454545454545
220390,2013,11,0,0,11,100.0
220390,2014,16,0,1,17,94.11764705882352
220390,2015,20,0,1,21,95.23809523809523
220390,2016,25,0,0,25,100.0
220390,2017,17,0,0,17,100.0
220390,2018,18,0,0,18,100.0
220390,2019,13,0,0,13,100.0
220390,2020,13,0,0,13,100.0
220400,2014,0,0,2,2,0.0
220400,2017,0,0,1,1,0.0
220400,2018,0,0,1,1,0.0
220400,2019,2,0,0,2,100.0
220400,2020,1,0,2,3,33.33333333333333
220410,2013,3,0,1,4,75.0
220410,2014,1,0,0,1,100.0
220410,2015,1,0,0,1,100.0
220410,2017,0,0,1,1,0.0
220410,2019,3,0,0,3,100.0
220410,2020,0,0,1,1,0.0
220415,2012,0,0,1,1,0.0
220415,2014,0,1,1,2,50.0
220415,2015,1,0,0,1,100.0
220415,2016,1,0,0,1,100.0
220415,2017,1,0,0,1,100.0
220415,2018,1,0,0,1,100.0
220415,2019,2,1,0,3,100.0
220415,2020,1,0,0,1,100.0
220420,2012,3,0,0,3,100.0
220420,2013,3,0,0,3,100.0
220420,2014,4,0,0,4,100.0
220420,2016,1,0,0,1,100.0
220420,2017,3,0,0,3,100.0
220420,2018,2,0,0,2,100.0
220420,2019,2,0,0,2,100.0
220420,2020,2,0,0,2,100.0
220430,2012,10,0,0,10,100.0
220430,2013,3,0,0,3,100.0
220430,2014,3,0,0,3,100.0
220430,2015,3,0,0,3,100.0
220430,2016,2,0,0,2,100.0
220430,2017,4,0,1,5,80.0
220430,2018,9,0,0,9,100.0
220430,2019,2,0,0,2,100.0
220430,2020,6,0,0,6,100.0
220435,2012,5,0,1,6,83.33333333333334
220435,2014,2,0,1,3,66.66666666666666
220435,2015,2,0,0,2,100.0
220435,2016,4,0,1,5,80.0
220435,2017,1,0,0,1,100.0
220435,2018,3,0,0,3,100.0
220435,2019,4,0,0,4,100.0
220435,2020,4,0,0,4,100.0
220440,2012,1,0,0,1,100.0
220440,2013,1,1,3,5,40.0
220440,2014,1,1,1,3,66.66666666666666
220440,2015,0,0,1,1,0.0
220440,2016,1,0,0,1,100.0
220440,2017,1,0,1,2,50.0
220440,2018,2,0,0,2,100.0
220440,2019,8,0,0,8,100.0
220440,2020,1,0,1,2,50.0
220450,2012,1,0,3,4,25.0
220450,2013,4,0,0,4,100.0
220450,2014,4,0,0,4,100.0
220450,2015,6,0,0,6,100.0
220450,2016,4,0,0,4,100.0
220450,2017,2,0,0,2,100.0
220450,2018,5,0,0,5,100.0
220450,2019,1,0,0,1,100.0
220455,2012,1,0,0,1,100.0
220455,2013,0,0,1,1,0.0
220455,2014,0,0,1,1,0.0
220455,2016,1,0,0,1,100.0
220455,2017,1,0,2,3,33.33333333333333
220455,2018,1,0,0,1,100.0
220455,2020,0,0,1,1,0.0
220460,2012,0,0,1,1,0.0
220460,2013,1,0,0,1,100.0
220460,2014,0,1,0,1,100.0
220460,2016,0,0,2,2,0.0
220460,2017,1,0,1,2,50.0
220460,2018,1,0,0,1,100.0
220460,2019,3,0,0,3,100.0
220460,2020,0,1,1,2,50.0
220465,2012,2,0,3,5,40.0
220465,2013,0,0,2,2,0.0
220465,2014,0,2,2,4,50.0
220465,2015,2,0,0,2,100.0
220465,2016,4,0,0,4,100.0
220465,2017,2,0,0,2,100.0
220465,2018,7,0,0,7,100.0
220465,2019,3,0,1,4,75.0
220465,2020,3,0,0,3,100.0
220470,2012,1,0,0,1,100.0
220470,2013,5,0,0,5,100.0
220470,2014,5,0,0,5,100.0
220470,2015,2,0,0,2,100.0
220470,2016,3,0,0,3,100.0
220470,2017,4,0,0,4,100.0
220470,2018,7,0,0,7,100.0
220470,2019,4,0,0,4,100.0
220470,2020,6,0,0,6,100.0
220480,2012,4,0,0,4,100.0
220480,2013,3,0,0,3,100.0
220480,2014,5,0,0,5,100.0
220480,2015,4,0,0,4,100.0
220480,2016,2,0,0,2,100.0
220480,2017,2,0,0,2,100.0
220480,2018,5,0,0,5,100.0
220480,2019,2,0,0,2,100.0
220480,2020,6,0,0,6,100.0
220490,2012,5,0,0,5,100.0
220490,2013,2,0,0,2,100.0
220490,2014,3,0,0,3,100.0
220490,2015,3,0,0,3,100.0
220490,2016,6,0,0,6,100.0
220490,2017,1,0,0,1,100.0
220490,2018,1,0,0,1,100.0
220490,2019,3,0,0,3,100.0
220490,2020,1,0,0,1,100.0
220500,2012,2,1,0,3,100.0
220500,2013,4,0,0,4,100.0
220500,2014,7,0,0,7,100.0
220500,2015,3,0,0,3,100.0
220500,2016,2,0,0,2,100.0
220500,2017,3,0,0,3,100.0
220500,2018,4,0,0,4,100.0
220500,2019,3,0,0,3,100.0
220500,2020,1,0,0,1,100.0
220510,2012,5,0,0,5,100.0
220510,2013,5,0,0,5,100.0
220510,2014,2,0,0,2,100.0
220510,2015,3,0,1,4,75.0
220510,2016,2,0,0,2,100.0
220510,2017,3,0,4,7,42.857142857142854
220510,2018,1,0,2,3,33.33333333333333
220510,2019,0,0,2,2,0.0
220510,2020,0,0,4,4,0.0
220515,2012,0,0,1,1,0.0
220515,2014,0,0,2,2,0.0
220515,2015,2,0,0,2,100.0
220515,2016,2,0,1,3,66.66666666666666
220515,2017,1,0,0,1,100.0
220515,2018,3,0,0,3,100.0
220515,2019,2,0,0,2,100.0
220515,2020,1,0,0,1,100.0
220520,2012,5,0,0,5,100.0
220520,2013,2,0,0,2,100.0
220520,2014,5,0,3,8,62.5
220520,2015,7,0,0,7,100.0
220520,2016,3,0,0,3,100.0
220520,2017,6,0,0,6,100.0
220520,2018,7,0,0,7,100.0
220520,2019,9,0,0,9,100.0
220520,2020,6,0,0,6,100.0
220525,2012,1,0,1,2,50.0
220525,2013,0,0,1,1,0.0
220525,2015,0,0,3,3,0.0
220525,2017,0,0,2,2,0.0
220525,2020,0,0,1,1,0.0
220527,2014,0,0,2,2,0.0
220527,2015,1,0,1,2,50.0
220527,2016,4,0,0,4,100.0
220527,2017,1,0,0,1,100.0
220527,2018,2,0,0,2,100.0
220527,2019,1,0,0,1,100.0
220527,2020,2,0,0,2,100.0
220530,2012,1,0,0,1,100.0
220530,2013,1,0,0,1,100.0
220530,2014,1,0,0,1,100.0
220530,2015,3,0,0,3,100.0
220530,2016,3,1,0,4,100.0
220530,2017,2,0,0,2,100.0
220530,2018,3,0,0,3,100.0
220530,2019,1,0,0,1,100.0
220530,2020,0,0,1,1,0.0
220535,2012,2,0,0,2,100.0
220535,2016,1,0,0,1,100.0
220535,2019,1,0,0,1,100.0
220535,2020,0,0,1,1,0.0
220540,2012,3,0,0,3,100.0
220540,2013,7,0,0,7,100.0
220540,2014,1,0,0,1,100.0
220540,2015,5,0,0,5,100.0
220540,2016,5,0,0,5,100.0
220540,2017,4,0,0,4,100.0
220540,2018,4,0,0,4,100.0
220540,2019,3,0,0,3,100.0
220540,2020,5,0,0,5,100.0
220545,2012,1,0,0,1,100.0
220545,2013,2,0,0,2,100.0
220545,2014,3,0,0,3,100.0
220545,2016,1,0,0,1,100.0
220545,2017,1,0,0,1,100.0
220545,2018,2,0,0,2,100.0
220545,2019,1,0,0,1,100.0
220550,2012,7,0,0,7,100.0
220550,2013,10,0,0,10,100.0
220550,2014,4,0,0,4,100.0
220550,2015,7,0,2,9,77.77777777777779
220550,2016,15,0,1,16,93.75
220550,2017,5,2,1,8,87.5
220550,2018,9,0,3,12,75.0
220550,2019,7,0,7,14,50.0
220550,2020,7,1,4,12,66.66666666666666
220551,2012,0,0,1,1,0.0
220551,2015,1,0,0,1,100.0
220551,2017,1,0,0,1,100.0
220551,2018,1,0,0,1,100.0
220551,2020,1,0,0,1,100.0
220552,2016,3,0,0,3,100.0
220552,2017,1,0,0,1,100.0
220552,2018,2,0,0,2,100.0
220552,2020,4,0,0,4,100.0
220553,2013,1,0,0,1,100.0
220553,2014,1,0,0,1,100.0
220553,2016,3,0,0,3,100.0
220553,2018,2,0,0,2,100.0
220554,2012,0,1,0,1,100.0
220554,2014,0,0,4,4,0.0
220554,2015,0,0,3,3,0.0
220554,2020,0,0,1,1,0.0
220555,2013,0,0,2,2,0.0
220555,2014,0,0,3,3,0.0
220555,2015,0,0,3,3,0.0
220555,2016,1,0,0,1,100.0
220555,2017,4,0,0,4,100.0
220555,2018,1,0,1,2,50.0
220555,2019,1,0,0,1,100.0
220555,2020,0,0,3,3,0.0
220556,2012,3,0,0,3,100.0
220556,2013,5,0,0,5,100.0
220556,2014,1,0,0,1,100.0
220556,2015,6,0,0,6,100.0
220556,2016,2,0,0,2,100.0
220556,2017,3,0,0,3,100.0
220556,2018,2,0,0,2,100.0
220556,2019,1,0,0,1,100.0
220556,2020,1,0,0,1,100.0
220557,2012,2,0,0,2,100.0
220557,2015,1,0,0,1,100.0
220557,2016,0,0,1,1,0.0
220557,2020,2,0,0,2,100.0
220558,2012,0,0,1,1,0.0
220558,2014,1,0,0,1,100.0
220558,2015,1,0,0,1,100.0
220558,2016,2,0,0,2,100.0
220558,2019,1,0,0,1,100.0
220559,2012,1,1,0,2,100.0
220559,2013,2,0,0,2,100.0
220559,2015,2,0,0,2,100.0
220559,2016,0,0,1,1,0.0
220559,2017,1,0,1,2,50.0
220559,2019,1,0,0,1,100.0
220560,2012,4,0,0,4,100.0
220560,2014,1,0,1,2,50.0
220560,2015,1,0,0,1,100.0
220560,2016,2,0,0,2,100.0
220560,2018,1,0,0,1,100.0
220570,2012,7,0,0,7,100.0
220570,2013,1,5,6,12,50.0
220570,2014,2,1,2,5,60.0
220570,2015,8,0,0,8,100.0
220570,2016,12,0,0,12,100.0
220570,2017,13,0,1,14,92.85714285714286
220570,2018,8,0,0,8,100.0
220570,2019,7,1,1,9,88.88888888888889
220570,2020,2,7,5,14,64.28571428571429
220580,2012,11,0,1,12,91.66666666666666
220580,2013,8,0,1,9,88.88888888888889
220580,2014,7,0,1,8,87.5
220580,2015,8,0,0,8,100.0
220580,2016,8,0,1,9,88.88888888888889
220580,2017,5,0,0,5,100.0
220580,2018,11,0,0,11,100.0
220580,2019,4,0,0,4,100.0
220580,2020,6,0,1,7,85.71428571428571
220585,2012,3,0,0,3,100.0
220585,2013,3,0,0,3,100.0
220585,2014,5,0,0,5,100.0
220585,2015,7,0,0,7,100.0
220585,2016,1,0,0,1,100.0
220585,2018,1,0,0,1,100.0
220585,2019,1,0,0,1,100.0
220585,2020,2,0,0,2,100.0
220590,2012,2,0,0,2,100.0
220590,2013,3,0,0,3,100.0
220590,2016,1,0,0,1,100.0
220590,2017,3,0,0,3,100.0
220590,2018,1,0,0,1,100.0
220590,2019,3,0,1,4,75.0
220590,2020,4,0,0,4,100.0
220595,2012,5,0,0,5,100.0
220595,2013,1,0,0,1,100.0
220595,2014,4,0,0,4,100.0
220595,2015,2,0,1,3,66.66666666666666
220595,2016,1,0,1,2,50.0
220595,2017,2,0,0,2,100.0
220595,2018,4,0,0,4,100.0
220595,2019,2,0,0,2,100.0
220595,2020,0,0,4,4,0.0
220600,2013,2,0,0,2,100.0
220600,2014,1,0,0,1,100.0
220600,2015,0,0,1,1,0.0
220600,2016,3,0,0,3,100.0
220600,2018,2,0,0,2,100.0
220600,2019,3,0,2,5,60.0
220600,2020,0,0,1,1,0.0
220605,2012,1,0,0,1,100.0
220605,2013,1,0,0,1,100.0
220605,2015,2,0,0,2,100.0
220605,2016,2,0,0,2,100.0
220605,2017,2,0,0,2,100.0
220605,2020,4,0,0,4,100.0
220610,2012,3,0,1,4,75.0
220610,2013,2,0,0,2,100.0
220610,2014,2,0,1,3,66.66666666666666
220610,2015,2,0,0,2,100.0
220610,2016,3,0,0,3,100.0
220610,2017,5,0,0,5,100.0
220610,2018,1,0,0,1,100.0
220610,2019,5,0,0,5,100.0
220610,2020,7,0,0,7,100.0
220620,2012,8,0,0,8,100.0
220620,2013,8,0,0,8,100.0
220620,2014,6,0,0,6,100.0
220620,2015,7,0,0,7,100.0
220620,2016,9,0,0,9,100.0
220620,2017,13,0,0,13,100.0
220620,2018,8,0,0,8,100.0
220620,2019,5,0,1,6,83.33333333333334
220620,2020,7,0,7,14,50.0
220630,2015,0,0,1,1,0.0
220630,2017,1,0,0,1,100.0
220635,2012,1,0,0,1,100.0
220635,2015,2,0,0,2,100.0
220635,2016,1,0,0,1,100.0
220635,2018,2,0,0,2,100.0
220635,2019,3,0,0,3,100.0
220635,2020,3,0,0,3,100.0
220640,2013,3,0,0,3,100.0
220640,2014,3,0,0,3,100.0
220640,2015,6,0,0,6,100.0
220640,2016,4,0,0,4,100.0
220640,2017,3,0,0,3,100.0
220640,2018,1,0,0,1,100.0
220640,2019,2,0,0,2,100.0
220640,2020,6,0,0,6,100.0
220650,2012,5,0,0,5,100.0
220650,2013,1,0,0,1,100.0
220650,2014,2,0,0,2,100.0
220650,2015,1,0,0,1,100.0
220650,2016,3,0,0,3,100.0
220650,2017,2,0,0,2,100.0
220650,2018,4,0,0,4,100.0
220650,2019,2,0,0,2,100.0
220650,2020,2,0,0,2,100.0
220660,2012,5,0,2,7,71.42857142857143
220660,2013,4,0,0,4,100.0
220660,2014,2,1,0,3,100.0
220660,2015,0,0,1,1,0.0
220660,2017,0,0,2,2,0.0
220660,2018,1,0,0,1,100.0
220660,2019,1,0,4,5,20.0
220660,2020,0,0,3,3,0.0
220665,2013,0,0,1,1,0.0
220665,2014,0,0,1,1,0.0
220665,2015,0,0,1,1,0.0
220665,2016,2,0,0,2,100.0
220665,2017,1,0,0,1,100.0
220665,2018,2,0,0,2,100.0
220665,2019,1,0,0,1,100.0
220665,2020,0,0,3,3,0.0
220667,2012,3,0,0,3,100.0
220667,2013,1,0,0,1,100.0
220667,2015,6,0,0,6,100.0
220667,2016,2,0,0,2,100.0
220667,2017,1,0,0,1,100.0
220667,2018,1,0,0,1,100.0
220667,2019,1,0,0,1,100.0
220669,2013,3,0,0,3,100.0
220669,2014,0,1,2,3,33.33333333333333
220669,2015,1,0,0,1,100.0
220669,2016,2,0,0,2,100.0
220669,2017,1,0,0,1,100.0
220669,2018,1,0,0,1,100.0
220669,2019,1,0,0,1,100.0
220669,2020,1,0,0,1,100.0
220670,2012,2,0,0,2,100.0
220670,2013,0,0,1,1,0.0
220670,2014,0,0,2,2,0.0
220670,2015,1,0,1,2,50.0
220670,2016,1,1,1,3,66.66666666666666
220670,2017,0,1,2,3,33.33333333333333
220670,2018,2,0,0,2,100.0
220670,2019,0,0,1,1,0.0
220670,2020,2,0,0,2,100.0
220672,2012,3,0,0,3,100.0
220672,2013,0,0,2,2,0.0
220672,2014,2,0,1,3,66.66666666666666
220672,2015,3,0,0,3,100.0
220672,2016,3,0,0,3,100.0
220672,2017,3,0,0,3,100.0
220672,2018,3,0,0,3,100.0
220672,2019,6,0,0,6,100.0
220672,2020,6,0,0,6,100.0
220675,2012,2,0,0,2,100.0
220675,2013,0,0,1,1,0.0
220675,2014,2,0,0,2,100.0
220675,2015,2,0,0,2,100.0
220675,2017,1,0,0,1,100.0
220675,2019,1,0,0,1,100.0
220675,2020,0,0,2,2,0.0
220680,2012,1,0,1,2,50.0
220680,2013,4,0,1,5,80.0
220680,2014,4,0,0,4,100.0
220680,2015,1,0,0,1,100.0
220680,2016,4,0,0,4,100.0
220680,2017,2,0,0,2,100.0
220680,2018,4,0,0,4,100.0
220680,2019,1,0,0,1,100.0
220680,2020,7,0,0,7,100.0
220690,2012,1,0,1,2,50.0
220690,2013,3,0,0,3,100.0
220690,2015,2,0,2,4,50.0
220690,2016,2,0,0,2,100.0
220690,2017,1,0,1,2,50.0
220690,2018,0,0,1,1,0.0
220690,2020,4,0,1,5,80.0
220695,2012,2,0,0,2,100.0
220695,2013,1,0,0,1,100.0
220695,2014,2,0,0,2,100.0
220695,2015,2,0,0,2,100.0
220695,2016,3,0,0,3,100.0
220695,2017,1,0,0,1,100.0
220695,2019,0,0,1,1,0.0
220695,2020,0,1,1,2,50.0
220700,2012,19,0,0,19,100.0
220700,2013,10,0,1,11,90.9090909090909
220700,2014,11,0,0,11,100.0
220700,2015,10,0,0,10,100.0
220700,2016,8,0,0,8,100.0
220700,2017,10,0,0,10,100.0
220700,2018,15,0,0,15,100.0
220700,2019,20,0,0,20,100.0
220700,2020,13,0,0,13,100.0
220710,2013,0,0,1,1,0.0
220710,2018,2,0,1,3,66.66666666666666
220710,2020,0,0,1,1,0.0
220720,2012,2,0,0,2,100.0
220720,2013,2,0,0,2,100.0
220720,2014,4,0,0,4,100.0
220720,2015,2,0,0,2,100.0
220720,2016,3,0,0,3,100.0
220720,2017,4,0,0,4,100.0
220720,2018,1,0,0,1,100.0
220720,2019,4,0,0,4,100.0
220720,2020,5,0,0,5,100.0
220730,2012,1,0,1,2,50.0
220730,2013,2,0,0,2,100.0
220730,2014,0,0,2,2,0.0
220730,2015,1,0,0,1,100.0
220730,2016,4,0,0,4,100.0
220730,2017,0,1,1,2,50.0
220730,2018,0,0,1,1,0.0
220730,2019,0,0,1,1,0.0
220730,2020,0,0,1,1,0.0
220735,2012,2,0,0,2,100.0
220735,2013,1,0,0,1,100.0
220735,2014,1,0,0,1,100.0
220735,2015,1,0,0,1,100.0
220735,2018,1,0,0,1,100.0
220740,2012,2,0,2,4,50.0
220740,2013,1,0,1,2,50.0
220740,2014,3,0,1,4,75.0
220740,2016,0,0,1,1,0.0
220740,2017,3,0,0,3,100.0
220740,2018,0,0,1,1,0.0
220740,2019,0,0,2,2,0.0
220750,2012,2,0,1,3,66.66666666666666
220750,2013,2,0,2,4,50.0
220750,2014,0,1,2,3,33.33333333333333
220750,2015,1,0,3,4,25.0
220750,2016,2,0,2,4,50.0
220750,2017,5,0,0,5,100.0
220750,2018,3,0,0,3,100.0
220750,2019,4,0,0,4,100.0
220750,2020,0,1,4,5,20.0
220755,2012,1,0,0,1,100.0
220755,2013,2,0,0,2,100.0
220755,2016,1,0,1,2,50.0
220755,2018,2,0,0,2,100.0
220755,2019,3,0,0,3,100.0
220755,2020,1,0,0,1,100.0
220760,2012,1,0,0,1,100.0
220760,2014,1,0,0,1,100.0
220760,2015,2,0,1,3,66.66666666666666
220760,2016,4,0,0,4,100.0
220760,2017,3,0,0,3,100.0
220760,2018,1,0,0,1,100.0
220760,2019,1,0,3,4,25.0
220760,2020,0,0,2,2,0.0
220770,2012,39,1,2,42,95.23809523809523
220770,2013,33,3,16,52,69.23076923076923
220770,2014,41,0,4,45,91.11111111111111
220770,2015,49,0,0,49,100.0
220770,2016,51,0,1,52,98.07692307692307
220770,2017,63,0,0,63,100.0
220770,2018,63,1,1,65,98.46153846153847
220770,2019,55,0,2,57,96.49122807017544
220770,2020,34,6,24,64,62.5
220775,2012,1,0,0,1,100.0
220775,2013,2,0,0,2,100.0
220775,2016,1,0,0,1,100.0
220775,2017,1,0,0,1,100.0
220775,2018,2,0,0,2,100.0
220775,2019,2,0,0,2,100.0
220777,2012,1,0,0,1,100.0
220777,2013,1,0,0,1,100.0
220777,2015,1,0,0,1,100.0
220777,2016,1,0,0,1,100.0
220777,2017,3,0,0,3,100.0
220777,2019,2,0,0,2,100.0
220779,2012,0,0,1,1,0.0
220779,2016,0,0,2,2,0.0
220779,2017,0,0,2,2,0.0
220779,2018,0,0,1,1,0.0
220779,2020,0,0,2,2,0.0
220780,2012,8,0,0,8,100.0
220780,2013,5,0,0,5,100.0
220780,2014,16,0,0,16,100.0
220780,2015,5,0,0,5,100.0
220780,2016,10,0,2,12,83.33333333333334
220780,2017,8,0,0,8,100.0
220780,2018,6,0,0,6,100.0
220780,2019,13,0,0,13,100.0
220780,2020,12,0,0,12,100.0
220785,2012,0,0,1,1,0.0
220785,2015,0,0,2,2,0.0
220785,2016,0,0,1,1,0.0
220785,2018,0,0,2,2,0.0
220790,2012,10,0,0,10,100.0
220790,2013,14,0,0,14,100.0
220790,2014,9,0,0,9,100.0
220790,2015,5,0,0,5,100.0
220790,2016,9,0,0,9,100.0
220790,2017,7,0,0,7,100.0
220790,2018,6,0,0,6,100.0
220790,2019,14,0,0,14,100.0
220790,2020,8,0,0,8,100.0
220793,2013,2,0,0,2,100.0
220793,2016,1,0,0,1,100.0
220793,2017,0,0,1,1,0.0
220793,2019,0,0,2,2,0.0
220795,2012,1,0,0,1,100.0
220795,2013,3,0,0,3,100.0
220795,2014,1,0,0,1,100.0
220795,2017,3,0,0,3,100.0
220795,2019,1,0,0,1,100.0
220800,2012,30,0,0,30,100.0
220800,2013,27,0,0,27,100.0
220800,2014,24,0,2,26,92.3076923076923
220800,2015,28,0,0,28,100.0
220800,2016,23,0,0,23,100.0
220800,2017,32,0,0,32,100.0
220800,2018,25,0,0,25,100.0
220800,2019,22,0,0,22,100.0
220800,2020,27,0,0,27,100.0
220810,2012,5,0,0,5,100.0
220810,2013,1,0,2,3,33.33333333333333
220810,2014,1,0,1,2,50.0
220810,2015,2,0,0,2,100.0
220810,2017,3,0,1,4,75.0
220810,2018,1,0,0,1,100.0
220810,2019,1,0,3,4,25.0
220810,2020,3,0,0,3,100.0
220820,2012,6,0,0,6,100.0
220820,2013,13,0,0,13,100.0
220820,2014,8,0,0,8,100.0
220820,2015,4,0,0,4,100.0
220820,2016,7,0,0,7,100.0
220820,2017,5,0,0,5,100.0
220820,2018,7,0,0,7,100.0
220820,2019,7,0,0,7,100.0
220820,2020,8,0,0,8,100.0
220830,2012,8,0,0,8,100.0
220830,2013,5,0,0,5,100.0
220830,2014,11,0,1,12,91.66666666666666
220830,2015,9,0,0,9,100.0
220830,2016,6,0,0,6,100.0
220830,2017,9,0,0,9,100.0
220830,2018,12,0,0,12,100.0
220830,2019,11,0,0,11,100.0
220830,2020,8,0,0,8,100.0
220840,2012,22,0,0,22,100.0
220840,2013,28,0,0,28,100.0
220840,2014,20,1,2,23,91.30434782608695
220840,2015,20,0,0,20,100.0
220840,2016,25,0,0,25,100.0
220840,2017,19,0,0,19,100.0
220840,2018,24,0,0,24,100.0
220840,2019,18,0,0,18,100.0
220840,2020,19,0,0,19,100.0
220850,2012,1,0,1,2,50.0
220850,2013,0,1,3,4,25.0
220850,2014,6,0,2,8,75.0
220850,2015,1,0,0,1,100.0
220850,2016,1,0,2,3,33.33333333333333
220850,2017,4,0,0,4,100.0
220850,2018,7,0,0,7,100.0
220850,2019,2,0,2,4,50.0
220850,2020,5,0,0,5,100.0
220855,2012,1,0,0,1,100.0
220855,2016,1,0,0,1,100.0
220855,2017,1,0,0,1,100.0
220855,2020,0,0,1,1,0.0
220860,2014,0,0,1,1,0.0
220860,2015,1,0,0,1,100.0
220860,2016,1,0,0,1,100.0
220860,2017,1,0,3,4,25.0
220860,2019,1,0,0,1,100.0
220865,2013,1,0,0,1,100.0
220865,2015,5,0,0,5,100.0
220865,2016,4,0,0,4,100.0
220865,2017,3,0,0,3,100.0
220865,2018,4,0,0,4,100.0
220865,2019,1,0,0,1,100.0
220865,2020,5,0,0,5,100.0
220870,2012,2,0,1,3,66.66666666666666
220870,2013,3,0,1,4,75.0
220870,2014,0,0,2,2,0.0
220870,2015,0,0,2,2,0.0
220870,2016,2,0,0,2,100.0
220870,2017,4,0,0,4,100.0
220870,2018,4,0,0,4,100.0
220870,2019,0,0,3,3,0.0
220870,2020,0,0,2,2,0.0
220880,2012,9,0,0,9,100.0
220880,2013,8,0,0,8,100.0
220880,2014,4,0,0,4,100.0
220880,2015,9,0,0,9,100.0
220880,2016,7,0,0,7,100.0
220880,2017,5,0,0,5,100.0
220880,2018,2,0,0,2,100.0
220880,2019,7,0,0,7,100.0
220880,2020,5,0,0,5,100.0
220885,2012,0,1,2,3,33.33333333333333
220885,2015,0,0,2,2,0.0
220885,2017,2,0,0,2,100.0
220885,2018,4,0,0,4,100.0
220887,2013,1,0,0,1,100.0
220887,2015,1,0,0,1,100.0
220887,2018,0,0,1,1,0.0
220887,2019,0,0,1,1,0.0
220887,2020,0,0,1,1,0.0
220890,2014,0,0,1,1,0.0
220890,2015,1,0,0,1,100.0
220890,2016,1,0,0,1,100.0
220890,2017,2,0,1,3,66.66666666666666
220890,2018,1,0,0,1,100.0
220890,2019,0,0,4,4,0.0
220890,2020,0,0,4,4,0.0
220900,2012,1,0,1,2,50.0
220900,2014,4,0,0,4,100.0
220900,2015,3,0,0,3,100.0
220900,2016,2,0,0,2,100.0
220900,2017,1,0,1,2,50.0
220900,2018,4,0,0,4,100.0
220900,2019,5,0,0,5,100.0
220910,2012,3,0,0,3,100.0
220910,2013,0,2,2,4,50.0
220910,2014,0,1,0,1,100.0
220910,2015,2,0,0,2,100.0
220910,2016,2,0,1,3,66.66666666666666
220910,2017,3,0,0,3,100.0
220910,2018,4,0,0,4,100.0
220910,2019,4,0,0,4,100.0
220910,2020,4,0,0,4,100.0
220915,2012,0,0,1,1,0.0
220915,2013,0,0,3,3,0.0
220915,2015,0,0,1,1,0.0
220915,2016,0,0,1,1,0.0
220915,2017,1,0,0,1,100.0
220915,2018,2,0,0,2,100.0
220915,2019,2,0,0,2,100.0
220920,2012,1,0,0,1,100.0
220920,2013,0,0,1,1,0.0
220920,2014,0,0,1,1,0.0
220920,2015,1,0,4,5,20.0
220920,2016,2,0,1,3,66.66666666666666
220920,2017,2,0,0,2,100.0
220920,2018,1,0,0,1,100.0
220920,2019,0,0,5,5,0.0
220920,2020,0,0,1,1,0.0
220930,2013,0,1,0,1,100.0
220930,2014,2,0,2,4,50.0
220930,2015,8,0,0,8,100.0
220930,2016,2,0,0,2,100.0
220930,2017,0,0,1,1,0.0
220930,2018,1,0,0,1,100.0
220930,2019,0,0,3,3,0.0
220930,2020,0,0,1,1,0.0
220935,2012,3,0,0,3,100.0
220935,2015,1,0,0,1,100.0
220935,2016,1,0,0,1,100.0
220935,2017,4,0,0,4,100.0
220935,2018,1,0,0,1,100.0
220935,2019,1,0,0,1,100.0
220935,2020,3,0,0,3,100.0
220937,2012,2,0,1,3,66.66666666666666
220937,2013,1,0,0,1,100.0
220937,2014,3,0,0,3,100.0
220937,2016,4,0,0,4,100.0
220937,2017,1,0,0,1,100.0
220937,2018,3,0,0,3,100.0
220937,2019,1,0,0,1,100.0
220937,2020,2,0,0,2,100.0
220940,2012,6,0,0,6,100.0
220940,2013,1,0,1,2,50.0
220940,2014,0,0,2,2,0.0
220940,2015,2,0,0,2,100.0
220940,2016,0,0,1,1,0.0
220940,2017,0,0,4,4,0.0
220940,2018,4,0,0,4,100.0
220940,2019,2,0,1,3,66.66666666666666
220940,2020,3,0,0,3,100.0
220945,2017,0,0,3,3,0.0
220945,2020,0,1,1,2,50.0
220950,2013,0,0,1,1,0.0
220950,2014,2,0,1,3,66.66666666666666
220950,2015,2,0,0,2,100.0
220950,2017,1,0,0,1,100.0
220950,2020,1,0,0,1,100.0
220955,2012,2,0,0,2,100.0
220955,2013,1,0,0,1,100.0
220955,2014,4,0,0,4,100.0
220955,2016,1,0,0,1,100.0
220955,2017,0,0,1,1,0.0
220955,2019,1,0,0,1,100.0
220955,2020,0,0,2,2,0.0
220960,2016,2,0,0,2,100.0
220960,2018,0,0,1,1,0.0
220960,2020,1,0,0,1,100.0
220965,2012,0,0,4,4,0.0
220965,2014,0,0,1,1,0.0
220965,2015,0,0,3,3,0.0
220965,2017,2,0,0,2,100.0
220965,2019,0,0,2,2,0.0
220965,2020,0,0,6,6,0.0
220970,2012,1,0,0,1,100.0
220970,2013,1,0,1,2,50.0
220970,2014,2,0,1,3,66.66666666666666
220970,2015,3,0,0,3,100.0
220970,2016,1,0,0,1,100.0
220970,2017,0,0,1,1,0.0
220970,2018,3,0,0,3,100.0
220970,2019,4,0,0,4,100.0
220970,2020,1,0,0,1,100.0
220975,2012,0,0,1,1,0.0
220975,2013,1,0,0,1,100.0
220975,2014,2,0,0,2,100.0
220975,2015,1,0,0,1,100.0
220975,2017,1,0,0,1,100.0
220975,2018,2,0,0,2,100.0
220975,2019,1,0,0,1,100.0
220975,2020,1,0,0,1,100.0
220980,2012,1,0,3,4,25.0
220980,2013,0,0,1,1,0.0
220980,2014,0,0,1,1,0.0
220980,2016,1,0,0,1,100.0
220980,2019,2,0,3,5,40.0
220980,2020,0,0,1,1,0.0
220985,2015,1,0,0,1,100.0
220985,2016,1,0,0,1,100.0
220985,2017,1,0,1,2,50.0
220985,2018,3,0,0,3,100.0
220985,2019,1,0,0,1,100.0
220985,2020,2,0,0,2,100.0
220987,2013,0,0,1,1,0.0
220987,2015,4,0,0,4,100.0
220987,2016,3,0,0,3,100.0
220987,2017,4,0,0,4,100.0
220987,2018,3,0,0,3,100.0
220987,2019,4,0,0,4,100.0
220987,2020,1,0,0,1,100.0
220990,2012,1,0,0,1,100.0
220990,2014,2,0,0,2,100.0
220990,2015,0,0,1,1,0.0
220990,2016,0,0,2,2,0.0
220990,2018,3,0,0,3,100.0
220990,2019,0,0,2,2,0.0
220990,2020,2,0,1,3,66.66666666666666
220995,2013,0,0,2,2,0.0
220995,2014,2,0,0,2,100.0
220995,2015,1,0,0,1,100.0
220995,2017,3,0,0,3,100.0
220995,2018,3,0,0,3,100.0
220995,2019,2,0,0,2,100.0
220995,2020,2,0,0,2,100.0
220997,2012,1,0,0,1,100.0
220997,2013,3,0,0,3,100.0
220997,2014,4,0,0,4,100.0
220997,2015,3,0,0,3,100.0
220997,2016,1,0,0,1,100.0
220997,2017,3,0,0,3,100.0
220997,2018,1,0,0,1,100.0
220997,2019,2,0,0,2,100.0
220997,2020,4,0,0,4,100.0
221000,2012,5,0,0,5,100.0
221000,2013,6,0,2,8,75.0
221000,2014,5,0,0,5,100.0
221000,2015,8,0,0,8,100.0
221000,2016,7,0,0,7,100.0
221000,2017,6,0,0,6,100.0
221000,2018,7,0,0,7,100.0
221000,2019,4,0,0,4,100.0
221000,2020,14,0,0,14,100.0
221005,2014,1,0,0,1,100.0
221005,2016,0,0,1,1,0.0
221005,2017,2,0,0,2,100.0
221005,2018,1,0,0,1,100.0
221005,2019,1,0,0,1,100.0
221005,2020,4,0,0,4,100.0
221010,2012,0,1,0,1,100.0
221010,2013,3,0,0,3,100.0
221010,2014,1,0,0,1,100.0
221010,2016,2,0,0,2,100.0
221010,2017,1,0,0,1,100.0
221010,2018,2,0,0,2,100.0
221020,2012,4,0,0,4,100.0
221020,2013,1,0,0,1,100.0
221020,2014,2,0,3,5,40.0
221020,2015,2,0,0,2,100.0
221020,2016,1,0,0,1,100.0
221020,2017,1,0,0,1,100.0
221020,2018,3,0,0,3,100.0
221020,2019,2,0,0,2,100.0
221020,2020,3,0,0,3,100.0
221030,2012,1,0,0,1,100.0
221030,2013,3,0,0,3,100.0
221030,2014,1,0,0,1,100.0
221030,2016,2,0,0,2,100.0
221030,2017,2,0,0,2,100.0
221030,2018,5,0,0,5,100.0
221030,2019,4,0,0,4,100.0
221030,2020,2,0,0,2,100.0
221035,2012,0,0,1,1,0.0
221035,2013,1,0,3,4,25.0
221035,2014,0,0,1,1,0.0
221035,2015,0,0,1,1,0.0
221035,2017,3,0,1,4,75.0
221035,2018,2,0,0,2,100.0
221035,2020,0,0,1,1,0.0
221037,2012,1,0,0,1,100.0
221037,2013,0,0,1,1,0.0
221037,2019,1,0,0,1,100.0
221037,2020,0,0,1,1,0.0
221038,2013,1,0,0,1,100.0
221038,2014,1,0,1,2,50.0
221038,2016,0,0,1,1,0.0
221038,2017,1,0,0,1,100.0
221038,2018,1,0,0,1,100.0
221039,2012,1,0,0,1,100.0
221039,2013,1,0,0,1,100.0
221039,2014,2,0,0,2,100.0
221039,2017,1,0,1,2,50.0
221039,2019,2,0,0,2,100.0
221039,2020,2,0,0,2,100.0
221040,2012,3,0,0,3,100.0
221040,2013,2,0,0,2,100.0
221040,2014,8,0,0,8,100.0
221040,2015,3,0,0,3,100.0
221040,2016,2,0,3,5,40.0
221040,2017,5,0,1,6,83.33333333333334
221040,2018,3,0,0,3,100.0
221040,2019,3,0,0,3,100.0
221040,2020,8,0,0,8,100.0
221050,2012,3,0,0,3,100.0
221050,2013,4,0,0,4,100.0
221050,2014,2,0,0,2,100.0
221050,2015,2,0,0,2,100.0
221050,2016,3,0,0,3,100.0
221050,2017,6,0,0,6,100.0
221050,2018,3,0,0,3,100.0
221050,2019,5,0,0,5,100.0
221050,2020,5,0,0,5,100.0
221060,2012,6,0,6,12,50.0
221060,2013,0,2,9,11,18.181818181818183
221060,2014,8,0,1,9,88.88888888888889
221060,2015,7,0,7,14,50.0
221060,2016,7,0,4,11,63.63636363636363
221060,2017,6,0,1,7,85.71428571428571
221060,2018,12,0,0,12,100.0
221060,2019,19,0,1,20,95.0
221060,2020,10,0,7,17,58.82352941176471
221062,2014,1,0,0,1,100.0
221062,2015,0,1,0,1,100.0
221062,2016,0,0,1,1,0.0
221063,2012,3,0,0,3,100.0
221063,2014,0,0,1,1,0.0
221063,2016,1,0,0,1,100.0
221063,2017,1,0,0,1,100.0
221063,2018,2,0,0,2,100.0
221063,2019,1,0,0,1,100.0
221065,2012,1,0,1,2,50.0
221065,2013,1,0,0,1,100.0
221065,2014,2,1,0,3,100.0
221065,2015,0,0,3,3,0.0
221065,2016,3,0,0,3,100.0
221065,2017,0,0,1,1,0.0
221065,2020,0,0,1,1,0.0
221070,2012,3,0,0,3,100.0
221070,2013,1,0,1,2,50.0
221070,2014,0,0,3,3,0.0
221070,2015,4,0,0,4,100.0
221070,2016,8,1,0,9,100.0
221070,2017,3,0,0,3,100.0
221070,2018,3,0,0,3,100.0
221070,2019,8,0,0,8,100.0
221070,2020,6,0,0,6,100.0
221080,2012,9,0,1,10,90.0
221080,2013,2,0,0,2,100.0
221080,2014,3,0,0,3,100.0
221080,2015,2,0,0,2,100.0
221080,2016,4,0,0,4,100.0
221080,2017,2,0,0,2,100.0
221080,2018,8,0,0,8,100.0
221080,2019,4,0,0,4,100.0
221080,2020,4,0,0,4,100.0
221090,2012,2,0,0,2,100.0
221090,2013,2,0,1,3,66.66666666666666
221090,2014,3,0,0,3,100.0
221090,2015,2,0,0,2,100.0
221090,2016,0,0,1,1,0.0
221090,2017,1,0,0,1,100.0
221090,2018,1,0,0,1,100.0
221090,2019,2,0,0,2,100.0
221090,2020,1,0,0,1,100.0
221093,2012,1,0,0,1,100.0
221093,2013,0,0,1,1,0.0
221093,2014,1,0,0,1,100.0
221093,2015,2,0,0,2,100.0
221093,2016,1,0,0,1,100.0
221093,2017,1,0,0,1,100.0
221093,2018,2,0,0,2,100.0
221093,2019,3,0,3,6,50.0
221093,2020,1,0,0,1,100.0
221095,2012,1,0,0,1,100.0
221095,2013,1,0,0,1,100.0
221095,2015,1,1,1,3,66.66666666666666
221095,2017,2,0,0,2,100.0
221095,2018,2,0,0,2,100.0
221095,2019,1,0,0,1,100.0
221097,2014,2,0,0,2,100.0
221097,2015,1,0,0,1,100.0
221097,2016,1,0,0,1,100.0
221097,2017,2,0,0,2,100.0
221097,2018,2,0,0,2,100.0
221097,2019,1,0,0,1,100.0
221097,2020,1,0,0,1,100.0
221100,2012,300,5,12,317,96.21451104100946
221100,2013,277,3,24,304,92.10526315789474
221100,2014,301,0,4,305,98.68852459016394
221100,2015,305,0,9,314,97.13375796178345
221100,2016,270,0,30,300,90.0
221100,2017,239,1,50,290,82.75862068965517
221100,2018,245,0,13,258,94.96124031007753
221100,2019,223,1,51,275,81.45454545454545
221100,2020,184,31,134,349,61.60458452722063
221110,2012,12,1,5,18,72.22222222222221
221110,2013,7,1,2,10,80.0
221110,2014,14,0,2,16,87.5
221110,2015,12,1,0,13,100.0
221110,2016,5,0,3,8,62.5
221110,2017,4,0,2,6,66.66666666666666
221110,2018,8,0,5,13,61.53846153846154
221110,2019,4,0,7,11,36.36363636363637
221110,2020,2,0,10,12,16.666666666666664
221120,2012,2,0,1,3,66.66666666666666
221120,2013,7,0,3,10,70.0
221120,2014,7,0,5,12,58.333333333333336
221120,2015,4,0,6,10,40.0
221120,2016,2,0,3,5,40.0
221120,2017,8,0,0,8,100.0
221120,2018,10,0,0,10,100.0
221120,2019,9,0,0,9,100.0
221120,2020,8,0,0,8,100.0
221130,2012,8,0,0,8,100.0
221130,2013,9,0,0,9,100.0
221130,2014,2,0,0,2,100.0
221130,2015,6,0,1,7,85.71428571428571
221130,2016,6,0,0,6,100.0
221130,2017,8,0,0,8,100.0
221130,2018,9,0,0,9,100.0
221130,2019,10,0,0,10,100.0
221130,2020,10,0,1,11,90.9090909090909
221135,2012,1,0,0,1,100.0
221135,2014,1,0,0,1,100.0
221135,2016,2,0,0,2,100.0
221135,2017,1,0,1,2,50.0
221135,2018,3,0,0,3,100.0
221140,2012,0,0,1,1,0.0
221140,2013,0,0,2,2,0.0
221140,2014,3,0,0,3,100.0
221140,2015,1,0,1,2,50.0
221140,2016,2,0,0,2,100.0
221140,2017,1,0,1,2,50.0
221140,2018,1,0,1,2,50.0
221140,2019,1,0,0,1,100.0
221140,2020,3,0,0,3,100.0
221150,2012,1,0,0,1,100.0
221150,2013,1,0,0,1,100.0
221150,2014,4,0,0,4,100.0
221150,2015,1,0,0,1,100.0
221150,2017,1,0,0,1,100.0
221160,2012,1,0,0,1,100.0
221160,2013,1,0,0,1,100.0
221160,2014,2,0,0,2,100.0
221160,2015,2,0,0,2,100.0
221160,2017,2,0,0,2,100.0
221160,2020,1,0,0,1,100.0
221170,2012,1,0,0,1,100.0
221170,2013,0,0,2,2,0.0
221170,2014,0,0,2,2,0.0
221170,2015,0,0,1,1,0.0
221170,2016,1,0,1,2,50.0
221170,2017,0,0,2,2,0.0
221170,2018,1,0,1,2,50.0
221170,2019,0,0,1,1,0.0
221170,2020,0,0,1,1,0.0
230000,2015,1,0,0,1,100.0
230010,2012,1,0,0,1,100.0
230010,2013,2,0,0,2,100.0
230010,2014,1,0,0,1,100.0
230010,2015,2,0,0,2,100.0
230010,2016,1,1,0,2,100.0
230010,2017,1,1,0,2,100.0
230010,2018,3,0,0,3,100.0
230010,2019,5,0,0,5,100.0
230010,2020,2,0,0,2,100.0
230015,2012,0,2,1,3,66.66666666666666
230015,2013,2,2,1,5,80.0
230015,2014,2,0,2,4,50.0
230015,2015,4,1,1,6,83.33333333333334
230015,2016,2,0,0,2,100.0
230015,2017,3,0,0,3,100.0
230015,2018,3,0,0,3,100.0
230015,2019,5,0,0,5,100.0
230015,2020,7,0,0,7,100.0
230020,2012,10,0,0,10,100.0
230020,2013,15,0,1,16,93.75
230020,2014,14,0,0,14,100.0
230020,2015,25,0,0,25,100.0
230020,2016,22,0,0,22,100.0
230020,2017,20,0,0,20,100.0
230020,2018,22,0,0,22,100.0
230020,2019,18,0,0,18,100.0
230020,2020,29,0,0,29,100.0
230030,2012,11,0,0,11,100.0
230030,2013,23,0,0,23,100.0
230030,2014,17,0,0,17,100.0
230030,2015,9,0,0,9,100.0
230030,2016,10,1,0,11,100.0
230030,2017,14,0,0,14,100.0
230030,2018,13,0,0,13,100.0
230030,2019,12,0,0,12,100.0
230030,2020,12,0,1,13,92.3076923076923
230040,2012,1,0,0,1,100.0
230040,2013,3,0,0,3,100.0
230040,2014,5,0,0,5,100.0
230040,2015,5,0,1,6,83.33333333333334
230040,2016,2,0,0,2,100.0
230040,2017,2,0,0,2,100.0
230040,2018,4,0,0,4,100.0
230040,2019,3,0,0,3,100.0
230040,2020,2,0,0,2,100.0
230050,2012,1,0,0,1,100.0
230050,2013,1,0,0,1,100.0
230050,2014,2,0,1,3,66.66666666666666
230050,2015,4,0,1,5,80.0
230050,2016,1,0,0,1,100.0
230050,2017,1,0,0,1,100.0
230050,2018,6,0,0,6,100.0
230050,2019,3,0,0,3,100.0
230050,2020,1,0,0,1,100.0
230060,2012,4,0,0,4,100.0
230060,2013,0,0,1,1,0.0
230060,2014,1,0,0,1,100.0
230060,2015,2,0,0,2,100.0
230060,2016,3,0,0,3,100.0
230060,2018,3,0,0,3,100.0
230060,2019,3,0,0,3,100.0
230060,2020,2,0,0,2,100.0
230070,2012,5,0,0,5,100.0
230070,2013,5,0,0,5,100.0
230070,2014,1,0,0,1,100.0
230070,2015,4,0,0,4,100.0
230070,2016,2,0,0,2,100.0
230070,2017,3,0,0,3,100.0
230070,2018,5,0,0,5,100.0
230070,2019,3,0,0,3,100.0
230070,2020,5,0,0,5,100.0
230075,2012,10,0,0,10,100.0
230075,2013,10,0,0,10,100.0
230075,2014,11,0,0,11,100.0
230075,2015,6,0,0,6,100.0
230075,2016,10,0,0,10,100.0
230075,2017,7,0,0,7,100.0
230075,2018,10,0,0,10,100.0
230075,2019,15,0,0,15,100.0
230075,2020,10,0,0,10,100.0
230080,2012,2,0,0,2,100.0
230080,2013,2,0,0,2,100.0
230080,2015,2,0,0,2,100.0
230080,2016,5,0,0,5,100.0
230080,2017,1,0,0,1,100.0
230080,2018,1,0,0,1,100.0
230080,2019,3,0,0,3,100.0
230080,2020,6,0,0,6,100.0
230090,2012,1,2,0,3,100.0
230090,2013,4,1,0,5,100.0
230090,2014,4,0,0,4,100.0
230090,2015,2,0,0,2,100.0
230090,2016,4,0,0,4,100.0
230090,2017,5,0,0,5,100.0
230090,2018,2,0,0,2,100.0
230090,2019,6,0,0,6,100.0
230090,2020,5,0,0,5,100.0
230100,2012,22,0,0,22,100.0
230100,2013,32,0,0,32,100.0
230100,2014,22,0,1,23,95.65217391304348
230100,2015,27,0,0,27,100.0
230100,2016,23,0,0,23,100.0
230100,2017,26,0,0,26,100.0
230100,2018,23,0,0,23,100.0
230100,2019,30,0,0,30,100.0
230100,2020,31,0,1,32,96.875
230110,2012,24,0,0,24,100.0
230110,2013,24,0,0,24,100.0
230110,2014,17,0,0,17,100.0
230110,2015,17,0,0,17,100.0
230110,2016,23,0,0,23,100.0
230110,2017,17,0,0,17,100.0
230110,2018,22,0,0,22,100.0
230110,2019,21,0,0,21,100.0
230110,2020,23,0,0,23,100.0
230120,2012,7,1,0,8,100.0
230120,2013,8,0,0,8,100.0
230120,2014,5,0,0,5,100.0
230120,2015,8,0,0,8,100.0
230120,2016,8,1,0,9,100.0
230120,2017,3,0,0,3,100.0
230120,2018,3,0,0,3,100.0
230120,2019,7,0,0,7,100.0
230120,2020,6,0,0,6,100.0
230125,2012,2,0,1,3,66.66666666666666
230125,2013,1,0,3,4,25.0
230125,2015,1,0,4,5,20.0
230125,2016,1,0,0,1,100.0
230125,2017,4,0,0,4,100.0
230125,2018,2,0,0,2,100.0
230125,2019,4,0,0,4,100.0
230125,2020,3,0,0,3,100.0
230130,2012,8,0,0,8,100.0
230130,2013,8,0,0,8,100.0
230130,2014,9,0,0,9,100.0
230130,2015,5,0,0,5,100.0
230130,2016,9,1,0,10,100.0
230130,2017,3,0,0,3,100.0
230130,2018,9,0,0,9,100.0
230130,2019,9,0,0,9,100.0
230130,2020,9,0,0,9,100.0
230140,2012,0,2,0,2,100.0
230140,2013,1,1,1,3,66.66666666666666
230140,2014,0,0,1,1,0.0
230140,2015,2,1,2,5,60.0
230140,2017,0,0,2,2,0.0
230140,2018,6,0,0,6,100.0
230140,2020,9,0,0,9,100.0
230150,2013,0,0,1,1,0.0
230150,2014,0,0,1,1,0.0
230150,2015,2,0,3,5,40.0
230150,2016,5,0,0,5,100.0
230150,2017,3,0,0,3,100.0
230150,2018,4,0,0,4,100.0
230150,2019,3,0,0,3,100.0
230150,2020,2,0,0,2,100.0
230160,2012,7,0,0,7,100.0
230160,2013,3,0,0,3,100.0
230160,2014,9,0,0,9,100.0
230160,2015,4,0,0,4,100.0
230160,2016,8,0,0,8,100.0
230160,2017,8,0,0,8,100.0
230160,2018,6,0,0,6,100.0
230160,2019,5,0,0,5,100.0
230160,2020,5,0,0,5,100.0
230170,2012,9,0,0,9,100.0
230170,2013,5,0,0,5,100.0
230170,2014,5,0,0,5,100.0
230170,2015,3,0,0,3,100.0
230170,2016,6,0,0,6,100.0
230170,2017,5,0,0,5,100.0
230170,2018,7,0,0,7,100.0
230170,2019,3,0,0,3,100.0
230170,2020,9,0,1,10,90.0
230180,2012,2,0,0,2,100.0
230180,2013,3,0,0,3,100.0
230180,2014,1,0,0,1,100.0
230180,2016,1,0,0,1,100.0
230180,2017,1,0,0,1,100.0
230180,2018,1,0,0,1,100.0
230180,2019,3,0,0,3,100.0
230180,2020,3,0,0,3,100.0
230185,2013,3,0,0,3,100.0
230185,2014,1,0,3,4,25.0
230185,2015,1,1,1,3,66.66666666666666
230185,2016,2,0,0,2,100.0
230185,2017,3,0,0,3,100.0
230185,2018,6,0,0,6,100.0
230185,2019,6,0,0,6,100.0
230185,2020,5,0,0,5,100.0
230190,2012,20,0,0,20,100.0
230190,2013,14,0,0,14,100.0
230190,2014,18,0,0,18,100.0
230190,2015,19,1,3,23,86.95652173913044
230190,2016,10,4,13,27,51.85185185185185
230190,2017,27,0,0,27,100.0
230190,2018,31,0,0,31,100.0
230190,2019,11,0,0,11,100.0
230190,2020,5,5,10,20,50.0
230195,2012,5,0,0,5,100.0
230195,2013,8,0,0,8,100.0
230195,2014,9,0,0,9,100.0
230195,2015,8,0,0,8,100.0
230195,2016,8,0,0,8,100.0
230195,2017,6,0,0,6,100.0
230195,2018,5,1,0,6,100.0
230195,2019,6,0,0,6,100.0
230195,2020,12,0,0,12,100.0
230200,2012,7,1,0,8,100.0
230200,2013,5,0,0,5,100.0
230200,2014,9,0,0,9,100.0
230200,2015,4,0,0,4,100.0
230200,2016,8,0,0,8,100.0
230200,2017,6,0,0,6,100.0
230200,2018,6,0,0,6,100.0
230200,2019,9,0,0,9,100.0
230200,2020,6,0,0,6,100.0
230205,2012,1,0,0,1,100.0
230205,2013,8,0,0,8,100.0
230205,2014,5,0,0,5,100.0
230205,2015,3,0,0,3,100.0
230205,2016,1,0,0,1,100.0
230205,2017,4,0,0,4,100.0
230205,2018,3,0,0,3,100.0
230205,2019,5,0,0,5,100.0
230205,2020,3,0,0,3,100.0
230210,2012,5,0,0,5,100.0
230210,2013,9,0,0,9,100.0
230210,2014,10,0,0,10,100.0
230210,2015,12,0,0,12,100.0
230210,2016,8,0,0,8,100.0
230210,2017,11,0,0,11,100.0
230210,2018,9,0,0,9,100.0
230210,2019,7,0,0,7,100.0
230210,2020,16,0,1,17,94.11764705882352
230220,2012,14,0,0,14,100.0
230220,2013,10,0,0,10,100.0
230220,2014,12,0,0,12,100.0
230220,2015,15,0,0,15,100.0
230220,2016,10,0,0,10,100.0
230220,2017,4,0,0,4,100.0
230220,2018,13,0,0,13,100.0
230220,2019,11,0,0,11,100.0
230220,2020,7,0,0,7,100.0
230230,2012,11,0,0,11,100.0
230230,2013,6,0,0,6,100.0
230230,2014,5,0,0,5,100.0
230230,2015,10,0,0,10,100.0
230230,2016,9,0,0,9,100.0
230230,2017,3,0,0,3,100.0
230230,2018,8,0,0,8,100.0
230230,2019,9,0,0,9,100.0
230230,2020,10,0,0,10,100.0
230240,2012,12,0,0,12,100.0
230240,2013,15,0,0,15,100.0
230240,2014,20,0,0,20,100.0
230240,2015,19,0,0,19,100.0
230240,2016,19,0,0,19,100.0
230240,2017,21,0,0,21,100.0
230240,2018,13,0,0,13,100.0
230240,2019,11,0,0,11,100.0
230240,2020,17,0,2,19,89.47368421052632
230250,2012,16,0,0,16,100.0
230250,2013,18,0,0,18,100.0
230250,2014,13,0,0,13,100.0
230250,2015,15,0,0,15,100.0
230250,2016,19,0,0,19,100.0
230250,2017,18,0,0,18,100.0
230250,2018,8,0,0,8,100.0
230250,2019,7,2,2,11,81.81818181818183
230250,2020,16,0,0,16,100.0
230260,2012,20,0,0,20,100.0
230260,2013,19,0,0,19,100.0
230260,2014,20,0,0,20,100.0
230260,2015,16,0,0,16,100.0
230260,2016,21,0,0,21,100.0
230260,2017,19,0,0,19,100.0
230260,2018,21,0,0,21,100.0
230260,2019,18,0,0,18,100.0
230260,2020,21,0,0,21,100.0
230270,2012,12,0,0,12,100.0
230270,2013,12,0,0,12,100.0
230270,2014,6,0,0,6,100.0
230270,2015,9,0,0,9,100.0
230270,2016,8,0,0,8,100.0
230270,2017,11,0,0,11,100.0
230270,2018,8,0,0,8,100.0
230270,2019,7,0,0,7,100.0
230270,2020,10,0,0,10,100.0
230280,2012,21,0,0,21,100.0
230280,2013,28,0,0,28,100.0
230280,2014,17,0,0,17,100.0
230280,2015,22,0,0,22,100.0
230280,2016,16,0,0,16,100.0
230280,2017,14,0,0,14,100.0
230280,2018,23,0,0,23,100.0
230280,2019,22,0,0,22,100.0
230280,2020,31,0,2,33,93.93939393939394
230290,2012,8,0,0,8,100.0
230290,2013,8,0,1,9,88.88888888888889
230290,2014,6,0,0,6,100.0
230290,2015,2,0,0,2,100.0
230290,2016,1,0,0,1,100.0
230290,2017,5,0,0,5,100.0
230290,2018,8,0,0,8,100.0
230290,2019,4,0,0,4,100.0
230290,2020,3,0,0,3,100.0
230300,2012,3,0,0,3,100.0
230300,2013,9,0,0,9,100.0
230300,2014,4,0,0,4,100.0
230300,2015,3,0,0,3,100.0
230300,2016,5,0,0,5,100.0
230300,2017,2,0,0,2,100.0
230300,2018,12,0,0,12,100.0
230300,2019,4,0,0,4,100.0
230300,2020,5,0,3,8,62.5
230310,2012,3,0,0,3,100.0
230310,2013,4,0,0,4,100.0
230310,2014,5,0,0,5,100.0
230310,2015,5,0,0,5,100.0
230310,2016,4,0,0,4,100.0
230310,2017,2,0,0,2,100.0
230310,2018,5,0,0,5,100.0
230310,2019,3,0,0,3,100.0
230310,2020,7,0,0,7,100.0
230320,2012,6,1,1,8,87.5
230320,2013,6,2,1,9,88.88888888888889
230320,2014,6,0,0,6,100.0
230320,2015,13,0,0,13,100.0
230320,2016,5,0,0,5,100.0
230320,2017,10,0,0,10,100.0
230320,2018,14,0,0,14,100.0
230320,2019,6,0,0,6,100.0
230320,2020,15,0,0,15,100.0
230330,2012,3,0,0,3,100.0
230330,2013,5,0,0,5,100.0
230330,2014,1,0,0,1,100.0
230330,2015,2,0,0,2,100.0
230330,2016,4,0,0,4,100.0
230330,2017,10,0,0,10,100.0
230330,2018,5,0,0,5,100.0
230330,2019,5,0,0,5,100.0
230330,2020,2,0,0,2,100.0
230340,2012,3,0,0,3,100.0
230340,2013,8,0,0,8,100.0
230340,2014,4,0,0,4,100.0
230340,2015,6,0,0,6,100.0
230340,2016,7,0,0,7,100.0
230340,2017,5,0,0,5,100.0
230340,2018,3,0,0,3,100.0
230340,2019,7,0,0,7,100.0
230340,2020,6,0,0,6,100.0
230350,2012,18,0,0,18,100.0
230350,2013,24,0,0,24,100.0
230350,2014,24,0,0,24,100.0
230350,2015,28,0,0,28,100.0
230350,2016,13,0,0,13,100.0
230350,2017,17,0,0,17,100.0
230350,2018,24,0,0,24,100.0
230350,2019,13,0,0,13,100.0
230350,2020,26,0,0,26,100.0
230360,2012,3,0,0,3,100.0
230360,2013,1,0,0,1,100.0
230360,2014,2,0,0,2,100.0
230360,2015,1,0,0,1,100.0
230360,2016,3,0,0,3,100.0
230360,2017,3,0,0,3,100.0
230360,2018,5,0,0,5,100.0
230360,2019,3,0,0,3,100.0
230360,2020,4,0,0,4,100.0
230365,2012,3,0,0,3,100.0
230365,2013,5,0,0,5,100.0
230365,2014,5,0,0,5,100.0
230365,2015,3,0,0,3,100.0
230365,2016,5,0,0,5,100.0
230365,2017,3,0,0,3,100.0
230365,2018,1,0,0,1,100.0
230365,2019,4,0,0,4,100.0
230365,2020,2,0,0,2,100.0
230370,2012,83,3,7,93,92.47311827956989
230370,2013,107,1,2,110,98.18181818181819
230370,2014,96,0,0,96,100.0
230370,2015,119,0,0,119,100.0
230370,2016,122,0,0,122,100.0
230370,2017,113,0,0,113,100.0
230370,2018,143,0,1,144,99.30555555555556
230370,2019,102,0,0,102,100.0
230370,2020,139,0,0,139,100.0
230380,2012,7,0,0,7,100.0
230380,2013,9,0,0,9,100.0
230380,2014,4,0,0,4,100.0
230380,2015,8,0,0,8,100.0
230380,2016,5,0,0,5,100.0
230380,2017,10,0,0,10,100.0
230380,2018,10,0,0,10,100.0
230380,2019,8,0,0,8,100.0
230380,2020,10,0,0,10,100.0
230390,2012,2,0,0,2,100.0
230390,2013,6,0,0,6,100.0
230390,2014,2,0,0,2,100.0
230390,2015,5,0,0,5,100.0
230390,2016,3,0,2,5,60.0
230390,2017,4,0,0,4,100.0
230390,2018,6,0,0,6,100.0
230390,2019,5,0,0,5,100.0
230390,2020,2,0,0,2,100.0
230393,2012,4,1,1,6,83.33333333333334
230393,2013,3,0,0,3,100.0
230393,2014,5,0,0,5,100.0
230393,2015,2,0,1,3,66.66666666666666
230393,2016,1,0,0,1,100.0
230393,2017,1,0,0,1,100.0
230393,2018,5,0,0,5,100.0
230393,2019,4,0,0,4,100.0
230393,2020,4,0,0,4,100.0
230395,2012,8,0,0,8,100.0
230395,2013,9,1,1,11,90.9090909090909
230395,2014,4,0,1,5,80.0
230395,2015,7,0,0,7,100.0
230395,2016,8,0,0,8,100.0
230395,2017,8,0,0,8,100.0
230395,2018,6,0,0,6,100.0
230395,2019,8,0,0,8,100.0
230395,2020,8,0,0,8,100.0
230400,2012,7,0,0,7,100.0
230400,2013,3,0,0,3,100.0
230400,2014,8,0,2,10,80.0
230400,2015,2,1,2,5,60.0
230400,2016,7,0,0,7,100.0
230400,2017,5,0,0,5,100.0
230400,2018,4,0,0,4,100.0
230400,2019,11,0,0,11,100.0
230400,2020,6,0,0,6,100.0
230410,2012,26,0,0,26,100.0
230410,2013,28,0,0,28,100.0
230410,2014,25,0,0,25,100.0
230410,2015,23,0,0,23,100.0
230410,2016,28,0,0,28,100.0
230410,2017,34,0,0,34,100.0
230410,2018,30,0,0,30,100.0
230410,2019,26,0,0,26,100.0
230410,2020,27,0,0,27,100.0
230420,2012,41,1,0,42,100.0
230420,2013,37,0,0,37,100.0
230420,2014,51,0,0,51,100.0
230420,2015,44,0,0,44,100.0
230420,2016,43,0,0,43,100.0
230420,2017,33,0,0,33,100.0
230420,2018,34,0,0,34,100.0
230420,2019,52,0,0,52,100.0
230420,2020,38,0,0,38,100.0
230423,2012,3,0,0,3,100.0
230423,2013,4,0,0,4,100.0
230423,2014,6,0,1,7,85.71428571428571
230423,2015,2,0,0,2,100.0
230423,2016,4,0,0,4,100.0
230423,2017,8,0,0,8,100.0
230423,2018,7,0,0,7,100.0
230423,2019,9,0,0,9,100.0
230423,2020,7,0,1,8,87.5
230425,2012,7,0,0,7,100.0
230425,2013,8,0,0,8,100.0
230425,2014,8,0,0,8,100.0
230425,2015,9,0,0,9,100.0
230425,2016,5,0,0,5,100.0
230425,2017,13,0,0,13,100.0
230425,2018,7,0,0,7,100.0
230425,2019,9,0,0,9,100.0
230425,2020,11,0,0,11,100.0
230426,2012,5,0,0,5,100.0
230426,2013,1,0,0,1,100.0
230426,2014,2,0,0,2,100.0
230426,2015,2,0,0,2,100.0
230426,2016,2,0,0,2,100.0
230426,2017,1,0,0,1,100.0
230426,2018,4,0,0,4,100.0
230426,2019,4,0,0,4,100.0
230426,2020,5,0,0,5,100.0
230427,2012,2,0,0,2,100.0
230427,2013,1,0,0,1,100.0
230427,2015,1,0,0,1,100.0
230427,2016,1,0,0,1,100.0
230427,2017,1,0,0,1,100.0
230427,2018,2,0,0,2,100.0
230427,2019,4,0,0,4,100.0
230427,2020,4,0,0,4,100.0
230428,2012,6,0,0,6,100.0
230428,2013,18,1,3,22,86.36363636363636
230428,2014,24,0,0,24,100.0
230428,2015,14,0,0,14,100.0
230428,2016,16,0,0,16,100.0
230428,2017,26,0,0,26,100.0
230428,2018,24,0,0,24,100.0
230428,2019,19,0,0,19,100.0
230428,2020,20,0,0,20,100.0
230430,2012,5,0,0,5,100.0
230430,2013,9,0,0,9,100.0
230430,2014,4,0,0,4,100.0
230430,2015,7,0,0,7,100.0
230430,2016,7,0,0,7,100.0
230430,2017,4,0,0,4,100.0
230430,2018,4,0,0,4,100.0
230430,2019,8,0,0,8,100.0
230430,2020,8,0,0,8,100.0
230435,2012,5,0,0,5,100.0
230435,2013,7,0,0,7,100.0
230435,2014,6,0,1,7,85.71428571428571
230435,2015,7,0,0,7,100.0
230435,2016,4,1,0,5,100.0
230435,2017,14,0,0,14,100.0
230435,2018,9,0,0,9,100.0
230435,2019,9,0,0,9,100.0
230435,2020,9,0,0,9,100.0
230440,2012,797,54,39,890,95.6179775280899
230440,2013,723,73,77,873,91.17983963344788
230440,2014,701,66,38,805,95.27950310559005
230440,2015,839,10,7,856,99.1822429906542
230440,2016,738,34,28,800,96.5
230440,2017,834,9,3,846,99.64539007092199
230440,2018,860,1,0,861,100.0
230440,2019,739,7,1,747,99.8661311914324
230440,2020,979,1,25,1005,97.51243781094527
230445,2013,4,0,0,4,100.0
230445,2014,3,0,0,3,100.0
230445,2015,2,0,0,2,100.0
230445,2016,5,0,0,5,100.0
230445,2017,1,0,0,1,100.0
230445,2018,1,0,0,1,100.0
230445,2019,3,0,0,3,100.0
230445,2020,5,0,0,5,100.0
230450,2012,3,0,1,4,75.0
230450,2013,7,0,0,7,100.0
230450,2014,7,0,0,7,100.0
230450,2015,6,0,0,6,100.0
230450,2016,5,0,0,5,100.0
230450,2017,5,0,0,5,100.0
230450,2018,1,0,0,1,100.0
230450,2019,1,0,0,1,100.0
230450,2020,7,0,0,7,100.0
230460,2013,2,0,0,2,100.0
230460,2017,3,0,0,3,100.0
230460,2018,2,0,0,2,100.0
230460,2019,2,0,0,2,100.0
230460,2020,1,0,0,1,100.0
230465,2012,2,1,1,4,75.0
230465,2013,0,3,2,5,60.0
230465,2014,2,0,0,2,100.0
230465,2015,3,3,0,6,100.0
230465,2016,2,0,0,2,100.0
230465,2017,2,0,0,2,100.0
230465,2018,2,0,0,2,100.0
230465,2019,5,0,0,5,100.0
230465,2020,5,0,0,5,100.0
230470,2012,3,4,2,9,77.77777777777779
230470,2013,11,0,0,11,100.0
230470,2014,15,0,0,15,100.0
230470,2015,11,0,0,11,100.0
230470,2016,17,0,0,17,100.0
230470,2017,11,1,0,12,100.0
230470,2018,15,0,0,15,100.0
230470,2019,22,0,0,22,100.0
230470,2020,17,0,0,17,100.0
230480,2013,1,0,0,1,100.0
230480,2014,2,0,0,2,100.0
230480,2016,0,1,0,1,100.0
230480,2017,1,0,0,1,100.0
230480,2018,2,0,0,2,100.0
230480,2020,4,0,0,4,100.0
230490,2012,1,0,0,1,100.0
230490,2013,3,0,0,3,100.0
230490,2014,2,0,0,2,100.0
230490,2015,4,0,0,4,100.0
230490,2016,4,1,0,5,100.0
230490,2017,3,0,0,3,100.0
230490,2018,1,0,0,1,100.0
230490,2019,6,0,0,6,100.0
230490,2020,1,0,0,1,100.0
230495,2012,9,0,0,9,100.0
230495,2013,0,4,4,8,50.0
230495,2014,4,1,1,6,83.33333333333334
230495,2015,1,4,2,7,71.42857142857143
230495,2016,8,0,0,8,100.0
230495,2017,3,0,0,3,100.0
230495,2018,9,0,1,10,90.0
230495,2019,10,0,0,10,100.0
230495,2020,9,0,1,10,90.0
230500,2012,12,0,0,12,100.0
230500,2013,9,0,0,9,100.0
230500,2014,10,0,0,10,100.0
230500,2015,12,0,0,12,100.0
230500,2016,5,0,0,5,100.0
230500,2017,12,0,0,12,100.0
230500,2018,9,0,0,9,100.0
230500,2019,13,0,0,13,100.0
230500,2020,12,0,0,12,100.0
230510,2012,1,0,0,1,100.0
230510,2013,2,0,0,2,100.0
230510,2014,2,0,0,2,100.0
230510,2015,1,0,0,1,100.0
230510,2016,3,0,0,3,100.0
230510,2017,2,0,0,2,100.0
230510,2019,1,0,0,1,100.0
230510,2020,1,0,0,1,100.0
230520,2012,7,0,0,7,100.0
230520,2013,9,0,0,9,100.0
230520,2014,9,0,0,9,100.0
230520,2015,10,0,0,10,100.0
230520,2016,6,0,0,6,100.0
230520,2017,8,0,0,8,100.0
230520,2018,6,0,0,6,100.0
230520,2019,3,0,0,3,100.0
230520,2020,6,0,0,6,100.0
230523,2012,22,0,0,22,100.0
230523,2013,21,0,0,21,100.0
230523,2014,17,0,2,19,89.47368421052632
230523,2015,19,0,0,19,100.0
230523,2016,20,0,0,20,100.0
230523,2017,22,0,0,22,100.0
230523,2018,24,0,0,24,100.0
230523,2019,14,0,0,14,100.0
230523,2020,30,0,1,31,96.7741935483871
230526,2012,5,0,0,5,100.0
230526,2013,2,0,0,2,100.0
230526,2014,5,0,0,5,100.0
230526,2015,4,1,0,5,100.0
230526,2016,6,1,0,7,100.0
230526,2017,6,0,0,6,100.0
230526,2018,3,0,0,3,100.0
230526,2019,2,0,0,2,100.0
230526,2020,1,0,1,2,50.0
230530,2012,4,0,0,4,100.0
230530,2013,6,0,0,6,100.0
230530,2014,6,0,0,6,100.0
230530,2015,4,0,0,4,100.0
230530,2016,6,0,0,6,100.0
230530,2017,7,0,0,7,100.0
230530,2018,6,0,0,6,100.0
230530,2019,9,0,0,9,100.0
230530,2020,9,0,0,9,100.0
230533,2012,3,0,0,3,100.0
230533,2013,6,0,0,6,100.0
230533,2014,2,0,0,2,100.0
230533,2015,4,0,1,5,80.0
230533,2016,7,0,0,7,100.0
230533,2017,2,0,0,2,100.0
230533,2018,1,0,0,1,100.0
230533,2019,3,0,0,3,100.0
230533,2020,2,0,0,2,100.0
230535,2012,8,0,0,8,100.0
230535,2013,6,1,0,7,100.0
230535,2014,8,0,0,8,100.0
230535,2015,8,0,0,8,100.0
230535,2016,9,0,0,9,100.0
230535,2017,7,0,0,7,100.0
230535,2018,3,0,0,3,100.0
230535,2019,8,0,0,8,100.0
230535,2020,4,0,0,4,100.0
230540,2012,18,1,0,19,100.0
230540,2013,21,0,0,21,100.0
230540,2014,14,0,0,14,100.0
230540,2015,16,0,0,16,100.0
230540,2016,28,0,0,28,100.0
230540,2017,22,0,0,22,100.0
230540,2018,16,0,0,16,100.0
230540,2019,20,0,0,20,100.0
230540,2020,22,0,0,22,100.0
230550,2012,35,0,0,35,100.0
230550,2013,38,0,0,38,100.0
230550,2014,23,0,0,23,100.0
230550,2015,26,0,0,26,100.0
230550,2016,38,0,0,38,100.0
230550,2017,28,0,0,28,100.0
230550,2018,40,0,0,40,100.0
230550,2019,34,0,0,34,100.0
230550,2020,30,0,1,31,96.7741935483871
230560,2012,5,0,0,5,100.0
230560,2013,4,1,0,5,100.0
230560,2014,8,0,0,8,100.0
230560,2015,11,0,0,11,100.0
230560,2016,9,0,0,9,100.0
230560,2017,6,0,0,6,100.0
230560,2018,4,0,0,4,100.0
230560,2019,6,0,0,6,100.0
230560,2020,12,0,1,13,92.3076923076923
230565,2012,2,1,0,3,100.0
230565,2013,0,2,0,2,100.0
230565,2014,2,0,0,2,100.0
230565,2015,1,0,0,1,100.0
230565,2016,3,0,0,3,100.0
230565,2017,5,0,0,5,100.0
230565,2018,2,0,0,2,100.0
230565,2019,4,0,0,4,100.0
230565,2020,3,0,0,3,100.0
230570,2012,7,0,0,7,100.0
230570,2013,5,0,1,6,83.33333333333334
230570,2014,1,0,0,1,100.0
230570,2015,2,0,0,2,100.0
230570,2016,3,0,0,3,100.0
230570,2017,1,0,0,1,100.0
230570,2018,4,0,0,4,100.0
230570,2019,2,0,0,2,100.0
230570,2020,2,0,0,2,100.0
230580,2012,17,0,0,17,100.0
230580,2013,19,0,0,19,100.0
230580,2014,6,0,0,6,100.0
230580,2015,6,0,0,6,100.0
230580,2016,18,0,0,18,100.0
230580,2017,8,0,0,8,100.0
230580,2018,14,0,0,14,100.0
230580,2019,9,0,0,9,100.0
230580,2020,7,0,0,7,100.0
230590,2012,12,0,0,12,100.0
230590,2013,20,1,0,21,100.0
230590,2014,10,0,0,10,100.0
230590,2015,9,0,0,9,100.0
230590,2016,11,0,0,11,100.0
230590,2017,8,0,0,8,100.0
230590,2018,10,0,0,10,100.0
230590,2019,9,0,0,9,100.0
230590,2020,12,0,0,12,100.0
230600,2012,5,0,0,5,100.0
230600,2013,9,0,1,10,90.0
230600,2014,4,0,0,4,100.0
230600,2015,6,0,0,6,100.0
230600,2016,2,0,0,2,100.0
230600,2017,4,0,0,4,100.0
230600,2019,5,0,0,5,100.0
230600,2020,2,0,0,2,100.0
230610,2012,4,0,0,4,100.0
230610,2013,5,0,0,5,100.0
230610,2014,3,0,1,4,75.0
230610,2015,7,0,0,7,100.0
230610,2016,15,0,0,15,100.0
230610,2017,6,0,0,6,100.0
230610,2018,3,0,0,3,100.0
230610,2019,9,0,0,9,100.0
230610,2020,9,0,0,9,100.0
230620,2012,4,0,0,4,100.0
230620,2013,2,0,0,2,100.0
230620,2014,2,0,0,2,100.0
230620,2015,4,0,0,4,100.0
230620,2016,2,0,0,2,100.0
230620,2017,1,0,0,1,100.0
230620,2018,1,0,0,1,100.0
230620,2019,2,0,0,2,100.0
230620,2020,1,0,0,1,100.0
230625,2012,10,0,0,10,100.0
230625,2013,15,0,0,15,100.0
230625,2014,12,0,0,12,100.0
230625,2015,6,0,0,6,100.0
230625,2016,17,0,0,17,100.0
230625,2017,13,0,0,13,100.0
230625,2018,10,0,0,10,100.0
230625,2019,10,0,0,10,100.0
230625,2020,15,0,0,15,100.0
230630,2012,19,0,0,19,100.0
230630,2013,16,0,0,16,100.0
230630,2014,15,0,0,15,100.0
230630,2015,16,0,0,16,100.0
230630,2016,11,0,0,11,100.0
230630,2017,15,0,0,15,100.0
230630,2018,10,0,0,10,100.0
230630,2019,11,0,0,11,100.0
230630,2020,18,0,0,18,100.0
230640,2012,34,0,0,34,100.0
230640,2013,33,0,0,33,100.0
230640,2014,26,0,0,26,100.0
230640,2015,40,0,0,40,100.0
230640,2016,33,0,0,33,100.0
230640,2017,29,0,0,29,100.0
230640,2018,39,0,0,39,100.0
230640,2019,28,0,0,28,100.0
230640,2020,40,0,0,40,100.0
230650,2012,5,0,0,5,100.0
230650,2013,3,0,0,3,100.0
230650,2014,5,0,0,5,100.0
230650,2015,9,0,0,9,100.0
230650,2016,3,0,0,3,100.0
230650,2017,8,0,0,8,100.0
230650,2018,10,0,0,10,100.0
230650,2019,3,0,0,3,100.0
230650,2020,5,0,0,5,100.0
230655,2012,3,0,0,3,100.0
230655,2013,7,0,0,7,100.0
230655,2014,10,0,0,10,100.0
230655,2015,11,0,0,11,100.0
230655,2016,10,0,0,10,100.0
230655,2017,13,0,0,13,100.0
230655,2018,19,0,0,19,100.0
230655,2019,8,0,0,8,100.0
230655,2020,17,0,0,17,100.0
230660,2012,9,0,0,9,100.0
230660,2013,4,0,0,4,100.0
230660,2014,4,0,0,4,100.0
230660,2015,4,0,0,4,100.0
230660,2016,9,0,0,9,100.0
230660,2017,4,0,0,4,100.0
230660,2018,5,0,0,5,100.0
230660,2019,5,0,0,5,100.0
230660,2020,2,0,0,2,100.0
230670,2012,7,0,0,7,100.0
230670,2013,5,0,0,5,100.0
230670,2014,8,0,0,8,100.0
230670,2015,3,0,0,3,100.0
230670,2016,8,0,0,8,100.0
230670,2017,9,0,0,9,100.0
230670,2018,2,0,0,2,100.0
230670,2019,3,0,0,3,100.0
230670,2020,4,0,0,4,100.0
230680,2012,4,0,0,4,100.0
230680,2013,3,0,0,3,100.0
230680,2014,4,0,0,4,100.0
230680,2015,1,0,0,1,100.0
230680,2016,5,0,0,5,100.0
230680,2017,5,0,0,5,100.0
230680,2018,2,0,0,2,100.0
230680,2019,2,0,0,2,100.0
230680,2020,4,0,1,5,80.0
230690,2012,12,0,0,12,100.0
230690,2013,6,1,0,7,100.0
230690,2014,13,0,0,13,100.0
230690,2015,12,0,0,12,100.0
230690,2016,12,0,0,12,100.0
230690,2017,7,0,0,7,100.0
230690,2018,10,0,0,10,100.0
230690,2019,5,0,0,5,100.0
230690,2020,7,0,0,7,100.0
230700,2012,6,0,0,6,100.0
230700,2013,13,0,0,13,100.0
230700,2014,6,0,0,6,100.0
230700,2015,15,0,0,15,100.0
230700,2016,5,0,0,5,100.0
230700,2017,9,0,0,9,100.0
230700,2018,8,0,0,8,100.0
230700,2019,10,0,0,10,100.0
230700,2020,7,0,0,7,100.0
230710,2012,10,0,0,10,100.0
230710,2013,12,0,0,12,100.0
230710,2014,9,0,0,9,100.0
230710,2015,5,0,0,5,100.0
230710,2016,3,0,0,3,100.0
230710,2017,6,0,0,6,100.0
230710,2018,6,0,0,6,100.0
230710,2019,10,0,0,10,100.0
230710,2020,8,0,0,8,100.0
230720,2013,3,0,0,3,100.0
230720,2014,3,0,0,3,100.0
230720,2015,2,0,0,2,100.0
230720,2016,3,0,0,3,100.0
230720,2017,1,0,0,1,100.0
230720,2018,3,0,0,3,100.0
230720,2019,1,0,0,1,100.0
230720,2020,2,0,0,2,100.0
230725,2012,7,0,1,8,87.5
230725,2013,7,0,0,7,100.0
230725,2014,4,0,0,4,100.0
230725,2015,5,0,0,5,100.0
230725,2016,6,0,0,6,100.0
230725,2017,4,0,0,4,100.0
230725,2018,7,0,0,7,100.0
230725,2019,4,0,0,4,100.0
230725,2020,6,0,0,6,100.0
230730,2012,66,19,21,106,80.18867924528303
230730,2013,24,19,44,87,49.42528735632184
230730,2014,53,16,21,90,76.66666666666667
230730,2015,94,0,0,94,100.0
230730,2016,100,1,0,101,100.0
230730,2017,77,0,0,77,100.0
230730,2018,80,0,0,80,100.0
230730,2019,91,0,0,91,100.0
230730,2020,103,0,1,104,99.03846153846155
230740,2012,10,0,0,10,100.0
230740,2013,5,0,0,5,100.0
230740,2014,4,0,0,4,100.0
230740,2015,10,0,0,10,100.0
230740,2016,6,0,0,6,100.0
230740,2017,4,0,0,4,100.0
230740,2018,9,0,0,9,100.0
230740,2019,3,0,0,3,100.0
230740,2020,14,0,0,14,100.0
230750,2012,8,0,0,8,100.0
230750,2013,9,0,0,9,100.0
230750,2014,7,0,0,7,100.0
230750,2015,6,0,0,6,100.0
230750,2016,6,0,0,6,100.0
230750,2017,7,0,0,7,100.0
230750,2018,7,0,0,7,100.0
230750,2019,3,0,0,3,100.0
230750,2020,10,0,0,10,100.0
230760,2012,19,0,0,19,100.0
230760,2013,17,0,0,17,100.0
230760,2014,20,1,0,21,100.0
230760,2015,22,0,0,22,100.0
230760,2016,18,0,0,18,100.0
230760,2017,20,0,0,20,100.0
230760,2018,14,0,0,14,100.0
230760,2019,21,0,0,21,100.0
230760,2020,12,0,0,12,100.0
230763,2012,4,0,0,4,100.0
230763,2013,5,0,0,5,100.0
230763,2014,5,0,0,5,100.0
230763,2015,9,0,0,9,100.0
230763,2016,3,0,0,3,100.0
230763,2017,4,0,0,4,100.0
230763,2018,3,0,0,3,100.0
230763,2019,5,1,0,6,100.0
230763,2020,8,0,0,8,100.0
230765,2012,61,3,5,69,92.7536231884058
230765,2013,69,7,5,81,93.82716049382715
230765,2014,66,6,7,79,91.13924050632912
230765,2015,70,0,0,70,100.0
230765,2016,63,4,1,68,98.52941176470588
230765,2017,83,2,3,88,96.5909090909091
230765,2018,98,5,0,103,100.0
230765,2019,72,2,1,75,98.66666666666667
230765,2020,87,0,2,89,97.75280898876404
230770,2012,25,0,0,25,100.0
230770,2013,35,0,0,35,100.0
230770,2014,31,0,1,32,96.875
230770,2015,32,0,0,32,100.0
230770,2016,33,0,0,33,100.0
230770,2017,33,0,0,33,100.0
230770,2018,41,0,0,41,100.0
230770,2019,41,0,0,41,100.0
230770,2020,57,0,0,57,100.0
230780,2012,5,0,0,5,100.0
230780,2013,8,0,0,8,100.0
230780,2014,9,0,0,9,100.0
230780,2015,7,0,0,7,100.0
230780,2016,4,0,0,4,100.0
230780,2017,6,0,0,6,100.0
230780,2018,11,0,0,11,100.0
230780,2019,7,0,0,7,100.0
230780,2020,5,0,0,5,100.0
230790,2012,2,0,0,2,100.0
230790,2013,5,0,0,5,100.0
230790,2014,1,0,0,1,100.0
230790,2015,5,0,0,5,100.0
230790,2016,7,0,0,7,100.0
230790,2017,5,0,0,5,100.0
230790,2018,2,0,0,2,100.0
230790,2019,4,0,0,4,100.0
230790,2020,1,0,0,1,100.0
230800,2012,14,0,0,14,100.0
230800,2013,8,0,4,12,66.66666666666666
230800,2014,7,0,0,7,100.0
230800,2015,12,0,0,12,100.0
230800,2016,13,0,0,13,100.0
230800,2017,5,0,0,5,100.0
230800,2018,19,0,0,19,100.0
230800,2019,11,0,0,11,100.0
230800,2020,15,0,0,15,100.0
230810,2012,3,0,0,3,100.0
230810,2013,15,0,0,15,100.0
230810,2014,6,0,0,6,100.0
230810,2015,6,0,0,6,100.0
230810,2016,12,0,0,12,100.0
230810,2017,9,0,0,9,100.0
230810,2018,13,0,0,13,100.0
230810,2019,7,0,0,7,100.0
230810,2020,16,1,0,17,100.0
230820,2012,2,0,0,2,100.0
230820,2013,3,0,0,3,100.0
230820,2014,4,0,0,4,100.0
230820,2015,1,0,0,1,100.0
230820,2016,1,0,0,1,100.0
230820,2017,4,0,0,4,100.0
230820,2018,4,0,0,4,100.0
230820,2019,3,0,0,3,100.0
230820,2020,8,0,0,8,100.0
230830,2012,9,0,0,9,100.0
230830,2013,5,0,0,5,100.0
230830,2014,9,0,0,9,100.0
230830,2015,13,0,0,13,100.0
230830,2016,13,0,0,13,100.0
230830,2017,3,0,0,3,100.0
230830,2018,10,0,0,10,100.0
230830,2019,12,0,0,12,100.0
230830,2020,10,0,0,10,100.0
230835,2012,8,0,0,8,100.0
230835,2013,4,0,0,4,100.0
230835,2014,6,0,0,6,100.0
230835,2015,5,0,1,6,83.33333333333334
230835,2016,8,0,0,8,100.0
230835,2017,7,0,0,7,100.0
230835,2018,4,0,0,4,100.0
230835,2019,4,0,0,4,100.0
230835,2020,3,0,0,3,100.0
230837,2012,3,0,0,3,100.0
230837,2014,3,0,0,3,100.0
230837,2015,1,0,0,1,100.0
230837,2016,1,0,0,1,100.0
230837,2017,3,0,0,3,100.0
230837,2018,4,0,0,4,100.0
230837,2019,4,0,0,4,100.0
230837,2020,4,0,0,4,100.0
230840,2012,10,0,0,10,100.0
230840,2013,14,0,0,14,100.0
230840,2014,7,0,0,7,100.0
230840,2015,7,0,0,7,100.0
230840,2016,13,0,0,13,100.0
230840,2017,6,0,0,6,100.0
230840,2018,10,0,0,10,100.0
230840,2019,11,0,0,11,100.0
230840,2020,7,0,0,7,100.0
230850,2012,11,0,0,11,100.0
230850,2013,10,0,0,10,100.0
230850,2014,6,0,0,6,100.0
230850,2015,9,0,0,9,100.0
230850,2016,9,0,0,9,100.0
230850,2017,12,0,0,12,100.0
230850,2018,8,0,0,8,100.0
230850,2019,11,0,0,11,100.0
230850,2020,10,0,0,10,100.0
230860,2012,9,0,0,9,100.0
230860,2013,3,0,0,3,100.0
230860,2014,7,0,0,7,100.0
230860,2015,8,0,0,8,100.0
230860,2016,3,0,0,3,100.0
230860,2017,4,0,0,4,100.0
230860,2018,7,0,0,7,100.0
230860,2019,4,0,0,4,100.0
230860,2020,3,0,0,3,100.0
230870,2012,20,0,0,20,100.0
230870,2013,18,0,0,18,100.0
230870,2014,21,0,1,22,95.45454545454545
230870,2015,18,0,1,19,94.73684210526315
230870,2016,16,0,0,16,100.0
230870,2017,23,0,0,23,100.0
230870,2018,31,0,0,31,100.0
230870,2019,15,0,0,15,100.0
230870,2020,33,0,0,33,100.0
230880,2012,1,0,0,1,100.0
230880,2013,1,0,0,1,100.0
230880,2014,2,0,2,4,50.0
230880,2015,0,1,1,2,50.0
230880,2016,0,0,1,1,0.0
230880,2017,2,0,0,2,100.0
230880,2018,3,0,1,4,75.0
230880,2020,1,1,1,3,66.66666666666666
230890,2012,9,0,0,9,100.0
230890,2013,3,0,0,3,100.0
230890,2014,6,0,0,6,100.0
230890,2015,8,0,0,8,100.0
230890,2016,4,0,0,4,100.0
230890,2017,6,0,0,6,100.0
230890,2018,12,0,0,12,100.0
230890,2019,7,0,0,7,100.0
230890,2020,12,0,0,12,100.0
230900,2012,3,0,0,3,100.0
230900,2013,3,0,0,3,100.0
230900,2014,3,0,0,3,100.0
230900,2015,6,0,0,6,100.0
230900,2016,3,0,0,3,100.0
230900,2017,4,0,0,4,100.0
230900,2018,6,0,0,6,100.0
230900,2020,5,0,0,5,100.0
230910,2012,1,0,0,1,100.0
230910,2013,1,0,0,1,100.0
230910,2014,1,0,0,1,100.0
230910,2015,1,0,0,1,100.0
230910,2016,1,0,0,1,100.0
230910,2017,1,0,0,1,100.0
230910,2018,3,0,0,3,100.0
230910,2019,1,0,0,1,100.0
230910,2020,3,0,0,3,100.0
230920,2012,4,0,0,4,100.0
230920,2013,2,0,0,2,100.0
230920,2014,7,0,0,7,100.0
230920,2015,4,0,0,4,100.0
230920,2016,2,0,0,2,100.0
230920,2017,0,1,0,1,100.0
230920,2018,6,0,0,6,100.0
230920,2019,9,0,0,9,100.0
230920,2020,3,0,0,3,100.0
230930,2012,8,0,0,8,100.0
230930,2013,8,0,0,8,100.0
230930,2014,11,0,1,12,91.66666666666666
230930,2015,13,1,0,14,100.0
230930,2016,3,0,0,3,100.0
230930,2017,5,0,0,5,100.0
230930,2018,7,0,0,7,100.0
230930,2019,7,0,0,7,100.0
230930,2020,17,0,0,17,100.0
230940,2012,8,0,0,8,100.0
230940,2013,14,0,0,14,100.0
230940,2014,10,0,0,10,100.0
230940,2015,13,0,0,13,100.0
230940,2016,8,0,0,8,100.0
230940,2017,12,0,0,12,100.0
230940,2018,10,0,0,10,100.0
230940,2019,10,0,0,10,100.0
230940,2020,11,0,0,11,100.0
230945,2012,7,0,0,7,100.0
230945,2013,5,0,0,5,100.0
230945,2014,5,0,0,5,100.0
230945,2015,8,0,0,8,100.0
230945,2016,5,0,0,5,100.0
230945,2017,7,0,0,7,100.0
230945,2018,9,0,0,9,100.0
230945,2019,8,0,0,8,100.0
230945,2020,5,0,0,5,100.0
230950,2012,7,0,0,7,100.0
230950,2013,8,0,0,8,100.0
230950,2014,5,0,0,5,100.0
230950,2015,4,0,0,4,100.0
230950,2016,13,0,0,13,100.0
230950,2017,6,0,0,6,100.0
230950,2018,9,0,0,9,100.0
230950,2019,8,0,0,8,100.0
230950,2020,8,0,0,8,100.0
230960,2012,19,1,0,20,100.0
230960,2013,12,0,0,12,100.0
230960,2014,18,1,3,22,86.36363636363636
230960,2015,27,0,1,28,96.42857142857143
230960,2016,1,10,12,23,47.82608695652174
230960,2017,20,3,1,24,95.83333333333334
230960,2018,33,0,0,33,100.0
230960,2019,22,0,0,22,100.0
230960,2020,29,0,0,29,100.0
230970,2012,16,0,0,16,100.0
230970,2013,20,0,0,20,100.0
230970,2014,13,0,0,13,100.0
230970,2015,15,0,0,15,100.0
230970,2016,24,0,0,24,100.0
230970,2017,24,0,0,24,100.0
230970,2018,27,0,0,27,100.0
230970,2019,18,0,0,18,100.0
230970,2020,34,0,0,34,100.0
230980,2012,1,0,0,1,100.0
230980,2013,2,0,0,2,100.0
230980,2014,4,0,0,4,100.0
230980,2015,1,0,0,1,100.0
230980,2016,2,0,0,2,100.0
230980,2017,3,0,0,3,100.0
230980,2018,2,0,0,2,100.0
230980,2019,4,0,0,4,100.0
230980,2020,3,0,0,3,100.0
230990,2012,1,0,0,1,100.0
230990,2013,0,0,2,2,0.0
230990,2014,2,0,0,2,100.0
230990,2015,0,0,1,1,0.0
230990,2016,3,0,2,5,60.0
230990,2017,1,0,0,1,100.0
230990,2018,1,0,0,1,100.0
230990,2019,3,0,0,3,100.0
230990,2020,1,0,0,1,100.0
231000,2012,2,0,0,2,100.0
231000,2013,3,0,0,3,100.0
231000,2014,3,0,0,3,100.0
231000,2015,4,0,0,4,100.0
231000,2016,1,0,0,1,100.0
231000,2017,4,0,0,4,100.0
231000,2018,4,0,0,4,100.0
231000,2019,6,0,0,6,100.0
231010,2012,5,0,0,5,100.0
231010,2013,2,0,1,3,66.66666666666666
231010,2014,1,0,0,1,100.0
231010,2015,8,0,0,8,100.0
231010,2016,1,0,0,1,100.0
231010,2017,5,0,0,5,100.0
231010,2018,4,0,0,4,100.0
231010,2019,2,0,0,2,100.0
231010,2020,2,0,0,2,100.0
231020,2012,15,0,0,15,100.0
231020,2013,13,0,0,13,100.0
231020,2014,11,0,0,11,100.0
231020,2015,5,0,0,5,100.0
231020,2016,11,0,0,11,100.0
231020,2017,8,0,0,8,100.0
231020,2018,14,0,0,14,100.0
231020,2019,7,0,0,7,100.0
231020,2020,13,0,0,13,100.0
231025,2012,14,1,0,15,100.0
231025,2013,8,0,0,8,100.0
231025,2014,4,0,0,4,100.0
231025,2015,10,0,0,10,100.0
231025,2016,9,0,0,9,100.0
231025,2017,9,0,0,9,100.0
231025,2018,8,0,0,8,100.0
231025,2019,11,0,0,11,100.0
231025,2020,6,0,0,6,100.0
231030,2012,12,1,0,13,100.0
231030,2013,12,0,0,12,100.0
231030,2014,12,0,1,13,92.3076923076923
231030,2015,10,0,0,10,100.0
231030,2016,10,0,0,10,100.0
231030,2017,17,0,0,17,100.0
231030,2018,5,0,0,5,100.0
231030,2019,10,0,0,10,100.0
231030,2020,12,0,0,12,100.0
231040,2012,5,0,0,5,100.0
231040,2013,2,0,0,2,100.0
231040,2014,1,0,0,1,100.0
231040,2015,4,0,0,4,100.0
231040,2016,3,3,0,6,100.0
231040,2017,1,0,0,1,100.0
231040,2018,1,0,0,1,100.0
231040,2019,1,0,0,1,100.0
231040,2020,1,0,1,2,50.0
231050,2012,12,0,0,12,100.0
231050,2013,12,0,0,12,100.0
231050,2014,9,0,0,9,100.0
231050,2015,11,0,0,11,100.0
231050,2016,14,0,0,14,100.0
231050,2017,10,0,0,10,100.0
231050,2018,10,0,0,10,100.0
231050,2019,13,0,0,13,100.0
231050,2020,6,0,2,8,75.0
231060,2012,4,0,0,4,100.0
231060,2013,3,0,0,3,100.0
231060,2014,4,0,0,4,100.0
231060,2015,2,0,0,2,100.0
231060,2017,3,0,0,3,100.0
231060,2018,4,0,0,4,100.0
231060,2019,2,0,0,2,100.0
231060,2020,4,0,0,4,100.0
231070,2012,15,0,0,15,100.0
231070,2013,19,1,0,20,100.0
231070,2014,12,0,0,12,100.0
231070,2015,9,0,1,10,90.0
231070,2016,11,0,0,11,100.0
231070,2017,9,1,0,10,100.0
231070,2018,7,0,2,9,77.77777777777779
231070,2019,8,0,0,8,100.0
231070,2020,5,0,1,6,83.33333333333334
231080,2012,1,0,0,1,100.0
231080,2013,3,0,0,3,100.0
231080,2014,3,0,0,3,100.0
231080,2015,4,0,0,4,100.0
231080,2016,3,0,0,3,100.0
231080,2017,3,0,0,3,100.0
231080,2018,9,0,0,9,100.0
231080,2019,1,0,0,1,100.0
231080,2020,5,0,0,5,100.0
231085,2012,10,0,1,11,90.9090909090909
231085,2013,4,0,0,4,100.0
231085,2014,4,0,7,11,36.36363636363637
231085,2015,4,1,2,7,71.42857142857143
231085,2016,7,0,0,7,100.0
231085,2017,3,0,0,3,100.0
231085,2018,11,0,0,11,100.0
231085,2019,13,0,0,13,100.0
231085,2020,10,0,0,10,100.0
231090,2012,3,0,0,3,100.0
231090,2014,1,0,0,1,100.0
231090,2015,1,0,0,1,100.0
231090,2016,4,0,0,4,100.0
231090,2017,2,0,0,2,100.0
231090,2018,5,0,0,5,100.0
231090,2019,10,0,0,10,100.0
231090,2020,6,0,0,6,100.0
231095,2012,1,0,0,1,100.0
231095,2013,2,0,0,2,100.0
231095,2014,4,0,0,4,100.0
231095,2015,2,0,0,2,100.0
231095,2016,2,0,0,2,100.0
231095,2017,3,0,0,3,100.0
231095,2018,3,0,0,3,100.0
231095,2019,2,0,0,2,100.0
231095,2020,2,0,0,2,100.0
231100,2012,4,0,0,4,100.0
231100,2013,3,0,0,3,100.0
231100,2014,2,0,0,2,100.0
231100,2015,3,0,0,3,100.0
231100,2016,4,0,0,4,100.0
231100,2017,2,0,0,2,100.0
231100,2018,5,0,0,5,100.0
231100,2019,7,0,0,7,100.0
231100,2020,3,0,0,3,100.0
231110,2012,7,0,1,8,87.5
231110,2013,1,0,0,1,100.0
231110,2014,10,0,0,10,100.0
231110,2015,5,0,0,5,100.0
231110,2016,3,0,0,3,100.0
231110,2017,3,0,0,3,100.0
231110,2018,6,0,0,6,100.0
231110,2019,2,0,0,2,100.0
231110,2020,6,0,0,6,100.0
231120,2012,1,0,0,1,100.0
231120,2013,3,0,0,3,100.0
231120,2014,2,0,0,2,100.0
231120,2015,5,0,0,5,100.0
231120,2016,1,0,0,1,100.0
231120,2017,4,0,0,4,100.0
231120,2018,2,0,0,2,100.0
231120,2020,2,0,0,2,100.0
231123,2012,2,0,0,2,100.0
231123,2013,0,1,0,1,100.0
231123,2014,1,0,0,1,100.0
231123,2015,3,0,0,3,100.0
231123,2016,3,0,0,3,100.0
231123,2017,3,0,0,3,100.0
231123,2018,1,0,0,1,100.0
231123,2019,1,0,0,1,100.0
231123,2020,4,0,0,4,100.0
231126,2012,5,1,1,7,85.71428571428571
231126,2013,3,2,2,7,71.42857142857143
231126,2014,0,0,2,2,0.0
231126,2015,8,0,0,8,100.0
231126,2016,9,0,0,9,100.0
231126,2017,6,0,0,6,100.0
231126,2018,10,0,0,10,100.0
231126,2019,8,0,0,8,100.0
231126,2020,7,0,0,7,100.0
231130,2012,27,0,2,29,93.10344827586206
231130,2013,24,1,0,25,100.0
231130,2014,24,1,2,27,92.5925925925926
231130,2015,25,0,0,25,100.0
231130,2016,30,0,0,30,100.0
231130,2017,15,1,10,26,61.53846153846154
231130,2018,24,0,0,24,100.0
231130,2019,22,0,0,22,100.0
231130,2020,38,0,2,40,95.0
231135,2012,9,0,0,9,100.0
231135,2013,6,0,0,6,100.0
231135,2014,5,0,0,5,100.0
231135,2015,4,0,0,4,100.0
231135,2016,5,0,0,5,100.0
231135,2017,7,0,0,7,100.0
231135,2018,2,0,0,2,100.0
231135,2019,3,0,0,3,100.0
231135,2020,7,0,0,7,100.0
231140,2012,15,0,0,15,100.0
231140,2013,24,0,0,24,100.0
231140,2014,26,0,1,27,96.29629629629629
231140,2015,12,1,1,14,92.85714285714286
231140,2016,32,0,0,32,100.0
231140,2017,32,0,0,32,100.0
231140,2018,33,0,0,33,100.0
231140,2019,34,0,0,34,100.0
231140,2020,23,0,0,23,100.0
231150,2012,5,0,0,5,100.0
231150,2013,9,0,0,9,100.0
231150,2014,8,0,0,8,100.0
231150,2015,5,0,0,5,100.0
231150,2016,5,0,0,5,100.0
231150,2017,5,0,0,5,100.0
231150,2018,3,0,0,3,100.0
231150,2019,8,0,0,8,100.0
231150,2020,7,0,0,7,100.0
231160,2012,2,2,3,7,57.14285714285714
231160,2013,8,0,0,8,100.0
231160,2014,9,1,0,10,100.0
231160,2015,3,5,7,15,53.333333333333336
231160,2016,6,0,0,6,100.0
231160,2017,5,1,0,6,100.0
231160,2018,9,0,0,9,100.0
231160,2019,8,0,0,8,100.0
231160,2020,7,0,0,7,100.0
231170,2012,1,1,2,4,50.0
231170,2013,5,0,1,6,83.33333333333334
231170,2014,5,0,0,5,100.0
231170,2015,3,0,0,3,100.0
231170,2016,3,0,0,3,100.0
231170,2017,3,0,0,3,100.0
231170,2018,5,0,0,5,100.0
231170,2019,4,0,0,4,100.0
231170,2020,3,0,0,3,100.0
231180,2012,19,0,0,19,100.0
231180,2013,20,1,0,21,100.0
231180,2014,27,0,0,27,100.0
231180,2015,26,0,0,26,100.0
231180,2016,22,0,0,22,100.0
231180,2017,20,0,0,20,100.0
231180,2018,21,0,0,21,100.0
231180,2019,23,0,0,23,100.0
231180,2020,24,0,0,24,100.0
231190,2012,2,0,0,2,100.0
231190,2013,4,0,0,4,100.0
231190,2014,2,0,0,2,100.0
231190,2015,5,0,0,5,100.0
231190,2016,2,0,0,2,100.0
231190,2017,7,0,0,7,100.0
231190,2018,7,0,0,7,100.0
231190,2019,6,0,0,6,100.0
231190,2020,4,0,0,4,100.0
231195,2012,4,0,0,4,100.0
231195,2013,6,0,0,6,100.0
231195,2014,4,0,0,4,100.0
231195,2015,3,0,0,3,100.0
231195,2016,3,0,0,3,100.0
231195,2017,8,0,0,8,100.0
231195,2018,6,0,0,6,100.0
231195,2019,3,0,0,3,100.0
231195,2020,12,0,0,12,100.0
231200,2012,5,0,0,5,100.0
231200,2013,8,0,8,16,50.0
231200,2014,2,1,2,5,60.0
231200,2015,2,0,2,4,50.0
231200,2016,12,0,0,12,100.0
231200,2017,10,0,0,10,100.0
231200,2018,9,0,0,9,100.0
231200,2019,10,0,0,10,100.0
231200,2020,10,0,0,10,100.0
231210,2012,2,0,0,2,100.0
231210,2013,6,1,0,7,100.0
231210,2014,6,0,1,7,85.71428571428571
231210,2015,3,0,0,3,100.0
231210,2016,5,0,1,6,83.33333333333334
231210,2017,5,0,0,5,100.0
231210,2018,2,0,0,2,100.0
231210,2019,5,0,0,5,100.0
231210,2020,5,0,0,5,100.0
231220,2012,16,0,3,19,84.21052631578947
231220,2013,8,0,0,8,100.0
231220,2014,14,0,0,14,100.0
231220,2015,11,0,0,11,100.0
231220,2016,5,0,0,5,100.0
231220,2017,15,0,0,15,100.0
231220,2018,13,0,0,13,100.0
231220,2019,9,0,0,9,100.0
231220,2020,9,0,2,11,81.81818181818183
231230,2012,22,0,0,22,100.0
231230,2013,22,0,0,22,100.0
231230,2014,18,0,2,20,90.0
231230,2015,14,0,0,14,100.0
231230,2016,24,0,0,24,100.0
231230,2017,8,0,0,8,100.0
231230,2018,17,0,0,17,100.0
231230,2019,15,0,0,15,100.0
231230,2020,19,0,1,20,95.0
231240,2012,13,0,0,13,100.0
231240,2013,16,0,0,16,100.0
231240,2014,8,0,0,8,100.0
231240,2015,17,0,0,17,100.0
231240,2016,20,0,0,20,100.0
231240,2017,15,0,0,15,100.0
231240,2018,16,0,0,16,100.0
231240,2019,23,0,0,23,100.0
231240,2020,20,0,0,20,100.0
231250,2012,2,0,0,2,100.0
231250,2013,1,0,0,1,100.0
231250,2014,1,0,0,1,100.0
231250,2015,2,0,0,2,100.0
231250,2016,2,0,0,2,100.0
231250,2017,3,0,0,3,100.0
231250,2018,4,0,0,4,100.0
231250,2019,6,0,0,6,100.0
231250,2020,3,0,0,3,100.0
231260,2012,4,0,0,4,100.0
231260,2013,4,0,0,4,100.0
231260,2014,7,0,0,7,100.0
231260,2015,3,0,0,3,100.0
231260,2016,6,0,0,6,100.0
231260,2017,2,0,0,2,100.0
231260,2018,2,0,0,2,100.0
231260,2019,2,0,0,2,100.0
231260,2020,11,0,0,11,100.0
231270,2012,14,0,0,14,100.0
231270,2013,10,0,0,10,100.0
231270,2014,12,0,0,12,100.0
231270,2015,5,1,0,6,100.0
231270,2016,13,0,0,13,100.0
231270,2017,4,0,0,4,100.0
231270,2018,12,0,0,12,100.0
231270,2019,1,0,0,1,100.0
231270,2020,5,0,0,5,100.0
231280,2012,1,0,0,1,100.0
231280,2013,2,0,1,3,66.66666666666666
231280,2014,0,1,3,4,25.0
231280,2015,0,1,3,4,25.0
231280,2016,0,0,1,1,0.0
231280,2017,2,0,0,2,100.0
231280,2018,2,0,0,2,100.0
231280,2019,1,0,0,1,100.0
231280,2020,1,0,0,1,100.0
231290,2012,59,1,1,61,98.36065573770492
231290,2013,68,4,4,76,94.73684210526315
231290,2014,59,0,1,60,98.33333333333333
231290,2015,69,0,1,70,98.57142857142858
231290,2016,64,1,0,65,100.0
231290,2017,67,1,0,68,100.0
231290,2018,63,0,1,64,98.4375
231290,2019,59,0,0,59,100.0
231290,2020,78,1,0,79,100.0
231300,2012,6,0,0,6,100.0
231300,2013,4,0,0,4,100.0
231300,2014,12,0,0,12,100.0
231300,2015,3,0,0,3,100.0
231300,2016,2,0,0,2,100.0
231300,2017,6,0,0,6,100.0
231300,2018,4,0,0,4,100.0
231300,2019,11,0,0,11,100.0
231300,2020,5,0,0,5,100.0
231310,2012,8,0,0,8,100.0
231310,2013,13,0,0,13,100.0
231310,2014,9,0,0,9,100.0
231310,2015,11,0,0,11,100.0
231310,2016,7,0,0,7,100.0
231310,2017,13,0,0,13,100.0
231310,2018,14,0,0,14,100.0
231310,2019,10,0,0,10,100.0
231310,2020,16,0,0,16,100.0
231320,2012,8,1,0,9,100.0
231320,2013,7,0,1,8,87.5
231320,2014,5,0,1,6,83.33333333333334
231320,2015,6,0,0,6,100.0
231320,2016,11,0,0,11,100.0
231320,2017,15,0,0,15,100.0
231320,2018,10,0,0,10,100.0
231320,2019,11,0,0,11,100.0
231320,2020,8,0,1,9,88.88888888888889
231325,2012,3,0,0,3,100.0
231325,2013,2,0,0,2,100.0
231325,2014,4,0,0,4,100.0
231325,2015,2,0,0,2,100.0
231325,2016,2,0,0,2,100.0
231325,2018,2,0,0,2,100.0
231325,2019,1,0,0,1,100.0
231325,2020,1,0,0,1,100.0
231330,2012,14,0,0,14,100.0
231330,2013,22,0,0,22,100.0
231330,2014,20,0,1,21,95.23809523809523
231330,2015,25,0,0,25,100.0
231330,2016,15,0,0,15,100.0
231330,2017,17,0,0,17,100.0
231330,2018,21,0,0,21,100.0
231330,2019,23,0,0,23,100.0
231330,2020,15,1,0,16,100.0
231335,2012,7,0,0,7,100.0
231335,2013,5,0,0,5,100.0
231335,2014,5,0,0,5,100.0
231335,2015,2,0,0,2,100.0
231335,2016,3,0,0,3,100.0
231335,2017,2,0,0,2,100.0
231335,2018,7,0,0,7,100.0
231335,2019,4,0,0,4,100.0
231335,2020,6,0,0,6,100.0
231340,2012,15,0,1,16,93.75
231340,2013,18,0,0,18,100.0
231340,2014,21,0,0,21,100.0
231340,2015,21,0,0,21,100.0
231340,2016,22,0,0,22,100.0
231340,2017,22,0,0,22,100.0
231340,2018,27,0,0,27,100.0
231340,2019,25,0,0,25,100.0
231340,2020,39,0,0,39,100.0
231350,2012,11,7,1,19,94.73684210526315
231350,2013,16,0,0,16,100.0
231350,2014,17,0,1,18,94.44444444444444
231350,2015,12,0,1,13,92.3076923076923
231350,2016,15,0,0,15,100.0
231350,2017,12,2,0,14,100.0
231350,2018,16,0,0,16,100.0
231350,2019,17,0,0,17,100.0
231350,2020,21,0,0,21,100.0
231355,2012,1,0,0,1,100.0
231355,2013,3,0,0,3,100.0
231355,2014,4,0,0,4,100.0
231355,2015,5,0,0,5,100.0
231355,2016,3,0,0,3,100.0
231355,2017,4,0,0,4,100.0
231355,2018,2,0,0,2,100.0
231355,2019,3,0,0,3,100.0
231355,2020,9,0,0,9,100.0
231360,2012,9,0,0,9,100.0
231360,2013,9,0,0,9,100.0
231360,2014,6,0,0,6,100.0
231360,2015,3,0,0,3,100.0
231360,2016,5,0,0,5,100.0
231360,2017,8,0,0,8,100.0
231360,2018,7,0,0,7,100.0
231360,2019,15,0,0,15,100.0
231360,2020,12,0,0,12,100.0
231370,2012,5,0,0,5,100.0
231370,2013,1,0,0,1,100.0
231370,2015,1,0,0,1,100.0
231370,2017,3,0,0,3,100.0
231370,2019,2,0,0,2,100.0
231370,2020,2,0,0,2,100.0
231375,2012,4,0,0,4,100.0
231375,2013,1,1,0,2,100.0
231375,2014,6,0,0,6,100.0
231375,2015,3,0,0,3,100.0
231375,2016,6,0,0,6,100.0
231375,2017,7,0,0,7,100.0
231375,2018,6,0,0,6,100.0
231375,2019,11,0,0,11,100.0
231375,2020,9,0,0,9,100.0
231380,2012,4,0,0,4,100.0
231380,2013,6,0,0,6,100.0
231380,2014,9,1,0,10,100.0
231380,2015,4,0,0,4,100.0
231380,2016,8,0,0,8,100.0
231380,2017,15,0,0,15,100.0
231380,2018,5,0,0,5,100.0
231380,2019,9,0,0,9,100.0
231380,2020,6,0,0,6,100.0
231390,2012,6,0,0,6,100.0
231390,2013,1,1,2,4,50.0
231390,2014,6,0,0,6,100.0
231390,2015,2,0,0,2,100.0
231390,2016,7,0,0,7,100.0
231390,2017,3,0,0,3,100.0
231390,2018,3,0,0,3,100.0
231390,2019,4,0,0,4,100.0
231390,2020,6,0,0,6,100.0
231395,2012,2,0,0,2,100.0
231395,2013,9,0,0,9,100.0
231395,2014,4,0,0,4,100.0
231395,2015,6,0,0,6,100.0
231395,2016,3,0,0,3,100.0
231395,2017,8,0,0,8,100.0
231395,2018,7,0,1,8,87.5
231395,2019,7,0,0,7,100.0
231395,2020,11,0,0,11,100.0
231400,2012,12,0,0,12,100.0
231400,2013,9,0,0,9,100.0
231400,2014,11,0,0,11,100.0
231400,2015,11,0,0,11,100.0
231400,2016,6,0,0,6,100.0
231400,2017,7,0,0,7,100.0
231400,2018,11,0,0,11,100.0
231400,2019,10,0,0,10,100.0
231400,2020,12,0,1,13,92.3076923076923
231410,2012,17,0,0,17,100.0
231410,2013,10,0,0,10,100.0
231410,2014,18,0,0,18,100.0
231410,2015,9,0,0,9,100.0
231410,2016,17,0,0,17,100.0
231410,2017,20,0,0,20,100.0
231410,2018,18,0,0,18,100.0
231410,2019,21,0,0,21,100.0
231410,2020,24,0,0,24,100.0
240010,2012,3,0,0,3,100.0
240010,2013,4,0,0,4,100.0
240010,2014,2,0,0,2,100.0
240010,2015,4,0,0,4,100.0
240010,2016,2,0,0,2,100.0
240010,2017,2,0,0,2,100.0
240010,2018,1,0,1,2,50.0
240010,2019,1,0,0,1,100.0
240010,2020,1,0,2,3,33.33333333333333
240020,2012,17,0,0,17,100.0
240020,2013,12,0,0,12,100.0
240020,2014,11,0,3,14,78.57142857142857
240020,2015,17,0,5,22,77.27272727272727
240020,2016,10,1,5,16,68.75
240020,2017,10,0,0,10,100.0
240020,2018,17,0,0,17,100.0
240020,2019,11,0,3,14,78.57142857142857
240020,2020,16,0,1,17,94.11764705882352
240030,2012,2,0,0,2,100.0
240030,2013,3,0,0,3,100.0
240030,2014,3,0,0,3,100.0
240030,2015,3,0,0,3,100.0
240030,2016,5,0,0,5,100.0
240030,2017,4,0,0,4,100.0
240030,2018,4,0,0,4,100.0
240030,2019,4,0,0,4,100.0
240040,2013,1,0,0,1,100.0
240040,2014,1,0,0,1,100.0
240040,2016,2,0,0,2,100.0
240040,2018,1,0,0,1,100.0
240040,2019,1,0,0,1,100.0
240040,2020,1,0,0,1,100.0
240050,2012,2,0,1,3,66.66666666666666
240050,2013,1,0,0,1,100.0
240050,2014,5,0,0,5,100.0
240050,2015,1,0,1,2,50.0
240050,2016,0,0,4,4,0.0
240050,2017,4,0,0,4,100.0
240050,2018,1,0,2,3,33.33333333333333
240050,2019,2,0,3,5,40.0
240050,2020,0,0,2,2,0.0
240060,2012,1,0,1,2,50.0
240060,2013,1,0,0,1,100.0
240060,2014,1,0,0,1,100.0
240060,2015,0,0,1,1,0.0
240060,2017,2,0,0,2,100.0
240060,2019,2,0,0,2,100.0
240070,2012,2,0,0,2,100.0
240070,2013,1,0,0,1,100.0
240070,2014,4,0,0,4,100.0
240070,2015,3,1,4,8,50.0
240070,2016,5,0,4,9,55.55555555555556
240070,2017,3,0,0,3,100.0
240070,2018,1,0,1,2,50.0
240070,2020,0,0,3,3,0.0
240080,2012,5,0,0,5,100.0
240080,2013,3,0,0,3,100.0
240080,2014,5,0,0,5,100.0
240080,2015,1,0,0,1,100.0
240080,2016,2,0,2,4,50.0
240080,2017,5,0,0,5,100.0
240080,2018,8,0,0,8,100.0
240080,2019,6,0,0,6,100.0
240080,2020,2,0,0,2,100.0
240090,2012,3,0,1,4,75.0
240090,2015,1,0,1,2,50.0
240090,2016,0,0,1,1,0.0
240090,2017,0,0,1,1,0.0
240090,2018,0,0,1,1,0.0
240090,2019,2,0,0,2,100.0
240090,2020,1,0,0,1,100.0
240100,2012,8,0,2,10,80.0
240100,2013,2,0,9,11,18.181818181818183
240100,2014,2,1,8,11,27.27272727272727
240100,2015,0,0,11,11,0.0
240100,2016,6,0,0,6,100.0
240100,2017,5,0,3,8,62.5
240100,2018,2,0,10,12,16.666666666666664
240100,2019,7,2,1,10,90.0
240100,2020,11,0,0,11,100.0
240110,2012,10,0,1,11,90.9090909090909
240110,2013,1,0,3,4,25.0
240110,2014,2,1,5,8,37.5
240110,2015,4,0,1,5,80.0
240110,2016,12,0,0,12,100.0
240110,2017,12,0,0,12,100.0
240110,2018,13,0,0,13,100.0
240110,2019,7,0,0,7,100.0
240110,2020,14,0,0,14,100.0
240120,2012,3,0,0,3,100.0
240120,2013,4,0,0,4,100.0
240120,2014,3,0,1,4,75.0
240120,2015,4,0,0,4,100.0
240120,2016,3,0,0,3,100.0
240120,2017,2,0,0,2,100.0
240120,2019,5,0,0,5,100.0
240120,2020,6,0,0,6,100.0
240130,2012,0,0,1,1,0.0
240130,2013,0,0,2,2,0.0
240130,2014,4,0,0,4,100.0
240130,2015,2,0,0,2,100.0
240130,2016,3,0,0,3,100.0
240130,2017,0,0,2,2,0.0
240130,2018,0,0,3,3,0.0
240130,2019,0,0,1,1,0.0
240130,2020,0,0,1,1,0.0
240140,2012,2,0,0,2,100.0
240140,2013,2,0,0,2,100.0
240140,2014,1,0,2,3,33.33333333333333
240140,2015,2,0,0,2,100.0
240140,2016,1,0,0,1,100.0
240140,2018,3,0,0,3,100.0
240140,2019,6,0,0,6,100.0
240140,2020,4,0,0,4,100.0
240145,2012,5,2,3,10,70.0
240145,2013,4,0,2,6,66.66666666666666
240145,2014,1,1,9,11,18.181818181818183
240145,2015,0,2,3,5,40.0
240145,2016,2,1,12,15,20.0
240145,2017,0,0,9,9,0.0
240145,2018,8,0,0,8,100.0
240145,2019,6,0,0,6,100.0
240145,2020,10,0,0,10,100.0
240150,2013,1,0,0,1,100.0
240150,2014,1,0,0,1,100.0
240150,2015,5,0,0,5,100.0
240150,2017,1,0,0,1,100.0
240150,2020,3,0,0,3,100.0
240160,2012,1,0,1,2,50.0
240160,2013,1,0,0,1,100.0
240160,2015,0,0,2,2,0.0
240160,2016,0,0,1,1,0.0
240160,2017,2,0,0,2,100.0
240160,2019,0,0,1,1,0.0
240160,2020,2,0,0,2,100.0
240165,2012,2,0,0,2,100.0
240165,2014,1,0,0,1,100.0
240165,2015,0,0,1,1,0.0
240165,2017,2,0,0,2,100.0
240165,2018,2,0,0,2,100.0
240170,2012,1,0,0,1,100.0
240170,2014,2,0,0,2,100.0
240170,2015,1,0,1,2,50.0
240170,2016,9,0,0,9,100.0
240170,2017,3,0,1,4,75.0
240170,2018,1,0,1,2,50.0
240170,2019,2,0,0,2,100.0
240170,2020,6,0,0,6,100.0
240180,2012,2,0,0,2,100.0
240180,2013,4,0,0,4,100.0
240180,2014,6,0,1,7,85.71428571428571
240180,2015,5,0,0,5,100.0
240180,2016,5,0,0,5,100.0
240180,2017,5,0,0,5,100.0
240180,2018,5,0,0,5,100.0
240180,2019,4,0,2,6,66.66666666666666
240180,2020,5,0,0,5,100.0
240185,2013,0,0,1,1,0.0
240185,2015,0,0,3,3,0.0
240185,2016,1,0,0,1,100.0
240185,2017,2,0,0,2,100.0
240185,2020,3,0,0,3,100.0
240190,2012,1,0,0,1,100.0
240190,2013,0,0,1,1,0.0
240190,2014,0,0,1,1,0.0
240190,2015,0,0,1,1,0.0
240190,2018,2,0,0,2,100.0
240190,2019,2,0,0,2,100.0
240190,2020,2,0,0,2,100.0
240200,2012,19,0,1,20,95.0
240200,2013,13,0,0,13,100.0
240200,2014,21,0,0,21,100.0
240200,2015,19,0,0,19,100.0
240200,2016,24,0,0,24,100.0
240200,2017,14,0,0,14,100.0
240200,2018,19,0,1,20,95.0
240200,2019,9,0,1,10,90.0
240200,2020,17,0,0,17,100.0
240210,2012,3,0,0,3,100.0
240210,2013,2,0,0,2,100.0
240210,2014,3,0,0,3,100.0
240210,2015,2,0,0,2,100.0
240210,2016,2,0,2,4,50.0
240210,2017,1,0,0,1,100.0
240210,2018,0,0,4,4,0.0
240210,2019,0,0,1,1,0.0
240210,2020,0,0,1,1,0.0
240220,2012,9,0,0,9,100.0
240220,2013,6,0,0,6,100.0
240220,2014,13,0,1,14,92.85714285714286
240220,2015,15,0,0,15,100.0
240220,2016,8,0,0,8,100.0
240220,2017,9,0,0,9,100.0
240220,2018,6,0,0,6,100.0
240220,2019,9,0,0,9,100.0
240220,2020,13,0,0,13,100.0
240230,2012,12,0,0,12,100.0
240230,2013,6,0,0,6,100.0
240230,2014,8,0,2,10,80.0
240230,2015,5,0,3,8,62.5
240230,2016,8,0,1,9,88.88888888888889
240230,2017,3,0,0,3,100.0
240230,2018,6,0,0,6,100.0
240230,2019,7,0,1,8,87.5
240230,2020,9,0,0,9,100.0
240240,2012,1,0,0,1,100.0
240240,2013,2,0,0,2,100.0
240240,2014,4,0,0,4,100.0
240240,2015,3,0,0,3,100.0
240240,2016,1,0,0,1,100.0
240240,2018,2,0,1,3,66.66666666666666
240240,2019,1,0,1,2,50.0
240240,2020,3,0,0,3,100.0
240250,2012,1,0,0,1,100.0
240250,2013,4,0,0,4,100.0
240250,2014,7,0,0,7,100.0
240250,2015,7,0,0,7,100.0
240250,2016,5,0,0,5,100.0
240250,2018,0,0,4,4,0.0
240250,2019,0,1,1,2,50.0
240250,2020,5,0,0,5,100.0
240260,2012,16,1,5,22,77.27272727272727
240260,2013,22,0,7,29,75.86206896551724
240260,2014,27,0,1,28,96.42857142857143
240260,2015,24,0,1,25,96.0
240260,2016,24,0,1,25,96.0
240260,2017,24,0,0,24,100.0
240260,2018,28,0,2,30,93.33333333333333
240260,2019,22,2,2,26,92.3076923076923
240260,2020,10,0,1,11,90.9090909090909
240270,2012,3,0,0,3,100.0
240270,2013,3,0,0,3,100.0
240270,2014,1,0,0,1,100.0
240270,2015,5,0,0,5,100.0
240270,2016,5,0,0,5,100.0
240270,2017,4,0,0,4,100.0
240270,2018,3,0,0,3,100.0
240270,2020,2,0,0,2,100.0
240280,2013,1,0,0,1,100.0
240280,2014,2,0,0,2,100.0
240280,2016,1,0,0,1,100.0
240280,2017,0,0,1,1,0.0
240280,2018,0,0,2,2,0.0
240280,2019,3,0,0,3,100.0
240280,2020,2,0,0,2,100.0
240290,2012,1,0,0,1,100.0
240290,2013,2,0,0,2,100.0
240290,2014,3,0,0,3,100.0
240290,2015,2,0,0,2,100.0
240290,2016,1,0,0,1,100.0
240290,2017,0,0,1,1,0.0
240290,2018,1,0,0,1,100.0
240290,2019,3,0,0,3,100.0
240290,2020,0,0,1,1,0.0
240300,2012,1,1,1,3,66.66666666666666
240300,2013,3,0,0,3,100.0
240300,2014,4,0,0,4,100.0
240300,2015,4,0,1,5,80.0
240300,2016,3,0,0,3,100.0
240300,2017,1,0,0,1,100.0
240300,2018,0,2,1,3,66.66666666666666
240300,2019,5,0,0,5,100.0
240300,2020,3,0,0,3,100.0
240310,2012,7,0,0,7,100.0
240310,2013,11,0,0,11,100.0
240310,2014,10,0,0,10,100.0
240310,2015,10,0,4,14,71.42857142857143
240310,2016,9,0,0,9,100.0
240310,2017,11,0,1,12,91.66666666666666
240310,2018,8,0,0,8,100.0
240310,2019,9,0,5,14,64.28571428571429
240310,2020,11,0,0,11,100.0
240320,2013,4,0,0,4,100.0
240320,2014,2,0,0,2,100.0
240320,2015,6,0,0,6,100.0
240320,2016,2,0,0,2,100.0
240320,2017,4,0,0,4,100.0
240320,2019,4,0,0,4,100.0
240320,2020,2,0,0,2,100.0
240325,2012,53,0,4,57,92.98245614035088
240325,2013,70,0,4,74,94.5945945945946
240325,2014,54,0,2,56,96.42857142857143
240325,2015,52,0,5,57,91.22807017543859
240325,2016,58,1,22,81,72.8395061728395
240325,2017,50,0,17,67,74.6268656716418
240325,2018,41,0,11,52,78.84615384615384
240325,2019,45,1,16,62,74.19354838709677
240325,2020,58,2,21,81,74.07407407407408
240330,2012,1,0,0,1,100.0
240330,2013,1,0,1,2,50.0
240330,2014,3,0,0,3,100.0
240330,2015,1,0,0,1,100.0
240330,2016,1,0,0,1,100.0
240330,2017,4,0,0,4,100.0
240330,2018,1,0,0,1,100.0
240330,2019,2,0,0,2,100.0
240330,2020,0,0,1,1,0.0
240340,2012,2,0,0,2,100.0
240340,2013,1,0,0,1,100.0
240340,2014,3,0,0,3,100.0
240340,2016,2,1,0,3,100.0
240340,2019,2,0,0,2,100.0
240340,2020,1,0,0,1,100.0
240350,2012,4,0,0,4,100.0
240350,2013,3,0,0,3,100.0
240350,2014,3,0,0,3,100.0
240350,2015,3,0,0,3,100.0
240350,2016,4,0,0,4,100.0
240350,2017,1,0,0,1,100.0
240350,2018,1,0,0,1,100.0
240350,2019,1,0,0,1,100.0
240350,2020,3,0,0,3,100.0
240360,2012,7,0,1,8,87.5
240360,2013,6,0,0,6,100.0
240360,2014,8,0,0,8,100.0
240360,2015,9,0,3,12,75.0
240360,2016,9,0,2,11,81.81818181818183
240360,2017,11,0,0,11,100.0
240360,2018,12,0,1,13,92.3076923076923
240360,2019,11,0,6,17,64.70588235294117
240360,2020,0,1,17,18,5.555555555555555
240370,2012,3,1,0,4,100.0
240370,2013,2,0,1,3,66.66666666666666
240370,2015,0,1,0,1,100.0
240370,2016,1,0,1,2,50.0
240370,2017,0,1,2,3,33.33333333333333
240370,2018,0,1,0,1,100.0
240370,2019,0,0,1,1,0.0
240370,2020,0,0,1,1,0.0
240375,2012,1,0,0,1,100.0
240375,2013,1,0,0,1,100.0
240375,2014,3,0,0,3,100.0
240375,2015,2,0,0,2,100.0
240375,2016,1,0,0,1,100.0
240375,2019,1,0,1,2,50.0
240380,2012,3,0,0,3,100.0
240380,2013,1,0,0,1,100.0
240380,2014,3,0,0,3,100.0
240380,2015,1,0,0,1,100.0
240380,2016,5,0,1,6,83.33333333333334
240380,2017,0,0,1,1,0.0
240380,2018,3,0,0,3,100.0
240380,2019,2,0,0,2,100.0
240380,2020,5,0,0,5,100.0
240390,2013,1,0,0,1,100.0
240390,2016,0,0,1,1,0.0
240390,2017,2,0,0,2,100.0
240400,2012,2,0,0,2,100.0
240400,2014,0,0,1,1,0.0
240400,2015,2,0,0,2,100.0
240400,2016,0,0,1,1,0.0
240400,2017,2,0,0,2,100.0
240400,2019,4,0,0,4,100.0
240400,2020,3,0,0,3,100.0
240410,2012,2,0,0,2,100.0
240410,2017,1,0,0,1,100.0
240410,2019,1,0,0,1,100.0
240410,2020,2,0,0,2,100.0
240420,2012,5,0,0,5,100.0
240420,2013,8,0,0,8,100.0
240420,2014,11,0,0,11,100.0
240420,2015,4,0,0,4,100.0
240420,2016,7,0,0,7,100.0
240420,2017,5,0,0,5,100.0
240420,2018,8,0,0,8,100.0
240420,2019,5,0,0,5,100.0
240420,2020,14,0,0,14,100.0
240430,2012,1,3,1,5,80.0
240430,2013,0,2,2,4,50.0
240430,2014,0,2,2,4,50.0
240430,2015,0,2,4,6,33.33333333333333
240430,2016,0,2,4,6,33.33333333333333
240430,2017,5,0,1,6,83.33333333333334
240430,2018,1,0,1,2,50.0
240430,2019,0,4,1,5,80.0
240430,2020,1,2,3,6,50.0
240440,2012,3,0,2,5,60.0
240440,2013,0,1,4,5,20.0
240440,2014,0,0,3,3,0.0
240440,2015,0,0,4,4,0.0
240440,2016,0,0,2,2,0.0
240440,2017,0,0,2,2,0.0
240440,2018,0,0,1,1,0.0
240440,2019,0,1,2,3,33.33333333333333
240440,2020,0,0,4,4,0.0
240450,2012,8,0,0,8,100.0
240450,2013,4,0,0,4,100.0
240450,2014,9,0,0,9,100.0
240450,2015,8,0,0,8,100.0
240450,2016,6,0,0,6,100.0
240450,2017,3,0,0,3,100.0
240450,2018,5,0,0,5,100.0
240450,2019,4,0,0,4,100.0
240450,2020,7,0,0,7,100.0
240460,2012,1,0,0,1,100.0
240460,2013,2,0,0,2,100.0
240460,2014,2,0,0,2,100.0
240460,2015,1,0,0,1,100.0
240460,2016,2,0,0,2,100.0
240460,2017,1,0,0,1,100.0
240460,2018,3,0,0,3,100.0
240460,2019,3,0,0,3,100.0
240460,2020,3,0,0,3,100.0
240470,2012,4,0,0,4,100.0
240470,2013,6,0,0,6,100.0
240470,2014,2,1,0,3,100.0
240470,2015,0,0,8,8,0.0
240470,2016,3,0,1,4,75.0
240470,2017,6,0,1,7,85.71428571428571
240470,2018,3,0,3,6,50.0
240470,2019,0,0,1,1,0.0
240470,2020,0,0,5,5,0.0
240480,2017,3,0,0,3,100.0
240480,2020,1,0,0,1,100.0
240485,2012,1,1,0,2,100.0
240485,2014,3,0,0,3,100.0
240485,2015,8,0,0,8,100.0
240485,2016,2,0,0,2,100.0
240485,2017,3,0,2,5,60.0
240485,2018,0,0,1,1,0.0
240485,2019,0,0,3,3,0.0
240485,2020,2,0,0,2,100.0
240490,2012,2,0,1,3,66.66666666666666
240490,2013,2,0,1,3,66.66666666666666
240490,2015,2,0,0,2,100.0
240490,2016,1,0,1,2,50.0
240490,2018,2,0,0,2,100.0
240490,2019,1,0,1,2,50.0
240490,2020,1,0,2,3,33.33333333333333
240500,2012,3,0,0,3,100.0
240500,2013,2,0,0,2,100.0
240500,2014,2,0,1,3,66.66666666666666
240500,2015,2,0,0,2,100.0
240500,2016,3,0,0,3,100.0
240500,2017,1,0,0,1,100.0
240500,2018,0,0,1,1,0.0
240500,2019,3,0,0,3,100.0
240500,2020,2,0,0,2,100.0
240510,2012,1,0,0,1,100.0
240510,2013,2,0,0,2,100.0
240510,2014,4,0,0,4,100.0
240510,2015,1,0,1,2,50.0
240510,2016,5,0,0,5,100.0
240510,2017,4,0,0,4,100.0
240510,2018,2,0,0,2,100.0
240510,2019,1,0,0,1,100.0
240510,2020,2,0,0,2,100.0
240520,2012,3,1,1,5,80.0
240520,2014,0,0,1,1,0.0
240520,2016,1,0,1,2,50.0
240520,2017,0,0,2,2,0.0
240520,2018,0,1,1,2,50.0
240520,2019,0,2,2,4,50.0
240520,2020,0,0,2,2,0.0
240530,2012,3,0,0,3,100.0
240530,2013,3,0,0,3,100.0
240530,2014,2,0,0,2,100.0
240530,2015,2,0,0,2,100.0
240530,2016,1,0,1,2,50.0
240530,2018,0,0,1,1,0.0
240530,2019,6,0,0,6,100.0
240530,2020,1,0,0,1,100.0
240540,2014,1,0,2,3,33.33333333333333
240540,2016,0,0,2,2,0.0
240540,2017,1,0,1,2,50.0
240540,2018,1,0,1,2,50.0
240540,2019,1,0,0,1,100.0
240540,2020,1,0,3,4,25.0
240550,2014,1,0,0,1,100.0
240550,2015,0,0,1,1,0.0
240550,2018,2,0,0,2,100.0
240560,2012,7,0,0,7,100.0
240560,2013,3,0,0,3,100.0
240560,2014,3,0,0,3,100.0
240560,2015,3,0,0,3,100.0
240560,2016,4,0,3,7,57.14285714285714
240560,2017,0,1,3,4,25.0
240560,2018,6,0,0,6,100.0
240560,2019,6,0,0,6,100.0
240560,2020,5,0,0,5,100.0
240570,2012,4,0,0,4,100.0
240570,2013,3,0,0,3,100.0
240570,2014,3,0,1,4,75.0
240570,2015,2,0,1,3,66.66666666666666
240570,2016,1,0,1,2,50.0
240570,2017,0,0,2,2,0.0
240570,2018,2,0,0,2,100.0
240570,2019,2,0,0,2,100.0
240570,2020,3,0,0,3,100.0
240580,2012,13,0,0,13,100.0
240580,2013,9,0,3,12,75.0
240580,2014,9,0,0,9,100.0
240580,2015,8,0,1,9,88.88888888888889
240580,2016,13,0,0,13,100.0
240580,2017,14,0,0,14,100.0
240580,2018,12,0,0,12,100.0
240580,2019,14,0,1,15,93.33333333333333
240580,2020,16,0,0,16,100.0
240590,2013,0,0,1,1,0.0
240590,2014,0,0,1,1,0.0
240590,2017,2,0,1,3,66.66666666666666
240590,2018,1,0,0,1,100.0
240590,2020,1,0,2,3,33.33333333333333
240600,2012,6,0,0,6,100.0
240600,2013,1,0,0,1,100.0
240600,2014,1,0,0,1,100.0
240600,2015,1,0,0,1,100.0
240600,2016,0,0,2,2,0.0
240600,2017,1,0,0,1,100.0
240600,2019,3,0,0,3,100.0
240600,2020,3,0,0,3,100.0
240610,2012,7,0,0,7,100.0
240610,2013,2,0,0,2,100.0
240610,2014,4,0,0,4,100.0
240610,2015,4,0,0,4,100.0
240610,2016,6,0,1,7,85.71428571428571
240610,2017,4,0,0,4,100.0
240610,2018,5,0,0,5,100.0
240610,2019,1,0,0,1,100.0
240610,2020,8,0,1,9,88.88888888888889
240615,2013,0,0,1,1,0.0
240615,2014,1,0,0,1,100.0
240615,2015,1,0,0,1,100.0
240615,2016,1,0,0,1,100.0
240615,2018,1,0,0,1,100.0
240615,2019,2,0,0,2,100.0
240615,2020,1,0,0,1,100.0
240620,2012,2,0,0,2,100.0
240620,2014,2,0,1,3,66.66666666666666
240620,2015,1,0,0,1,100.0
240620,2016,1,0,0,1,100.0
240620,2017,1,0,0,1,100.0
240620,2018,3,0,0,3,100.0
240620,2019,0,0,1,1,0.0
240620,2020,1,0,0,1,100.0
240630,2012,1,0,0,1,100.0
240630,2014,2,0,0,2,100.0
240630,2015,2,0,0,2,100.0
240630,2017,1,0,0,1,100.0
240630,2018,2,0,0,2,100.0
240630,2019,3,0,0,3,100.0
240630,2020,1,0,0,1,100.0
240640,2012,1,0,0,1,100.0
240640,2016,0,0,2,2,0.0
240640,2017,0,0,1,1,0.0
240640,2018,0,1,1,2,50.0
240640,2020,1,0,1,2,50.0
240650,2012,4,0,0,4,100.0
240650,2013,3,0,0,3,100.0
240650,2014,7,0,0,7,100.0
240650,2015,4,0,0,4,100.0
240650,2016,3,0,0,3,100.0
240650,2017,4,0,0,4,100.0
240650,2018,3,0,0,3,100.0
240650,2019,5,0,0,5,100.0
240650,2020,5,0,0,5,100.0
240660,2012,2,0,0,2,100.0
240660,2013,2,0,0,2,100.0
240660,2014,6,0,0,6,100.0
240660,2015,3,0,0,3,100.0
240660,2017,0,0,1,1,0.0
240660,2018,0,0,2,2,0.0
240660,2020,4,0,0,4,100.0
240670,2012,2,0,0,2,100.0
240670,2013,2,0,0,2,100.0
240670,2014,1,0,0,1,100.0
240670,2015,4,0,0,4,100.0
240670,2016,2,0,0,2,100.0
240670,2017,1,0,0,1,100.0
240670,2018,3,0,0,3,100.0
240670,2019,3,0,0,3,100.0
240670,2020,3,0,0,3,100.0
240680,2012,6,0,0,6,100.0
240680,2015,1,0,0,1,100.0
240680,2016,3,0,0,3,100.0
240680,2019,3,0,0,3,100.0
240690,2013,1,0,0,1,100.0
240690,2014,1,0,0,1,100.0
240690,2016,2,0,0,2,100.0
240690,2018,3,0,0,3,100.0
240700,2012,1,0,1,2,50.0
240700,2013,1,0,0,1,100.0
240700,2014,0,1,1,2,50.0
240700,2015,0,0,4,4,0.0
240700,2016,0,0,2,2,0.0
240700,2017,1,0,0,1,100.0
240700,2018,2,0,2,4,50.0
240700,2019,2,0,5,7,28.57142857142857
240700,2020,2,0,1,3,66.66666666666666
240710,2012,24,0,1,25,96.0
240710,2013,22,0,1,23,95.65217391304348
240710,2014,23,0,0,23,100.0
240710,2015,19,0,0,19,100.0
240710,2016,22,0,0,22,100.0
240710,2017,28,0,2,30,93.33333333333333
240710,2018,29,0,2,31,93.54838709677419
240710,2019,14,0,0,14,100.0
240710,2020,25,0,2,27,92.5925925925926
240720,2012,5,0,1,6,83.33333333333334
240720,2013,9,0,0,9,100.0
240720,2014,8,0,0,8,100.0
240720,2015,11,0,0,11,100.0
240720,2016,8,0,2,10,80.0
240720,2017,3,0,1,4,75.0
240720,2018,7,0,0,7,100.0
240720,2019,3,0,3,6,50.0
240720,2020,4,0,2,6,66.66666666666666
240725,2014,2,0,0,2,100.0
240725,2015,1,0,0,1,100.0
240725,2016,3,0,0,3,100.0
240725,2018,1,0,0,1,100.0
240725,2020,1,0,0,1,100.0
240730,2012,1,0,0,1,100.0
240730,2013,1,0,1,2,50.0
240730,2014,0,0,5,5,0.0
240730,2015,0,0,2,2,0.0
240730,2016,0,0,3,3,0.0
240730,2017,2,0,0,2,100.0
240730,2018,2,0,3,5,40.0
240730,2020,0,0,2,2,0.0
240740,2012,1,0,0,1,100.0
240740,2013,1,0,3,4,25.0
240740,2014,1,0,0,1,100.0
240740,2015,3,0,0,3,100.0
240740,2016,1,0,0,1,100.0
240740,2017,2,0,1,3,66.66666666666666
240740,2018,2,0,0,2,100.0
240740,2019,8,0,0,8,100.0
240740,2020,3,0,2,5,60.0
240750,2012,0,0,2,2,0.0
240750,2013,3,0,0,3,100.0
240750,2015,0,0,4,4,0.0
240750,2016,4,0,0,4,100.0
240750,2017,2,0,0,2,100.0
240750,2018,3,0,0,3,100.0
240750,2019,3,0,0,3,100.0
240750,2020,2,0,0,2,100.0
240760,2012,1,0,1,2,50.0
240760,2013,0,0,1,1,0.0
240760,2014,0,0,2,2,0.0
240760,2017,0,0,2,2,0.0
240760,2018,0,0,4,4,0.0
240760,2019,1,0,0,1,100.0
240760,2020,1,0,0,1,100.0
240770,2013,6,0,0,6,100.0
240770,2014,4,0,0,4,100.0
240770,2015,6,0,0,6,100.0
240770,2016,2,0,1,3,66.66666666666666
240770,2018,3,0,0,3,100.0
240770,2019,3,0,0,3,100.0
240770,2020,8,0,0,8,100.0
240780,2012,5,0,0,5,100.0
240780,2013,4,0,0,4,100.0
240780,2014,3,0,0,3,100.0
240780,2015,6,0,0,6,100.0
240780,2016,8,0,0,8,100.0
240780,2017,10,0,0,10,100.0
240780,2018,7,0,0,7,100.0
240780,2019,9,0,0,9,100.0
240780,2020,8,0,0,8,100.0
240790,2012,0,0,1,1,0.0
240790,2013,1,0,0,1,100.0
240790,2015,0,0,1,1,0.0
240790,2017,0,0,1,1,0.0
240790,2019,0,0,1,1,0.0
240800,2012,93,1,2,96,97.91666666666666
240800,2013,84,0,0,84,100.0
240800,2014,90,0,0,90,100.0
240800,2015,81,0,0,81,100.0
240800,2016,87,0,0,87,100.0
240800,2017,89,0,1,90,98.88888888888889
240800,2018,102,0,0,102,100.0
240800,2019,99,0,0,99,100.0
240800,2020,102,0,0,102,100.0
240810,2012,216,2,31,249,87.55020080321285
240810,2013,263,0,21,284,92.6056338028169
240810,2014,174,0,88,262,66.41221374045801
240810,2015,189,0,21,210,90.0
240810,2016,257,0,9,266,96.61654135338345
240810,2017,256,2,20,278,92.80575539568345
240810,2018,112,5,139,256,45.703125
240810,2019,228,0,28,256,89.0625
240810,2020,229,3,15,247,93.92712550607287
240820,2012,7,0,0,7,100.0
240820,2013,9,0,1,10,90.0
240820,2014,9,0,2,11,81.81818181818183
240820,2015,7,0,2,9,77.77777777777779
240820,2016,6,0,2,8,75.0
240820,2017,5,0,1,6,83.33333333333334
240820,2018,7,0,0,7,100.0
240820,2019,8,0,0,8,100.0
240820,2020,6,0,0,6,100.0
240830,2012,8,0,0,8,100.0
240830,2013,12,0,0,12,100.0
240830,2014,12,0,0,12,100.0
240830,2015,16,0,0,16,100.0
240830,2016,8,0,2,10,80.0
240830,2017,8,0,0,8,100.0
240830,2018,12,0,0,12,100.0
240830,2019,7,0,0,7,100.0
240830,2020,9,0,0,9,100.0
240840,2012,0,0,1,1,0.0
240840,2013,1,0,0,1,100.0
240840,2014,2,0,0,2,100.0
240840,2015,3,0,0,3,100.0
240840,2016,2,0,0,2,100.0
240840,2017,1,0,0,1,100.0
240840,2018,1,0,0,1,100.0
240840,2019,1,0,0,1,100.0
240850,2012,1,0,0,1,100.0
240850,2018,0,0,2,2,0.0
240850,2019,0,0,1,1,0.0
240850,2020,1,0,0,1,100.0
240860,2012,1,0,0,1,100.0
240860,2015,2,0,0,2,100.0
240860,2016,1,0,1,2,50.0
240860,2017,2,0,0,2,100.0
240860,2018,3,0,0,3,100.0
240860,2019,1,0,0,1,100.0
240870,2012,1,0,0,1,100.0
240870,2014,1,0,0,1,100.0
240870,2015,1,0,0,1,100.0
240870,2016,0,0,3,3,0.0
240870,2020,0,0,3,3,0.0
240880,2012,1,0,0,1,100.0
240880,2014,1,0,0,1,100.0
240880,2016,3,0,0,3,100.0
240880,2018,1,0,0,1,100.0
240890,2012,5,0,0,5,100.0
240890,2013,10,0,0,10,100.0
240890,2014,2,0,0,2,100.0
240890,2015,4,0,0,4,100.0
240890,2016,4,0,0,4,100.0
240890,2017,3,0,0,3,100.0
240890,2018,4,0,0,4,100.0
240890,2019,7,0,0,7,100.0
240890,2020,5,0,0,5,100.0
240895,2012,4,0,0,4,100.0
240895,2013,6,0,0,6,100.0
240895,2014,2,0,0,2,100.0
240895,2015,2,0,0,2,100.0
240895,2016,5,0,0,5,100.0
240895,2017,5,0,0,5,100.0
240895,2018,4,0,0,4,100.0
240895,2019,4,0,0,4,100.0
240895,2020,6,0,0,6,100.0
240910,2012,3,0,0,3,100.0
240910,2013,3,0,0,3,100.0
240910,2014,1,0,0,1,100.0
240910,2015,4,0,1,5,80.0
240910,2016,2,1,2,5,60.0
240910,2018,3,0,0,3,100.0
240910,2020,1,0,1,2,50.0
240920,2012,1,0,0,1,100.0
240920,2016,0,0,1,1,0.0
240920,2017,2,0,0,2,100.0
240920,2018,0,0,1,1,0.0
240930,2012,2,0,0,2,100.0
240930,2013,2,0,0,2,100.0
240930,2014,8,0,0,8,100.0
240930,2015,5,0,0,5,100.0
240930,2016,6,0,0,6,100.0
240930,2017,3,0,1,4,75.0
240930,2018,5,0,0,5,100.0
240930,2019,6,0,0,6,100.0
240930,2020,4,0,1,5,80.0
240933,2012,1,0,0,1,100.0
240933,2013,1,0,0,1,100.0
240933,2014,2,0,0,2,100.0
240933,2015,1,0,0,1,100.0
240933,2017,2,0,2,4,50.0
240933,2019,0,0,2,2,0.0
240933,2020,0,0,1,1,0.0
240940,2012,9,0,0,9,100.0
240940,2013,9,0,1,10,90.0
240940,2014,6,0,0,6,100.0
240940,2015,10,0,0,10,100.0
240940,2016,3,0,1,4,75.0
240940,2017,8,0,0,8,100.0
240940,2018,8,0,3,11,72.72727272727273
240940,2019,10,0,1,11,90.9090909090909
240940,2020,14,0,0,14,100.0
240950,2013,3,0,0,3,100.0
240950,2014,2,0,0,2,100.0
240950,2016,3,0,0,3,100.0
240950,2017,1,0,0,1,100.0
240950,2018,3,0,0,3,100.0
240950,2019,2,0,0,2,100.0
240950,2020,1,0,0,1,100.0
240960,2014,1,0,0,1,100.0
240960,2017,1,0,0,1,100.0
240960,2018,1,0,0,1,100.0
240960,2020,2,0,0,2,100.0
240970,2012,0,0,2,2,0.0
240970,2013,0,0,2,2,0.0
240970,2014,1,0,1,2,50.0
240970,2015,0,0,2,2,0.0
240970,2016,1,0,0,1,100.0
240970,2017,0,0,1,1,0.0
240970,2020,1,0,0,1,100.0
240980,2012,2,0,0,2,100.0
240980,2013,7,0,0,7,100.0
240980,2014,7,0,0,7,100.0
240980,2015,5,0,0,5,100.0
240980,2016,9,0,0,9,100.0
240980,2017,2,0,0,2,100.0
240980,2018,5,0,0,5,100.0
240980,2019,4,0,0,4,100.0
240980,2020,5,0,0,5,100.0
240990,2012,2,0,2,4,50.0
240990,2013,5,0,2,7,71.42857142857143
240990,2014,5,0,0,5,100.0
240990,2015,4,0,1,5,80.0
240990,2016,2,0,0,2,100.0
240990,2017,7,0,0,7,100.0
240990,2018,3,0,0,3,100.0
240990,2019,5,0,0,5,100.0
240990,2020,8,0,0,8,100.0
241000,2012,2,0,0,2,100.0
241000,2015,0,0,4,4,0.0
241000,2016,0,0,1,1,0.0
241000,2018,0,0,1,1,0.0
241000,2020,1,0,0,1,100.0
241010,2012,1,0,2,3,33.33333333333333
241010,2013,6,0,0,6,100.0
241010,2014,4,0,0,4,100.0
241010,2015,4,0,0,4,100.0
241010,2016,4,0,0,4,100.0
241010,2017,4,0,1,5,80.0
241010,2018,5,0,0,5,100.0
241010,2019,2,0,0,2,100.0
241010,2020,6,0,0,6,100.0
241020,2012,1,0,0,1,100.0
241020,2013,4,0,1,5,80.0
241020,2014,4,0,0,4,100.0
241020,2017,3,0,0,3,100.0
241020,2018,2,0,0,2,100.0
241020,2019,3,0,0,3,100.0
241020,2020,2,0,0,2,100.0
241025,2012,0,0,2,2,0.0
241025,2013,1,0,1,2,50.0
241025,2015,0,0,3,3,0.0
241025,2016,0,0,2,2,0.0
241025,2018,0,0,1,1,0.0
241025,2019,0,0,1,1,0.0
241030,2012,1,0,0,1,100.0
241030,2013,1,0,0,1,100.0
241030,2014,1,0,0,1,100.0
241030,2015,1,0,0,1,100.0
241030,2016,3,0,0,3,100.0
241030,2017,2,0,1,3,66.66666666666666
241030,2018,0,0,3,3,0.0
241030,2019,1,0,2,3,33.33333333333333
241030,2020,4,0,0,4,100.0
241040,2012,0,0,2,2,0.0
241040,2013,2,0,0,2,100.0
241040,2014,3,0,1,4,75.0
241040,2015,1,0,0,1,100.0
241040,2016,5,0,0,5,100.0
241040,2017,3,0,0,3,100.0
241040,2018,4,0,0,4,100.0
241040,2020,3,0,0,3,100.0
241050,2012,0,0,3,3,0.0
241050,2013,1,0,0,1,100.0
241050,2014,2,0,1,3,66.66666666666666
241050,2015,0,0,1,1,0.0
241050,2016,2,0,0,2,100.0
241050,2018,1,0,1,2,50.0
241050,2020,1,0,1,2,50.0
241060,2012,1,0,0,1,100.0
241060,2013,1,0,2,3,33.33333333333333
241060,2016,0,0,2,2,0.0
241060,2017,1,0,0,1,100.0
241070,2012,1,0,0,1,100.0
241070,2013,6,0,0,6,100.0
241070,2014,1,0,0,1,100.0
241070,2015,3,0,0,3,100.0
241070,2016,0,0,1,1,0.0
241070,2017,1,0,0,1,100.0
241070,2020,1,0,1,2,50.0
241080,2013,1,0,0,1,100.0
241080,2015,3,0,1,4,75.0
241080,2017,1,0,0,1,100.0
241090,2012,0,0,3,3,0.0
241090,2013,3,0,0,3,100.0
241090,2014,3,0,0,3,100.0
241090,2015,2,0,0,2,100.0
241090,2016,1,0,0,1,100.0
241090,2017,4,0,0,4,100.0
241090,2018,2,0,0,2,100.0
241090,2019,1,0,0,1,100.0
241090,2020,3,0,0,3,100.0
241100,2012,2,0,0,2,100.0
241100,2013,1,0,0,1,100.0
241100,2014,1,0,0,1,100.0
241100,2015,2,0,0,2,100.0
241100,2016,1,0,0,1,100.0
241100,2019,1,0,0,1,100.0
241100,2020,1,0,0,1,100.0
241105,2012,0,0,4,4,0.0
241105,2014,0,0,3,3,0.0
241105,2015,0,0,2,2,0.0
241105,2016,1,0,2,3,33.33333333333333
241105,2017,0,0,1,1,0.0
241105,2018,0,0,2,2,0.0
241105,2019,0,1,2,3,33.33333333333333
241105,2020,0,0,2,2,0.0
241110,2012,1,0,0,1,100.0
241110,2014,1,0,0,1,100.0
241110,2015,0,0,1,1,0.0
241110,2016,1,0,0,1,100.0
241110,2018,0,0,1,1,0.0
241120,2012,9,0,0,9,100.0
241120,2013,9,0,3,12,75.0
241120,2014,12,0,0,12,100.0
241120,2015,7,0,2,9,77.77777777777779
241120,2016,13,0,7,20,65.0
241120,2017,6,0,0,6,100.0
241120,2018,6,0,0,6,100.0
241120,2019,8,0,4,12,66.66666666666666
241120,2020,11,0,4,15,73.33333333333333
241140,2012,5,0,0,5,100.0
241140,2013,5,0,0,5,100.0
241140,2014,3,0,0,3,100.0
241140,2015,4,0,0,4,100.0
241140,2016,0,0,3,3,0.0
241140,2017,0,0,3,3,0.0
241140,2018,4,0,0,4,100.0
241140,2019,4,0,0,4,100.0
241140,2020,4,0,0,4,100.0
241142,2013,3,0,0,3,100.0
241142,2019,1,0,0,1,100.0
241150,2012,4,0,0,4,100.0
241150,2013,8,0,0,8,100.0
241150,2014,5,0,0,5,100.0
241150,2015,9,0,0,9,100.0
241150,2016,6,0,0,6,100.0
241150,2017,3,0,0,3,100.0
241150,2018,5,0,0,5,100.0
241150,2019,9,0,1,10,90.0
241150,2020,7,0,1,8,87.5
241160,2013,0,0,1,1,0.0
241160,2015,0,0,1,1,0.0
241160,2017,1,0,0,1,100.0
241160,2018,1,0,0,1,100.0
241160,2020,1,0,0,1,100.0
241170,2012,0,0,1,1,0.0
241170,2015,0,0,2,2,0.0
241170,2016,0,0,1,1,0.0
241170,2017,1,0,0,1,100.0
241170,2018,0,0,2,2,0.0
241170,2020,2,0,0,2,100.0
241180,2014,1,0,0,1,100.0
241180,2018,0,0,1,1,0.0
241180,2019,0,0,2,2,0.0
241180,2020,1,1,1,3,66.66666666666666
241190,2012,1,0,0,1,100.0
241190,2013,0,0,1,1,0.0
241190,2014,3,0,0,3,100.0
241190,2015,1,0,0,1,100.0
241190,2016,2,0,1,3,66.66666666666666
241190,2017,1,0,0,1,100.0
241190,2018,1,0,0,1,100.0
241190,2019,1,0,0,1,100.0
241190,2020,2,0,0,2,100.0
241200,2012,11,0,8,19,57.89473684210527
241200,2013,7,0,15,22,31.818181818181817
241200,2014,32,0,6,38,84.21052631578947
241200,2015,29,0,7,36,80.55555555555556
241200,2016,21,1,11,33,66.66666666666666
241200,2017,16,2,15,33,54.54545454545454
241200,2018,21,0,13,34,61.76470588235294
241200,2019,12,1,14,27,48.148148148148145
241200,2020,17,3,21,41,48.78048780487805
241210,2012,1,0,0,1,100.0
241210,2013,1,0,0,1,100.0
241210,2014,4,0,0,4,100.0
241210,2015,2,0,0,2,100.0
241210,2016,3,1,0,4,100.0
241210,2017,2,0,0,2,100.0
241210,2018,1,0,0,1,100.0
241210,2019,1,0,0,1,100.0
241210,2020,0,0,1,1,0.0
241220,2012,16,0,0,16,100.0
241220,2013,10,0,0,10,100.0
241220,2014,19,0,0,19,100.0
241220,2015,17,0,0,17,100.0
241220,2016,12,0,0,12,100.0
241220,2017,13,0,0,13,100.0
241220,2018,16,0,0,16,100.0
241220,2019,17,0,2,19,89.47368421052632
241220,2020,19,0,0,19,100.0
241230,2012,2,0,0,2,100.0
241230,2013,1,0,0,1,100.0
241230,2014,5,0,0,5,100.0
241230,2015,2,0,0,2,100.0
241230,2016,1,0,0,1,100.0
241230,2017,2,0,0,2,100.0
241230,2018,6,0,2,8,75.0
241230,2019,2,0,0,2,100.0
241230,2020,3,0,0,3,100.0
241240,2012,2,0,0,2,100.0
241240,2013,4,0,0,4,100.0
241240,2014,1,0,0,1,100.0
241240,2018,2,0,0,2,100.0
241240,2019,2,0,0,2,100.0
241240,2020,7,0,0,7,100.0
241250,2012,4,3,2,9,77.77777777777779
241250,2013,9,0,0,9,100.0
241250,2014,2,0,3,5,40.0
241250,2015,8,0,0,8,100.0
241250,2016,2,1,10,13,23.076923076923077
241250,2017,10,0,0,10,100.0
241250,2018,5,0,1,6,83.33333333333334
241250,2019,11,0,0,11,100.0
241250,2020,4,0,1,5,80.0
241255,2012,1,0,0,1,100.0
241255,2013,2,0,0,2,100.0
241255,2014,3,0,0,3,100.0
241255,2015,2,0,0,2,100.0
241255,2016,1,0,0,1,100.0
241255,2017,2,0,0,2,100.0
241255,2018,3,0,0,3,100.0
241255,2019,2,0,0,2,100.0
241255,2020,1,0,0,1,100.0
241260,2012,5,0,0,5,100.0
241260,2013,2,0,0,2,100.0
241260,2014,7,0,0,7,100.0
241260,2015,3,0,0,3,100.0
241260,2016,3,0,0,3,100.0
241260,2017,4,0,0,4,100.0
241260,2018,9,0,0,9,100.0
241260,2019,7,0,0,7,100.0
241260,2020,1,0,0,1,100.0
241270,2013,1,0,0,1,100.0
241270,2014,2,0,0,2,100.0
241270,2016,1,0,1,2,50.0
241270,2017,0,0,1,1,0.0
241270,2018,0,0,1,1,0.0
241270,2020,3,0,0,3,100.0
241280,2012,1,0,0,1,100.0
241280,2013,0,0,1,1,0.0
241280,2014,3,0,0,3,100.0
241280,2015,1,0,0,1,100.0
241280,2016,2,0,2,4,50.0
241280,2017,3,0,0,3,100.0
241280,2018,1,0,0,1,100.0
241280,2019,0,0,1,1,0.0
241280,2020,2,0,0,2,100.0
241290,2012,2,0,2,4,50.0
241290,2013,5,0,0,5,100.0
241290,2014,1,0,2,3,33.33333333333333
241290,2015,0,0,4,4,0.0
241290,2016,6,0,0,6,100.0
241290,2017,5,0,0,5,100.0
241290,2018,2,0,2,4,50.0
241290,2019,2,0,0,2,100.0
241290,2020,1,0,0,1,100.0
241300,2012,2,0,0,2,100.0
241300,2013,1,0,0,1,100.0
241300,2014,1,0,1,2,50.0
241300,2015,2,0,0,2,100.0
241300,2016,2,0,0,2,100.0
241300,2017,6,0,0,6,100.0
241300,2019,1,0,0,1,100.0
241310,2012,2,0,0,2,100.0
241310,2013,2,0,0,2,100.0
241310,2014,2,0,0,2,100.0
241310,2015,3,0,0,3,100.0
241310,2016,2,0,0,2,100.0
241310,2017,3,0,0,3,100.0
241310,2018,2,0,0,2,100.0
241310,2019,2,0,0,2,100.0
241310,2020,3,0,0,3,100.0
241320,2012,1,0,0,1,100.0
241320,2013,0,0,1,1,0.0
241320,2016,1,0,0,1,100.0
241320,2018,1,0,0,1,100.0
241320,2019,1,0,2,3,33.33333333333333
241320,2020,1,0,0,1,100.0
241330,2012,4,0,0,4,100.0
241330,2013,2,0,0,2,100.0
241330,2014,2,0,0,2,100.0
241330,2015,1,0,0,1,100.0
241330,2016,2,0,0,2,100.0
241330,2018,1,0,0,1,100.0
241330,2019,3,0,0,3,100.0
241330,2020,1,0,0,1,100.0
241335,2012,1,1,2,4,50.0
241335,2013,1,0,1,2,50.0
241335,2014,0,0,1,1,0.0
241335,2015,0,0,2,2,0.0
241335,2016,0,0,3,3,0.0
241335,2017,0,0,5,5,0.0
241335,2019,0,1,2,3,33.33333333333333
241335,2020,0,1,3,4,25.0
241340,2012,1,0,0,1,100.0
241340,2013,2,0,0,2,100.0
241340,2014,3,0,0,3,100.0
241340,2015,2,0,0,2,100.0
241340,2016,2,0,1,3,66.66666666666666
241340,2017,0,0,1,1,0.0
241340,2018,1,0,1,2,50.0
241340,2019,1,1,1,3,66.66666666666666
241340,2020,3,0,0,3,100.0
241350,2013,1,0,0,1,100.0
241350,2014,2,0,0,2,100.0
241350,2015,2,0,0,2,100.0
241350,2017,1,0,0,1,100.0
241350,2019,1,0,0,1,100.0
241350,2020,1,0,0,1,100.0
241355,2012,1,0,1,2,50.0
241355,2013,2,0,0,2,100.0
241355,2014,2,0,0,2,100.0
241355,2015,1,0,0,1,100.0
241355,2017,1,0,0,1,100.0
241355,2018,1,0,0,1,100.0
241355,2019,2,0,0,2,100.0
241355,2020,1,0,0,1,100.0
241360,2012,0,0,2,2,0.0
241360,2014,1,0,0,1,100.0
241360,2016,1,0,0,1,100.0
241360,2017,2,0,0,2,100.0
241360,2018,4,0,0,4,100.0
241360,2019,3,0,0,3,100.0
241360,2020,3,0,0,3,100.0
241370,2013,1,0,0,1,100.0
241370,2014,2,0,0,2,100.0
241370,2015,3,0,0,3,100.0
241370,2016,1,0,0,1,100.0
241370,2017,2,0,0,2,100.0
241380,2018,0,0,1,1,0.0
241390,2012,3,0,0,3,100.0
241390,2013,2,0,0,2,100.0
241390,2014,2,0,0,2,100.0
241390,2015,3,0,0,3,100.0
241390,2016,4,0,0,4,100.0
241390,2017,3,0,0,3,100.0
241390,2018,1,0,0,1,100.0
241390,2019,3,0,0,3,100.0
241390,2020,5,0,0,5,100.0
241400,2012,3,0,1,4,75.0
241400,2013,1,0,0,1,100.0
241400,2014,3,0,0,3,100.0
241400,2015,11,0,1,12,91.66666666666666
241400,2016,4,0,0,4,100.0
241400,2017,3,0,1,4,75.0
241400,2018,1,0,0,1,100.0
241400,2019,1,1,1,3,66.66666666666666
241400,2020,4,1,2,7,71.42857142857143
241410,2012,1,0,1,2,50.0
241410,2013,3,0,2,5,60.0
241410,2014,1,0,0,1,100.0
241410,2015,4,0,0,4,100.0
241410,2016,5,0,0,5,100.0
241410,2017,2,0,0,2,100.0
241410,2018,3,0,0,3,100.0
241410,2019,2,0,0,2,100.0
241410,2020,3,0,2,5,60.0
241415,2012,1,0,0,1,100.0
241415,2013,1,0,0,1,100.0
241415,2014,1,0,0,1,100.0
241415,2015,1,0,0,1,100.0
241415,2016,2,0,0,2,100.0
241415,2017,2,0,0,2,100.0
241415,2018,1,0,0,1,100.0
241415,2019,2,0,0,2,100.0
241415,2020,2,0,0,2,100.0
241420,2012,4,0,0,4,100.0
241420,2013,3,0,0,3,100.0
241420,2014,1,1,4,6,33.33333333333333
241420,2015,5,0,0,5,100.0
241420,2016,5,0,1,6,83.33333333333334
241420,2017,5,0,1,6,83.33333333333334
241420,2018,3,0,0,3,100.0
241420,2019,4,0,0,4,100.0
241420,2020,4,0,0,4,100.0
241430,2012,1,0,0,1,100.0
241430,2014,1,0,0,1,100.0
241430,2019,1,0,0,1,100.0
241430,2020,1,0,0,1,100.0
241440,2012,8,0,0,8,100.0
241440,2013,2,0,0,2,100.0
241440,2014,2,0,0,2,100.0
241440,2015,8,0,1,9,88.88888888888889
241440,2016,8,0,0,8,100.0
241440,2017,8,0,0,8,100.0
241440,2018,9,0,0,9,100.0
241440,2019,14,0,0,14,100.0
241440,2020,13,0,0,13,100.0
241445,2013,0,0,1,1,0.0
241445,2014,0,0,1,1,0.0
241445,2015,0,0,1,1,0.0
241445,2016,1,0,0,1,100.0
241445,2017,0,0,2,2,0.0
241445,2019,0,1,0,1,100.0
241445,2020,2,0,0,2,100.0
241450,2013,5,0,1,6,83.33333333333334
241450,2014,7,0,0,7,100.0
241450,2015,2,0,0,2,100.0
241450,2016,0,0,1,1,0.0
241450,2017,0,0,3,3,0.0
241450,2018,0,0,5,5,0.0
241450,2019,3,0,0,3,100.0
241450,2020,7,0,0,7,100.0
241460,2012,1,0,0,1,100.0
241460,2013,2,0,1,3,66.66666666666666
241460,2014,3,0,0,3,100.0
241460,2015,4,0,0,4,100.0
241460,2016,2,0,0,2,100.0
241460,2017,2,0,0,2,100.0
241460,2018,4,0,1,5,80.0
241460,2019,4,0,0,4,100.0
241460,2020,1,0,1,2,50.0
241470,2012,0,0,1,1,0.0
241470,2014,1,0,0,1,100.0
241470,2016,2,0,0,2,100.0
241470,2017,2,0,0,2,100.0
241470,2018,2,0,0,2,100.0
241470,2020,1,0,0,1,100.0
241475,2017,1,0,0,1,100.0
241475,2019,3,0,0,3,100.0
241480,2012,0,0,2,2,0.0
241480,2013,3,1,0,4,100.0
241480,2014,2,0,0,2,100.0
241480,2015,0,0,2,2,0.0
241480,2016,0,0,2,2,0.0
241480,2017,6,0,0,6,100.0
241480,2018,2,0,4,6,33.33333333333333
241480,2019,4,0,0,4,100.0
241480,2020,6,0,0,6,100.0
241490,2013,1,0,0,1,100.0
241490,2014,1,0,0,1,100.0
241490,2016,1,0,0,1,100.0
241490,2017,1,0,0,1,100.0
241490,2020,3,0,0,3,100.0
241500,2013,3,0,0,3,100.0
241500,2014,1,0,0,1,100.0
241500,2019,3,0,0,3,100.0
250000,2012,0,1,0,1,100.0
250000,2013,0,1,0,1,100.0
250000,2014,1,0,1,2,50.0
250000,2019,0,0,2,2,0.0
250000,2020,0,0,3,3,0.0
250010,2012,2,0,0,2,100.0
250010,2013,5,0,0,5,100.0
250010,2014,7,0,0,7,100.0
250010,2015,2,0,0,2,100.0
250010,2016,4,0,0,4,100.0
250010,2018,1,0,0,1,100.0
250010,2019,1,0,0,1,100.0
250010,2020,6,0,0,6,100.0
250020,2012,0,1,1,2,50.0
250020,2014,1,0,0,1,100.0
250020,2015,1,0,0,1,100.0
250020,2016,1,0,0,1,100.0
250020,2017,2,0,0,2,100.0
250020,2018,1,0,0,1,100.0
250020,2019,2,0,0,2,100.0
250020,2020,2,0,0,2,100.0
250030,2012,7,0,0,7,100.0
250030,2013,5,0,0,5,100.0
250030,2014,12,0,0,12,100.0
250030,2015,11,0,0,11,100.0
250030,2016,10,0,0,10,100.0
250030,2017,4,0,0,4,100.0
250030,2018,6,0,0,6,100.0
250030,2019,13,0,0,13,100.0
250030,2020,9,0,0,9,100.0
250040,2012,6,0,0,6,100.0
250040,2013,8,1,0,9,100.0
250040,2014,9,0,0,9,100.0
250040,2015,11,0,0,11,100.0
250040,2016,10,0,0,10,100.0
250040,2017,5,0,0,5,100.0
250040,2018,6,1,0,7,100.0
250040,2019,6,0,0,6,100.0
250040,2020,10,0,0,10,100.0
250050,2012,2,0,0,2,100.0
250050,2013,6,0,0,6,100.0
250050,2014,4,0,0,4,100.0
250050,2015,11,0,0,11,100.0
250050,2016,4,0,0,4,100.0
250050,2017,3,0,0,3,100.0
250050,2018,6,0,0,6,100.0
250050,2019,3,0,0,3,100.0
250050,2020,5,0,0,5,100.0
250053,2012,2,0,0,2,100.0
250053,2013,2,0,0,2,100.0
250053,2015,2,0,0,2,100.0
250053,2016,1,0,0,1,100.0
250053,2017,2,0,0,2,100.0
250053,2019,6,0,0,6,100.0
250053,2020,2,0,0,2,100.0
250057,2013,0,0,1,1,0.0
250057,2017,1,0,0,1,100.0
250057,2018,0,0,1,1,0.0
250060,2012,9,0,0,9,100.0
250060,2013,11,0,0,11,100.0
250060,2014,14,0,0,14,100.0
250060,2015,13,0,0,13,100.0
250060,2016,7,0,0,7,100.0
250060,2017,9,0,0,9,100.0
250060,2018,4,0,0,4,100.0
250060,2019,5,0,1,6,83.33333333333334
250060,2020,6,0,0,6,100.0
250070,2012,3,0,3,6,50.0
250070,2013,2,0,2,4,50.0
250070,2014,2,0,0,2,100.0
250070,2015,10,0,0,10,100.0
250070,2016,5,0,0,5,100.0
250070,2017,3,0,0,3,100.0
250070,2018,2,0,0,2,100.0
250070,2019,5,0,0,5,100.0
250070,2020,3,0,1,4,75.0
250073,2012,0,0,2,2,0.0
250073,2013,0,0,1,1,0.0
250073,2016,2,0,0,2,100.0
250073,2019,0,0,1,1,0.0
250073,2020,2,0,0,2,100.0
250077,2012,3,0,0,3,100.0
250077,2013,1,0,0,1,100.0
250077,2014,3,0,0,3,100.0
250077,2015,1,0,0,1,100.0
250077,2016,1,0,0,1,100.0
250077,2017,2,0,0,2,100.0
250077,2018,4,0,0,4,100.0
250077,2019,2,0,0,2,100.0
250077,2020,2,0,0,2,100.0
250080,2012,5,0,0,5,100.0
250080,2013,0,1,0,1,100.0
250080,2014,6,0,0,6,100.0
250080,2015,5,0,0,5,100.0
250080,2016,9,0,0,9,100.0
250080,2017,3,0,0,3,100.0
250080,2018,5,0,0,5,100.0
250080,2019,0,2,4,6,33.33333333333333
250080,2020,1,3,3,7,57.14285714285714
250090,2012,2,0,0,2,100.0
250090,2013,9,0,0,9,100.0
250090,2014,3,0,0,3,100.0
250090,2015,3,0,0,3,100.0
250090,2016,8,0,0,8,100.0
250090,2017,3,0,1,4,75.0
250090,2018,2,0,0,2,100.0
250090,2019,3,0,0,3,100.0
250090,2020,7,0,0,7,100.0
250100,2012,1,1,3,5,40.0
250100,2013,2,0,3,5,40.0
250100,2014,1,0,0,1,100.0
250100,2015,4,0,0,4,100.0
250100,2016,7,0,0,7,100.0
250100,2017,10,0,0,10,100.0
250100,2018,9,0,0,9,100.0
250100,2019,7,0,0,7,100.0
250100,2020,9,0,0,9,100.0
250110,2012,12,0,3,15,80.0
250110,2013,0,1,7,8,12.5
250110,2014,4,0,0,4,100.0
250110,2015,10,0,0,10,100.0
250110,2016,8,0,0,8,100.0
250110,2017,5,0,0,5,100.0
250110,2018,4,0,0,4,100.0
250110,2019,7,0,0,7,100.0
250110,2020,3,0,0,3,100.0
250115,2012,0,0,1,1,0.0
250115,2013,0,0,2,2,0.0
250115,2018,0,0,2,2,0.0
250120,2012,6,0,0,6,100.0
250120,2013,5,0,0,5,100.0
250120,2014,2,0,0,2,100.0
250120,2015,0,0,2,2,0.0
250120,2016,3,0,0,3,100.0
250120,2017,1,0,0,1,100.0
250120,2019,2,0,0,2,100.0
250120,2020,2,0,0,2,100.0
250130,2012,3,1,3,7,57.14285714285714
250130,2013,3,2,3,8,62.5
250130,2014,5,0,0,5,100.0
250130,2015,7,0,0,7,100.0
250130,2016,6,0,0,6,100.0
250130,2017,11,0,0,11,100.0
250130,2018,5,0,0,5,100.0
250130,2019,6,0,0,6,100.0
250130,2020,3,0,0,3,100.0
250135,2012,0,0,1,1,0.0
250135,2013,2,0,0,2,100.0
250135,2014,5,0,0,5,100.0
250135,2015,1,0,0,1,100.0
250135,2016,1,0,0,1,100.0
250135,2017,1,0,0,1,100.0
250135,2019,3,0,0,3,100.0
250135,2020,1,0,0,1,100.0
250140,2012,0,2,0,2,100.0
250140,2013,1,1,2,4,50.0
250140,2014,2,1,1,4,75.0
250140,2015,1,0,0,1,100.0
250140,2016,1,0,0,1,100.0
250140,2017,5,0,0,5,100.0
250140,2018,1,0,0,1,100.0
250140,2019,1,0,1,2,50.0
250140,2020,2,0,1,3,66.66666666666666
250150,2012,6,0,0,6,100.0
250150,2013,9,0,0,9,100.0
250150,2014,1,0,0,1,100.0
250150,2015,2,0,0,2,100.0
250150,2016,4,0,0,4,100.0
250150,2017,5,0,0,5,100.0
250150,2018,6,0,0,6,100.0
250150,2019,8,0,0,8,100.0
250150,2020,1,0,0,1,100.0
250153,2015,1,0,0,1,100.0
250153,2017,5,0,0,5,100.0
250153,2018,1,0,0,1,100.0
250153,2019,2,0,0,2,100.0
250153,2020,1,0,0,1,100.0
250157,2012,2,0,0,2,100.0
250157,2013,3,0,0,3,100.0
250157,2015,1,0,0,1,100.0
250157,2016,2,0,0,2,100.0
250157,2017,3,0,0,3,100.0
250157,2018,2,0,0,2,100.0
250157,2019,2,0,0,2,100.0
250157,2020,1,0,0,1,100.0
250160,2012,7,0,0,7,100.0
250160,2013,2,0,0,2,100.0
250160,2014,3,0,0,3,100.0
250160,2015,2,0,0,2,100.0
250160,2016,4,1,0,5,100.0
250160,2018,3,0,0,3,100.0
250160,2019,3,0,0,3,100.0
250160,2020,4,0,0,4,100.0
250170,2012,0,0,1,1,0.0
250170,2013,0,0,2,2,0.0
250170,2014,1,0,2,3,33.33333333333333
250170,2015,3,0,0,3,100.0
250170,2016,0,0,1,1,0.0
250170,2017,3,0,0,3,100.0
250170,2018,1,0,0,1,100.0
250170,2019,2,0,0,2,100.0
250170,2020,4,0,0,4,100.0
250180,2012,48,0,1,49,97.95918367346938
250180,2013,37,0,0,37,100.0
250180,2014,36,0,0,36,100.0
250180,2015,36,0,0,36,100.0
250180,2016,36,1,6,43,86.04651162790698
250180,2017,34,0,0,34,100.0
250180,2018,34,0,1,35,97.14285714285714
250180,2019,38,0,3,41,92.6829268292683
250180,2020,43,0,0,43,100.0
250190,2012,2,0,0,2,100.0
250190,2013,4,0,0,4,100.0
250190,2014,3,0,0,3,100.0
250190,2015,3,0,0,3,100.0
250190,2016,4,0,0,4,100.0
250190,2017,6,0,0,6,100.0
250190,2018,6,0,0,6,100.0
250190,2019,7,0,0,7,100.0
250190,2020,2,0,2,4,50.0
250200,2013,0,1,2,3,33.33333333333333
250200,2014,3,0,0,3,100.0
250200,2015,2,0,0,2,100.0
250200,2016,1,0,0,1,100.0
250200,2017,2,0,0,2,100.0
250200,2018,3,0,0,3,100.0
250200,2019,1,0,0,1,100.0
250200,2020,3,0,0,3,100.0
250205,2012,0,0,1,1,0.0
250205,2013,3,0,0,3,100.0
250205,2015,2,0,0,2,100.0
250205,2016,2,0,0,2,100.0
250205,2017,3,0,0,3,100.0
250205,2018,1,0,0,1,100.0
250205,2019,2,0,0,2,100.0
250205,2020,1,0,0,1,100.0
250210,2012,0,0,1,1,0.0
250210,2016,1,0,0,1,100.0
250210,2018,1,0,1,2,50.0
250210,2019,1,0,0,1,100.0
250210,2020,2,0,0,2,100.0
250215,2013,3,0,0,3,100.0
250215,2015,1,0,0,1,100.0
250215,2016,3,0,0,3,100.0
250215,2017,1,0,0,1,100.0
250215,2020,1,0,0,1,100.0
250220,2012,1,0,0,1,100.0
250220,2013,2,0,0,2,100.0
250220,2015,1,0,0,1,100.0
250220,2017,2,0,0,2,100.0
250220,2018,1,0,0,1,100.0
250220,2019,1,0,0,1,100.0
250230,2013,0,0,2,2,0.0
250230,2015,1,0,0,1,100.0
250230,2017,2,0,0,2,100.0
250230,2018,2,0,0,2,100.0
250230,2019,2,0,0,2,100.0
250230,2020,4,0,0,4,100.0
250240,2012,5,0,1,6,83.33333333333334
250240,2013,3,0,0,3,100.0
250240,2014,3,0,0,3,100.0
250240,2015,5,0,0,5,100.0
250240,2016,5,0,2,7,71.42857142857143
250240,2017,0,0,5,5,0.0
250240,2018,1,2,3,6,50.0
250240,2019,0,0,2,2,0.0
250240,2020,4,0,0,4,100.0
250250,2012,6,0,0,6,100.0
250250,2013,2,0,0,2,100.0
250250,2014,6,0,0,6,100.0
250250,2015,4,0,0,4,100.0
250250,2016,3,0,0,3,100.0
250250,2017,7,0,0,7,100.0
250250,2018,6,0,0,6,100.0
250250,2019,9,0,0,9,100.0
250250,2020,11,0,0,11,100.0
250260,2012,0,0,2,2,0.0
250260,2013,0,0,2,2,0.0
250260,2014,1,0,0,1,100.0
250260,2015,1,0,1,2,50.0
250260,2016,1,0,0,1,100.0
250260,2017,1,0,0,1,100.0
250260,2018,4,0,0,4,100.0
250260,2020,1,0,0,1,100.0
250270,2012,0,0,1,1,0.0
250270,2014,3,0,0,3,100.0
250270,2016,2,0,0,2,100.0
250270,2017,1,0,0,1,100.0
250270,2019,1,0,0,1,100.0
250270,2020,1,0,0,1,100.0
250280,2012,3,0,1,4,75.0
250280,2013,2,0,0,2,100.0
250280,2014,4,0,0,4,100.0
250280,2015,4,0,0,4,100.0
250280,2016,6,0,0,6,100.0
250280,2017,3,0,0,3,100.0
250280,2018,6,0,0,6,100.0
250280,2019,7,0,0,7,100.0
250280,2020,7,0,0,7,100.0
250290,2012,0,0,2,2,0.0
250290,2014,1,0,1,2,50.0
250290,2015,1,0,0,1,100.0
250290,2016,1,0,1,2,50.0
250290,2017,1,0,1,2,50.0
250290,2018,1,0,1,2,50.0
250290,2019,3,0,0,3,100.0
250290,2020,2,0,2,4,50.0
250300,2012,14,0,0,14,100.0
250300,2013,3,0,0,3,100.0
250300,2014,7,0,0,7,100.0
250300,2015,9,0,0,9,100.0
250300,2016,3,0,0,3,100.0
250300,2017,7,0,0,7,100.0
250300,2018,6,0,0,6,100.0
250300,2019,7,0,0,7,100.0
250300,2020,9,0,0,9,100.0
250310,2013,0,1,0,1,100.0
250310,2015,2,0,0,2,100.0
250310,2016,1,0,0,1,100.0
250310,2017,1,0,0,1,100.0
250310,2018,1,0,0,1,100.0
250310,2019,2,0,0,2,100.0
250310,2020,1,0,0,1,100.0
250320,2012,26,0,0,26,100.0
250320,2013,17,0,0,17,100.0
250320,2014,13,0,0,13,100.0
250320,2015,19,0,0,19,100.0
250320,2016,29,0,0,29,100.0
250320,2017,29,0,0,29,100.0
250320,2018,23,0,0,23,100.0
250320,2019,25,1,0,26,100.0
250320,2020,24,0,0,24,100.0
250330,2012,4,0,0,4,100.0
250330,2014,1,0,0,1,100.0
250330,2015,6,0,0,6,100.0
250330,2016,2,0,2,4,50.0
250330,2017,4,0,0,4,100.0
250330,2018,5,0,0,5,100.0
250330,2019,4,0,0,4,100.0
250330,2020,3,0,0,3,100.0
250340,2012,0,0,2,2,0.0
250340,2014,2,0,0,2,100.0
250340,2015,1,0,0,1,100.0
250340,2016,0,0,2,2,0.0
250340,2017,2,0,1,3,66.66666666666666
250340,2020,0,0,1,1,0.0
250350,2012,3,1,1,5,80.0
250350,2013,6,0,0,6,100.0
250350,2014,4,0,0,4,100.0
250350,2015,6,0,0,6,100.0
250350,2016,1,0,0,1,100.0
250350,2017,3,0,0,3,100.0
250350,2018,5,0,1,6,83.33333333333334
250350,2019,7,0,0,7,100.0
250350,2020,4,0,0,4,100.0
250355,2012,6,0,0,6,100.0
250355,2013,1,0,0,1,100.0
250355,2014,4,0,0,4,100.0
250355,2015,2,0,2,4,50.0
250355,2016,5,0,0,5,100.0
250355,2017,3,0,0,3,100.0
250355,2018,2,0,0,2,100.0
250355,2019,1,0,0,1,100.0
250355,2020,6,0,0,6,100.0
250360,2012,0,3,1,4,75.0
250360,2013,0,2,2,4,50.0
250360,2014,3,0,0,3,100.0
250360,2015,4,0,0,4,100.0
250360,2016,6,0,0,6,100.0
250360,2017,5,0,0,5,100.0
250360,2018,3,0,0,3,100.0
250360,2019,1,0,0,1,100.0
250360,2020,2,0,0,2,100.0
250370,2012,13,0,2,15,86.66666666666667
250370,2013,22,0,0,22,100.0
250370,2014,18,0,1,19,94.73684210526315
250370,2015,19,1,0,20,100.0
250370,2016,18,0,1,19,94.73684210526315
250370,2017,19,0,2,21,90.47619047619048
250370,2018,20,0,0,20,100.0
250370,2019,16,0,6,22,72.72727272727273
250370,2020,28,0,0,28,100.0
250375,2013,1,0,0,1,100.0
250375,2014,1,0,0,1,100.0
250375,2015,2,0,0,2,100.0
250375,2018,2,0,0,2,100.0
250375,2020,2,0,0,2,100.0
250380,2012,2,1,0,3,100.0
250380,2013,2,0,0,2,100.0
250380,2014,1,0,0,1,100.0
250380,2015,1,0,0,1,100.0
250380,2016,4,0,0,4,100.0
250380,2017,2,0,0,2,100.0
250380,2018,2,0,0,2,100.0
250380,2019,3,0,0,3,100.0
250380,2020,3,0,0,3,100.0
250390,2012,0,0,1,1,0.0
250390,2013,1,0,0,1,100.0
250390,2014,2,0,0,2,100.0
250390,2015,2,0,1,3,66.66666666666666
250390,2016,3,0,1,4,75.0
250390,2017,2,0,0,2,100.0
250390,2018,1,0,0,1,100.0
250390,2019,0,0,2,2,0.0
250390,2020,3,0,0,3,100.0
250400,2012,150,0,0,150,100.0
250400,2013,183,0,0,183,100.0
250400,2014,132,0,0,132,100.0
250400,2015,124,0,0,124,100.0
250400,2016,139,0,0,139,100.0
250400,2017,136,0,0,136,100.0
250400,2018,136,0,0,136,100.0
250400,2019,139,0,0,139,100.0
250400,2020,145,0,0,145,100.0
250403,2012,0,1,0,1,100.0
250403,2013,1,0,0,1,100.0
250403,2014,2,0,0,2,100.0
250403,2015,1,0,0,1,100.0
250403,2016,2,0,0,2,100.0
250403,2017,2,0,0,2,100.0
250403,2018,3,0,0,3,100.0
250403,2019,4,0,0,4,100.0
250403,2020,3,0,0,3,100.0
250407,2012,0,0,2,2,0.0
250407,2016,0,0,3,3,0.0
250407,2019,0,0,1,1,0.0
250407,2020,1,0,1,2,50.0
250410,2014,1,0,1,2,50.0
250410,2015,1,0,0,1,100.0
250410,2017,1,0,0,1,100.0
250415,2012,2,0,0,2,100.0
250415,2013,2,0,0,2,100.0
250415,2014,2,0,0,2,100.0
250415,2015,2,0,0,2,100.0
250415,2016,2,0,1,3,66.66666666666666
250415,2017,3,0,0,3,100.0
250415,2018,1,0,0,1,100.0
250415,2019,1,0,1,2,50.0
250415,2020,0,1,1,2,50.0
250420,2013,2,0,0,2,100.0
250420,2014,1,0,0,1,100.0
250420,2015,1,0,0,1,100.0
250420,2017,2,0,0,2,100.0
250420,2018,1,0,0,1,100.0
250420,2019,1,0,0,1,100.0
250420,2020,2,0,0,2,100.0
250430,2012,12,0,0,12,100.0
250430,2013,4,0,0,4,100.0
250430,2014,10,0,0,10,100.0
250430,2015,10,0,0,10,100.0
250430,2016,10,0,0,10,100.0
250430,2017,9,0,0,9,100.0
250430,2018,12,0,0,12,100.0
250430,2019,8,0,0,8,100.0
250430,2020,12,0,0,12,100.0
250435,2013,1,0,0,1,100.0
250435,2016,5,0,0,5,100.0
250435,2017,1,0,0,1,100.0
250435,2018,2,0,0,2,100.0
250435,2020,1,0,0,1,100.0
250440,2012,4,0,1,5,80.0
250440,2013,6,0,0,6,100.0
250440,2014,5,0,0,5,100.0
250440,2015,4,1,3,8,62.5
250440,2016,2,0,3,5,40.0
250440,2017,7,0,0,7,100.0
250440,2018,2,0,0,2,100.0
250440,2019,0,0,6,6,0.0
250440,2020,0,0,7,7,0.0
250450,2012,1,0,2,3,33.33333333333333
250450,2013,1,0,1,2,50.0
250450,2015,3,0,0,3,100.0
250450,2016,3,0,0,3,100.0
250450,2017,3,0,0,3,100.0
250450,2018,2,0,0,2,100.0
250450,2019,3,0,0,3,100.0
250450,2020,3,0,0,3,100.0
250460,2012,9,0,0,9,100.0
250460,2013,17,0,0,17,100.0
250460,2014,11,0,0,11,100.0
250460,2015,14,0,0,14,100.0
250460,2016,10,0,0,10,100.0
250460,2017,10,0,0,10,100.0
250460,2018,10,0,0,10,100.0
250460,2019,5,0,1,6,83.33333333333334
250460,2020,6,0,0,6,100.0
250470,2012,0,0,2,2,0.0
250470,2013,0,1,0,1,100.0
250470,2015,0,0,1,1,0.0
250470,2016,0,0,1,1,0.0
250470,2017,0,0,1,1,0.0
250470,2018,0,0,1,1,0.0
250470,2020,0,0,2,2,0.0
250480,2012,4,0,0,4,100.0
250480,2013,8,0,0,8,100.0
250480,2014,8,0,0,8,100.0
250480,2015,6,0,0,6,100.0
250480,2016,3,0,1,4,75.0
250480,2017,8,0,0,8,100.0
250480,2018,9,0,0,9,100.0
250480,2019,3,0,3,6,50.0
250480,2020,3,0,0,3,100.0
250485,2013,0,0,1,1,0.0
250485,2015,0,0,2,2,0.0
250485,2016,1,0,0,1,100.0
250485,2017,0,0,1,1,0.0
250485,2018,1,0,1,2,50.0
250490,2012,1,1,1,3,66.66666666666666
250490,2013,6,0,1,7,85.71428571428571
250490,2014,4,0,0,4,100.0
250490,2015,5,0,0,5,100.0
250490,2016,10,0,0,10,100.0
250490,2017,5,0,0,5,100.0
250490,2018,4,0,0,4,100.0
250490,2019,4,0,0,4,100.0
250490,2020,7,0,0,7,100.0
250500,2012,8,0,0,8,100.0
250500,2013,0,0,1,1,0.0
250500,2014,1,0,0,1,100.0
250500,2015,1,0,0,1,100.0
250500,2016,2,0,0,2,100.0
250500,2017,2,0,0,2,100.0
250500,2018,2,0,0,2,100.0
250500,2019,2,0,0,2,100.0
250510,2012,11,0,0,11,100.0
250510,2013,3,0,0,3,100.0
250510,2014,5,0,0,5,100.0
250510,2015,5,0,0,5,100.0
250510,2016,5,0,0,5,100.0
250510,2017,3,0,0,3,100.0
250510,2018,5,0,0,5,100.0
250510,2019,5,0,0,5,100.0
250510,2020,5,0,0,5,100.0
250520,2012,2,2,0,4,100.0
250520,2014,0,1,0,1,100.0
250520,2015,0,1,0,1,100.0
250520,2016,2,0,1,3,66.66666666666666
250520,2017,0,1,3,4,25.0
250520,2018,0,0,2,2,0.0
250520,2019,0,1,0,1,100.0
250520,2020,2,1,1,4,75.0
250523,2013,0,4,1,5,80.0
250523,2014,0,0,3,3,0.0
250523,2015,0,1,2,3,33.33333333333333
250523,2016,2,3,2,7,71.42857142857143
250523,2017,0,1,1,2,50.0
250523,2018,1,0,0,1,100.0
250523,2019,0,0,1,1,0.0
250527,2013,0,1,1,2,50.0
250527,2014,0,0,1,1,0.0
250527,2015,0,1,2,3,33.33333333333333
250527,2016,1,0,0,1,100.0
250527,2017,2,0,0,2,100.0
250527,2020,1,0,0,1,100.0
250530,2016,1,0,0,1,100.0
250530,2017,0,0,1,1,0.0
250530,2020,1,0,0,1,100.0
250535,2014,1,0,2,3,33.33333333333333
250535,2015,1,0,0,1,100.0
250535,2016,1,0,0,1,100.0
250535,2018,1,0,0,1,100.0
250535,2019,1,0,0,1,100.0
250535,2020,1,0,0,1,100.0
250540,2012,1,0,0,1,100.0
250540,2013,2,0,0,2,100.0
250540,2014,2,0,0,2,100.0
250540,2015,2,0,0,2,100.0
250540,2016,2,0,0,2,100.0
250540,2017,5,0,0,5,100.0
250540,2018,2,0,0,2,100.0
250540,2019,2,0,0,2,100.0
250540,2020,1,0,0,1,100.0
250550,2012,1,0,0,1,100.0
250550,2013,1,0,0,1,100.0
250550,2014,1,0,0,1,100.0
250550,2015,1,0,0,1,100.0
250550,2017,1,0,0,1,100.0
250550,2019,1,0,0,1,100.0
250560,2012,0,0,1,1,0.0
250560,2014,0,0,1,1,0.0
250560,2015,1,0,0,1,100.0
250560,2017,2,0,0,2,100.0
250560,2018,1,0,1,2,50.0
250560,2019,0,0,3,3,0.0
250570,2012,0,1,2,3,33.33333333333333
250570,2013,3,0,0,3,100.0
250570,2014,4,0,0,4,100.0
250570,2015,1,0,0,1,100.0
250570,2016,1,0,0,1,100.0
250570,2017,6,0,0,6,100.0
250570,2019,3,0,0,3,100.0
250570,2020,2,0,0,2,100.0
250580,2012,0,4,1,5,80.0
250580,2014,1,0,1,2,50.0
250580,2015,0,1,3,4,25.0
250580,2016,2,0,0,2,100.0
250580,2017,1,0,0,1,100.0
250580,2018,2,0,0,2,100.0
250580,2020,1,0,0,1,100.0
250590,2012,2,0,0,2,100.0
250590,2014,1,0,0,1,100.0
250590,2015,1,0,0,1,100.0
250590,2016,2,1,0,3,100.0
250590,2018,1,0,0,1,100.0
250590,2019,1,0,0,1,100.0
250600,2012,11,0,0,11,100.0
250600,2013,13,0,0,13,100.0
250600,2014,9,0,0,9,100.0
250600,2015,16,0,0,16,100.0
250600,2016,11,0,0,11,100.0
250600,2017,11,0,0,11,100.0
250600,2018,16,0,0,16,100.0
250600,2019,10,0,0,10,100.0
250600,2020,14,0,0,14,100.0
250610,2012,2,1,2,5,60.0
250610,2013,2,5,1,8,87.5
250610,2014,2,0,2,4,50.0
250610,2015,2,0,1,3,66.66666666666666
250610,2016,3,0,0,3,100.0
250610,2017,4,0,0,4,100.0
250610,2018,3,0,0,3,100.0
250610,2019,5,0,0,5,100.0
250610,2020,5,0,0,5,100.0
250620,2016,3,0,0,3,100.0
250620,2017,1,0,0,1,100.0
250620,2018,1,0,0,1,100.0
250625,2012,3,0,0,3,100.0
250625,2013,1,0,0,1,100.0
250625,2014,4,0,0,4,100.0
250625,2016,1,0,0,1,100.0
250625,2017,1,0,1,2,50.0
250625,2018,2,0,0,2,100.0
250625,2019,1,0,0,1,100.0
250625,2020,2,0,0,2,100.0
250630,2012,14,0,0,14,100.0
250630,2013,19,0,0,19,100.0
250630,2014,19,0,0,19,100.0
250630,2015,23,0,0,23,100.0
250630,2016,15,0,0,15,100.0
250630,2017,15,0,0,15,100.0
250630,2018,10,0,0,10,100.0
250630,2019,17,0,0,17,100.0
250630,2020,23,0,0,23,100.0
250640,2012,2,0,0,2,100.0
250640,2013,3,0,0,3,100.0
250640,2014,3,0,0,3,100.0
250640,2015,5,0,0,5,100.0
250640,2016,5,0,0,5,100.0
250640,2017,4,0,0,4,100.0
250640,2018,3,0,1,4,75.0
250640,2019,7,0,0,7,100.0
250640,2020,6,0,0,6,100.0
250650,2013,1,0,0,1,100.0
250650,2014,1,0,0,1,100.0
250650,2015,1,0,0,1,100.0
250650,2016,2,0,0,2,100.0
250650,2017,1,0,0,1,100.0
250650,2018,1,0,0,1,100.0
250650,2020,1,0,0,1,100.0
250660,2012,0,1,2,3,33.33333333333333
250660,2013,8,0,0,8,100.0
250660,2014,2,0,0,2,100.0
250660,2015,1,0,0,1,100.0
250660,2016,2,0,0,2,100.0
250660,2017,1,0,0,1,100.0
250660,2018,2,0,0,2,100.0
250660,2019,1,0,0,1,100.0
250670,2012,0,0,2,2,0.0
250670,2013,5,0,0,5,100.0
250670,2014,2,0,0,2,100.0
250670,2015,2,0,0,2,100.0
250670,2016,8,0,0,8,100.0
250670,2017,3,0,0,3,100.0
250670,2018,1,1,2,4,50.0
250670,2019,0,0,2,2,0.0
250670,2020,0,0,1,1,0.0
250680,2012,4,0,0,4,100.0
250680,2013,1,0,0,1,100.0
250680,2014,2,0,0,2,100.0
250680,2015,6,0,0,6,100.0
250680,2016,3,0,0,3,100.0
250680,2017,4,0,0,4,100.0
250680,2018,4,0,0,4,100.0
250680,2019,11,0,0,11,100.0
250680,2020,5,0,0,5,100.0
250690,2012,6,0,0,6,100.0
250690,2013,13,0,0,13,100.0
250690,2014,9,0,2,11,81.81818181818183
250690,2015,9,0,0,9,100.0
250690,2016,13,0,0,13,100.0
250690,2017,11,0,0,11,100.0
250690,2018,9,0,0,9,100.0
250690,2019,8,0,0,8,100.0
250690,2020,10,0,0,10,100.0
250700,2012,0,0,3,3,0.0
250700,2013,5,1,0,6,100.0
250700,2014,6,0,0,6,100.0
250700,2015,12,0,0,12,100.0
250700,2016,11,0,0,11,100.0
250700,2017,9,0,0,9,100.0
250700,2018,5,0,4,9,55.55555555555556
250700,2019,4,0,1,5,80.0
250700,2020,0,0,3,3,0.0
250710,2012,3,1,0,4,100.0
250710,2013,3,0,0,3,100.0
250710,2014,5,0,0,5,100.0
250710,2015,6,0,0,6,100.0
250710,2016,6,0,0,6,100.0
250710,2017,6,0,0,6,100.0
250710,2018,6,0,0,6,100.0
250710,2019,8,0,0,8,100.0
250710,2020,3,0,0,3,100.0
250720,2012,0,1,1,2,50.0
250720,2013,2,0,0,2,100.0
250720,2014,1,0,0,1,100.0
250720,2015,3,0,0,3,100.0
250720,2016,1,0,0,1,100.0
250720,2017,2,0,2,4,50.0
250720,2018,3,0,0,3,100.0
250720,2019,2,0,0,2,100.0
250720,2020,4,0,0,4,100.0
250730,2012,0,1,1,2,50.0
250730,2013,7,0,0,7,100.0
250730,2014,4,0,0,4,100.0
250730,2015,1,2,2,5,60.0
250730,2016,3,0,1,4,75.0
250730,2017,3,0,0,3,100.0
250730,2018,5,0,0,5,100.0
250730,2019,3,0,0,3,100.0
250730,2020,6,0,0,6,100.0
250740,2012,0,1,0,1,100.0
250740,2013,2,0,0,2,100.0
250740,2014,1,0,0,1,100.0
250740,2015,4,0,0,4,100.0
250740,2016,1,0,0,1,100.0
250740,2017,6,0,0,6,100.0
250740,2018,1,0,0,1,100.0
250740,2019,3,0,0,3,100.0
250740,2020,2,0,0,2,100.0
250750,2012,252,2,13,267,95.13108614232209
250750,2013,224,1,44,269,83.64312267657994
250750,2014,234,3,24,261,90.80459770114942
250750,2015,197,10,62,269,76.95167286245353
250750,2016,165,24,81,270,70.0
250750,2017,142,15,88,245,64.08163265306122
250750,2018,146,11,89,246,63.82113821138211
250750,2019,125,7,88,220,60.0
250750,2020,272,4,21,297,92.92929292929293
250760,2012,3,0,1,4,75.0
250760,2013,1,0,1,2,50.0
250760,2014,2,0,0,2,100.0
250760,2015,3,0,0,3,100.0
250760,2016,6,0,0,6,100.0
250760,2017,2,0,0,2,100.0
250760,2018,1,0,0,1,100.0
250760,2019,3,0,0,3,100.0
250760,2020,4,0,0,4,100.0
250770,2012,1,0,0,1,100.0
250770,2013,3,0,0,3,100.0
250770,2014,9,0,0,9,100.0
250770,2015,5,0,0,5,100.0
250770,2016,6,0,0,6,100.0
250770,2017,5,0,0,5,100.0
250770,2018,10,0,0,10,100.0
250770,2019,5,0,0,5,100.0
250770,2020,2,0,0,2,100.0
250780,2012,3,0,0,3,100.0
250780,2013,2,0,0,2,100.0
250780,2014,0,0,2,2,0.0
250780,2015,1,0,1,2,50.0
250780,2017,1,0,1,2,50.0
250780,2019,0,0,1,1,0.0
250780,2020,0,0,1,1,0.0
250790,2012,0,2,1,3,66.66666666666666
250790,2013,7,0,0,7,100.0
250790,2014,2,0,0,2,100.0
250790,2015,8,0,0,8,100.0
250790,2016,3,0,0,3,100.0
250790,2017,7,0,0,7,100.0
250790,2018,5,0,0,5,100.0
250790,2019,2,0,0,2,100.0
250790,2020,1,0,0,1,100.0
250800,2012,5,0,0,5,100.0
250800,2013,5,0,0,5,100.0
250800,2014,4,0,0,4,100.0
250800,2015,5,0,0,5,100.0
250800,2017,4,0,0,4,100.0
250800,2018,2,0,0,2,100.0
250800,2019,1,0,0,1,100.0
250800,2020,3,0,0,3,100.0
250810,2012,3,0,1,4,75.0
250810,2013,1,0,0,1,100.0
250810,2014,3,0,0,3,100.0
250810,2016,0,0,2,2,0.0
250810,2017,0,0,1,1,0.0
250810,2020,0,0,2,2,0.0
250820,2012,2,0,0,2,100.0
250820,2013,1,0,1,2,50.0
250820,2014,3,0,0,3,100.0
250820,2015,1,0,0,1,100.0
250820,2016,1,0,0,1,100.0
250820,2017,1,0,0,1,100.0
250820,2018,2,0,0,2,100.0
250820,2019,4,0,0,4,100.0
250830,2012,9,0,0,9,100.0
250830,2013,6,0,0,6,100.0
250830,2014,14,0,0,14,100.0
250830,2015,6,0,0,6,100.0
250830,2016,12,0,0,12,100.0
250830,2017,7,0,0,7,100.0
250830,2018,8,0,0,8,100.0
250830,2019,8,0,0,8,100.0
250830,2020,8,0,0,8,100.0
250840,2012,0,0,1,1,0.0
250840,2018,0,0,1,1,0.0
250840,2019,0,0,2,2,0.0
250840,2020,1,0,0,1,100.0
250850,2012,1,0,0,1,100.0
250850,2013,5,0,0,5,100.0
250850,2015,3,0,0,3,100.0
250850,2017,3,0,0,3,100.0
250850,2019,3,0,0,3,100.0
250850,2020,1,0,0,1,100.0
250855,2013,0,1,0,1,100.0
250855,2014,1,0,0,1,100.0
250855,2016,1,0,0,1,100.0
250855,2017,1,0,0,1,100.0
250855,2018,1,0,0,1,100.0
250860,2012,4,1,3,8,62.5
250860,2013,1,1,3,5,40.0
250860,2014,9,0,0,9,100.0
250860,2015,2,0,0,2,100.0
250860,2016,4,0,0,4,100.0
250860,2017,6,0,0,6,100.0
250860,2018,6,0,0,6,100.0
250860,2019,3,0,0,3,100.0
250860,2020,3,0,0,3,100.0
250870,2012,1,0,0,1,100.0
250870,2014,1,0,0,1,100.0
250870,2015,1,0,0,1,100.0
250870,2017,0,0,1,1,0.0
250870,2019,0,1,1,2,50.0
250870,2020,2,0,0,2,100.0
250880,2012,3,0,0,3,100.0
250880,2013,0,0,1,1,0.0
250880,2014,2,0,0,2,100.0
250880,2015,2,0,0,2,100.0
250880,2016,4,0,0,4,100.0
250880,2017,2,0,0,2,100.0
250880,2018,2,0,0,2,100.0
250880,2019,2,0,0,2,100.0
250880,2020,4,0,0,4,100.0
250890,2012,14,0,0,14,100.0
250890,2013,20,0,0,20,100.0
250890,2014,13,0,0,13,100.0
250890,2015,16,0,0,16,100.0
250890,2016,10,1,1,12,91.66666666666666
250890,2017,14,0,0,14,100.0
250890,2018,18,0,0,18,100.0
250890,2019,14,0,1,15,93.33333333333333
250890,2020,16,1,2,19,89.47368421052632
250900,2012,1,0,0,1,100.0
250900,2013,3,0,0,3,100.0
250900,2014,1,0,0,1,100.0
250900,2015,3,0,0,3,100.0
250900,2016,2,0,0,2,100.0
250900,2017,5,0,0,5,100.0
250900,2018,0,0,2,2,0.0
250900,2019,0,0,4,4,0.0
250900,2020,3,0,1,4,75.0
250905,2012,0,1,0,1,100.0
250905,2013,0,0,1,1,0.0
250905,2015,4,0,0,4,100.0
250905,2016,1,0,0,1,100.0
250905,2017,3,0,0,3,100.0
250905,2018,1,0,0,1,100.0
250905,2019,2,0,1,3,66.66666666666666
250905,2020,3,0,0,3,100.0
250910,2012,4,0,4,8,50.0
250910,2013,8,0,0,8,100.0
250910,2014,7,0,0,7,100.0
250910,2015,3,0,0,3,100.0
250910,2016,6,0,1,7,85.71428571428571
250910,2017,9,0,0,9,100.0
250910,2018,2,0,0,2,100.0
250910,2019,9,0,0,9,100.0
250910,2020,4,0,2,6,66.66666666666666
250915,2012,2,0,0,2,100.0
250915,2013,5,0,0,5,100.0
250915,2015,3,0,0,3,100.0
250915,2016,0,1,0,1,100.0
250915,2018,3,0,0,3,100.0
250915,2019,2,0,0,2,100.0
250915,2020,3,1,2,6,66.66666666666666
250920,2012,1,1,0,2,100.0
250920,2013,4,0,0,4,100.0
250920,2014,4,0,0,4,100.0
250920,2015,5,0,0,5,100.0
250920,2016,6,0,1,7,85.71428571428571
250920,2017,3,0,0,3,100.0
250920,2018,2,0,0,2,100.0
250920,2019,3,0,0,3,100.0
250920,2020,9,0,0,9,100.0
250930,2012,2,0,0,2,100.0
250930,2013,1,0,0,1,100.0
250930,2014,1,0,0,1,100.0
250930,2015,3,0,0,3,100.0
250930,2016,2,0,0,2,100.0
250930,2017,1,0,0,1,100.0
250930,2018,3,0,0,3,100.0
250930,2019,3,0,0,3,100.0
250930,2020,5,0,0,5,100.0
250933,2012,0,1,0,1,100.0
250933,2013,0,2,0,2,100.0
250933,2014,2,0,0,2,100.0
250933,2015,3,0,0,3,100.0
250933,2016,1,0,0,1,100.0
250933,2019,1,0,0,1,100.0
250937,2012,0,0,2,2,0.0
250937,2015,0,0,1,1,0.0
250937,2016,1,0,0,1,100.0
250937,2017,1,0,0,1,100.0
250937,2020,2,0,0,2,100.0
250939,2012,0,0,4,4,0.0
250939,2014,1,0,0,1,100.0
250939,2015,3,0,3,6,50.0
250939,2016,5,0,0,5,100.0
250939,2017,1,0,0,1,100.0
250939,2018,4,0,0,4,100.0
250939,2019,2,0,0,2,100.0
250939,2020,1,0,0,1,100.0
250940,2012,4,0,0,4,100.0
250940,2013,2,0,1,3,66.66666666666666
250940,2014,1,0,0,1,100.0
250940,2015,2,0,0,2,100.0
250940,2016,1,0,0,1,100.0
250940,2017,4,0,0,4,100.0
250940,2018,4,0,0,4,100.0
250940,2019,2,0,0,2,100.0
250940,2020,4,0,0,4,100.0
250950,2012,0,0,1,1,0.0
250950,2015,2,0,0,2,100.0
250950,2016,1,0,0,1,100.0
250950,2017,1,0,0,1,100.0
250950,2018,1,0,0,1,100.0
250950,2019,3,0,0,3,100.0
250950,2020,2,0,0,2,100.0
250960,2012,0,0,1,1,0.0
250960,2013,0,0,1,1,0.0
250960,2014,0,0,3,3,0.0
250960,2015,1,0,0,1,100.0
250960,2016,2,0,0,2,100.0
250960,2017,1,0,0,1,100.0
250960,2018,1,0,0,1,100.0
250960,2020,2,0,0,2,100.0
250970,2012,12,0,3,15,80.0
250970,2013,11,0,0,11,100.0
250970,2014,11,0,0,11,100.0
250970,2015,10,0,0,10,100.0
250970,2016,7,0,0,7,100.0
250970,2017,14,0,0,14,100.0
250970,2018,10,0,0,10,100.0
250970,2019,15,0,0,15,100.0
250970,2020,14,0,0,14,100.0
250980,2012,3,0,0,3,100.0
250980,2013,4,0,0,4,100.0
250980,2014,6,0,0,6,100.0
250980,2015,2,0,0,2,100.0
250980,2016,2,0,0,2,100.0
250980,2017,4,0,0,4,100.0
250980,2018,3,0,0,3,100.0
250980,2019,2,0,0,2,100.0
250980,2020,1,0,0,1,100.0
250990,2012,6,0,0,6,100.0
250990,2013,1,0,0,1,100.0
250990,2014,4,0,0,4,100.0
250990,2016,1,0,0,1,100.0
250990,2017,4,0,0,4,100.0
250990,2018,2,0,0,2,100.0
250990,2019,4,0,0,4,100.0
250990,2020,2,0,0,2,100.0
251000,2012,0,0,1,1,0.0
251000,2013,0,0,5,5,0.0
251000,2014,1,0,0,1,100.0
251000,2015,2,0,0,2,100.0
251000,2017,1,0,0,1,100.0
251000,2018,0,0,1,1,0.0
251000,2019,0,0,2,2,0.0
251000,2020,0,0,1,1,0.0
251010,2012,1,2,3,6,50.0
251010,2013,3,1,2,6,66.66666666666666
251010,2014,1,0,0,1,100.0
251010,2015,0,0,4,4,0.0
251010,2016,1,0,0,1,100.0
251010,2017,3,0,0,3,100.0
251010,2018,2,0,0,2,100.0
251010,2019,4,0,0,4,100.0
251010,2020,8,0,0,8,100.0
251020,2012,3,0,0,3,100.0
251020,2013,2,0,0,2,100.0
251020,2014,1,0,0,1,100.0
251020,2015,1,0,0,1,100.0
251020,2016,4,0,1,5,80.0
251020,2017,3,0,0,3,100.0
251020,2018,4,0,0,4,100.0
251020,2019,1,0,0,1,100.0
251020,2020,2,0,0,2,100.0
251030,2012,3,0,0,3,100.0
251030,2013,1,0,0,1,100.0
251030,2014,1,0,0,1,100.0
251030,2015,1,0,0,1,100.0
251030,2016,1,0,0,1,100.0
251030,2017,1,0,0,1,100.0
251030,2019,1,0,0,1,100.0
251030,2020,1,0,0,1,100.0
251040,2012,0,1,1,2,50.0
251040,2013,2,0,0,2,100.0
251040,2014,1,0,0,1,100.0
251040,2015,1,0,0,1,100.0
251040,2016,1,0,0,1,100.0
251040,2017,3,0,0,3,100.0
251040,2018,1,0,0,1,100.0
251040,2019,4,0,0,4,100.0
251040,2020,1,0,0,1,100.0
251050,2015,1,0,0,1,100.0
251050,2017,0,0,1,1,0.0
251050,2019,0,0,2,2,0.0
251060,2013,0,0,2,2,0.0
251060,2014,0,0,1,1,0.0
251060,2017,3,0,1,4,75.0
251060,2018,0,0,2,2,0.0
251060,2019,0,0,1,1,0.0
251060,2020,0,0,2,2,0.0
251065,2013,0,0,1,1,0.0
251065,2014,1,0,0,1,100.0
251065,2015,2,0,0,2,100.0
251065,2016,1,0,0,1,100.0
251065,2019,1,0,1,2,50.0
251065,2020,0,0,1,1,0.0
251070,2012,0,0,1,1,0.0
251070,2014,0,0,2,2,0.0
251070,2015,0,0,1,1,0.0
251070,2019,0,0,1,1,0.0
251080,2012,38,0,0,38,100.0
251080,2013,43,0,0,43,100.0
251080,2014,30,0,0,30,100.0
251080,2015,39,0,0,39,100.0
251080,2016,45,0,0,45,100.0
251080,2017,33,0,0,33,100.0
251080,2018,26,0,0,26,100.0
251080,2019,39,0,0,39,100.0
251080,2020,36,0,0,36,100.0
251090,2012,2,0,2,4,50.0
251090,2013,3,0,1,4,75.0
251090,2014,2,0,1,3,66.66666666666666
251090,2015,1,1,3,5,40.0
251090,2016,7,0,0,7,100.0
251090,2017,5,0,0,5,100.0
251090,2018,1,0,4,5,20.0
251090,2019,0,0,1,1,0.0
251090,2020,5,0,0,5,100.0
251100,2012,0,0,1,1,0.0
251100,2013,0,0,1,1,0.0
251100,2015,1,0,2,3,33.33333333333333
251100,2016,0,0,3,3,0.0
251100,2018,1,0,1,2,50.0
251100,2020,1,0,0,1,100.0
251110,2012,3,0,0,3,100.0
251110,2013,3,0,0,3,100.0
251110,2014,1,0,0,1,100.0
251110,2016,6,0,0,6,100.0
251110,2017,3,0,0,3,100.0
251110,2018,5,0,0,5,100.0
251110,2019,1,0,0,1,100.0
251120,2012,12,0,1,13,92.3076923076923
251120,2013,10,0,0,10,100.0
251120,2014,8,0,0,8,100.0
251120,2015,9,0,0,9,100.0
251120,2016,11,0,0,11,100.0
251120,2017,5,0,0,5,100.0
251120,2018,9,0,0,9,100.0
251120,2019,12,0,0,12,100.0
251120,2020,14,0,1,15,93.33333333333333
251130,2012,6,0,0,6,100.0
251130,2013,4,0,0,4,100.0
251130,2014,3,0,0,3,100.0
251130,2015,7,0,0,7,100.0
251130,2016,5,0,0,5,100.0
251130,2017,4,0,0,4,100.0
251130,2018,3,0,1,4,75.0
251130,2019,6,0,0,6,100.0
251130,2020,8,0,0,8,100.0
251140,2012,8,0,0,8,100.0
251140,2013,4,0,0,4,100.0
251140,2014,7,0,0,7,100.0
251140,2015,5,0,0,5,100.0
251140,2016,6,0,0,6,100.0
251140,2017,7,0,0,7,100.0
251140,2018,6,0,0,6,100.0
251140,2019,7,0,0,7,100.0
251140,2020,7,0,1,8,87.5
251150,2012,1,0,0,1,100.0
251150,2013,2,0,0,2,100.0
251150,2014,3,0,0,3,100.0
251150,2015,3,0,0,3,100.0
251150,2016,2,0,0,2,100.0
251150,2017,7,0,0,7,100.0
251150,2018,5,0,0,5,100.0
251150,2019,3,0,0,3,100.0
251150,2020,5,0,0,5,100.0
251160,2012,1,0,0,1,100.0
251160,2013,0,1,3,4,25.0
251160,2014,0,1,3,4,25.0
251160,2015,1,0,1,2,50.0
251160,2016,3,0,0,3,100.0
251160,2017,1,0,0,1,100.0
251160,2018,2,0,0,2,100.0
251160,2020,2,0,0,2,100.0
251170,2012,2,0,0,2,100.0
251170,2014,4,0,0,4,100.0
251170,2015,3,0,0,3,100.0
251170,2016,3,0,0,3,100.0
251170,2018,2,0,0,2,100.0
251170,2019,1,0,0,1,100.0
251170,2020,6,0,0,6,100.0
251180,2012,5,0,0,5,100.0
251180,2013,2,0,0,2,100.0
251180,2014,7,0,0,7,100.0
251180,2015,4,0,0,4,100.0
251180,2016,6,0,0,6,100.0
251180,2017,2,0,1,3,66.66666666666666
251180,2018,2,0,0,2,100.0
251180,2019,2,0,0,2,100.0
251180,2020,2,0,1,3,66.66666666666666
251190,2012,0,1,1,2,50.0
251190,2013,0,0,2,2,0.0
251190,2014,1,2,2,5,60.0
251190,2015,5,1,0,6,100.0
251190,2016,10,0,0,10,100.0
251190,2017,5,0,0,5,100.0
251190,2018,7,0,0,7,100.0
251190,2019,4,0,1,5,80.0
251190,2020,7,0,0,7,100.0
251200,2012,4,0,0,4,100.0
251200,2013,4,0,0,4,100.0
251200,2014,2,0,0,2,100.0
251200,2015,6,0,0,6,100.0
251200,2016,4,0,0,4,100.0
251200,2017,7,0,0,7,100.0
251200,2018,5,0,0,5,100.0
251200,2019,7,0,0,7,100.0
251200,2020,8,0,0,8,100.0
251203,2013,0,0,1,1,0.0
251203,2015,1,0,0,1,100.0
251203,2016,1,0,0,1,100.0
251203,2017,4,0,0,4,100.0
251203,2018,1,0,0,1,100.0
251203,2020,1,0,0,1,100.0
251207,2013,0,0,1,1,0.0
251207,2015,1,0,0,1,100.0
251207,2016,2,0,0,2,100.0
251207,2017,1,0,0,1,100.0
251207,2018,0,0,1,1,0.0
251207,2020,0,0,2,2,0.0
251210,2012,9,0,0,9,100.0
251210,2013,7,0,0,7,100.0
251210,2014,8,0,0,8,100.0
251210,2015,7,0,0,7,100.0
251210,2016,13,0,0,13,100.0
251210,2017,5,0,0,5,100.0
251210,2018,10,0,0,10,100.0
251210,2019,7,0,0,7,100.0
251210,2020,7,0,0,7,100.0
251220,2012,0,0,1,1,0.0
251220,2013,0,0,2,2,0.0
251220,2014,1,0,1,2,50.0
251220,2015,0,0,1,1,0.0
251220,2018,1,0,0,1,100.0
251220,2019,0,0,1,1,0.0
251220,2020,1,0,0,1,100.0
251230,2012,1,0,3,4,25.0
251230,2013,1,3,2,6,66.66666666666666
251230,2014,11,0,1,12,91.66666666666666
251230,2015,14,0,0,14,100.0
251230,2016,2,0,0,2,100.0
251230,2017,11,0,0,11,100.0
251230,2018,7,0,0,7,100.0
251230,2019,5,0,0,5,100.0
251230,2020,6,0,2,8,75.0
251240,2012,1,0,2,3,33.33333333333333
251240,2013,6,0,0,6,100.0
251240,2015,1,0,0,1,100.0
251240,2016,6,0,0,6,100.0
251240,2017,1,0,0,1,100.0
251240,2018,3,0,0,3,100.0
251240,2019,4,0,0,4,100.0
251240,2020,5,0,0,5,100.0
251250,2012,11,0,1,12,91.66666666666666
251250,2013,18,0,0,18,100.0
251250,2014,11,0,0,11,100.0
251250,2015,17,0,0,17,100.0
251250,2016,18,0,0,18,100.0
251250,2017,10,0,0,10,100.0
251250,2018,13,1,0,14,100.0
251250,2019,16,0,0,16,100.0
251250,2020,18,0,0,18,100.0
251260,2014,1,0,0,1,100.0
251260,2015,1,0,0,1,100.0
251260,2016,3,0,0,3,100.0
251270,2012,3,0,0,3,100.0
251270,2013,3,0,0,3,100.0
251270,2014,6,0,3,9,66.66666666666666
251270,2015,4,0,0,4,100.0
251270,2016,9,0,1,10,90.0
251270,2017,4,0,0,4,100.0
251270,2018,1,0,0,1,100.0
251270,2019,2,0,3,5,40.0
251270,2020,2,0,0,2,100.0
251272,2013,0,0,1,1,0.0
251272,2014,2,0,0,2,100.0
251272,2015,1,0,0,1,100.0
251272,2016,0,0,1,1,0.0
251272,2017,1,0,0,1,100.0
251272,2018,0,1,1,2,50.0
251272,2019,1,0,2,3,33.33333333333333
251272,2020,0,0,3,3,0.0
251274,2012,3,0,0,3,100.0
251274,2013,1,0,0,1,100.0
251274,2014,1,0,0,1,100.0
251274,2015,0,0,2,2,0.0
251274,2016,1,0,0,1,100.0
251274,2018,1,0,0,1,100.0
251274,2019,3,0,0,3,100.0
251274,2020,3,0,0,3,100.0
251275,2013,2,0,0,2,100.0
251275,2016,1,0,0,1,100.0
251275,2017,1,0,0,1,100.0
251275,2018,1,0,0,1,100.0
251275,2019,0,0,1,1,0.0
251275,2020,1,0,0,1,100.0
251276,2012,2,0,0,2,100.0
251276,2013,2,0,0,2,100.0
251276,2014,4,0,0,4,100.0
251276,2015,3,0,0,3,100.0
251276,2016,1,0,0,1,100.0
251276,2018,2,0,0,2,100.0
251276,2020,1,0,0,1,100.0
251278,2014,1,0,0,1,100.0
251278,2016,1,0,0,1,100.0
251278,2018,1,0,0,1,100.0
251278,2020,1,0,0,1,100.0
251280,2012,2,0,0,2,100.0
251280,2013,2,0,0,2,100.0
251280,2014,1,0,0,1,100.0
251280,2017,2,0,0,2,100.0
251280,2018,1,0,0,1,100.0
251280,2019,2,0,0,2,100.0
251280,2020,4,0,0,4,100.0
251290,2012,7,0,0,7,100.0
251290,2013,9,0,0,9,100.0
251290,2014,6,0,0,6,100.0
251290,2015,12,0,0,12,100.0
251290,2016,10,0,0,10,100.0
251290,2017,10,0,0,10,100.0
251290,2018,7,0,0,7,100.0
251290,2019,4,0,0,4,100.0
251290,2020,9,0,0,9,100.0
251300,2012,1,0,0,1,100.0
251300,2014,0,0,1,1,0.0
251300,2017,0,0,1,1,0.0
251300,2019,0,0,2,2,0.0
251310,2012,3,0,0,3,100.0
251310,2013,1,0,0,1,100.0
251310,2014,4,0,0,4,100.0
251310,2015,1,0,1,2,50.0
251310,2016,6,0,0,6,100.0
251310,2017,1,0,0,1,100.0
251310,2018,3,0,0,3,100.0
251310,2019,4,0,0,4,100.0
251310,2020,3,0,0,3,100.0
251315,2012,0,0,1,1,0.0
251315,2013,0,1,1,2,50.0
251315,2014,1,0,0,1,100.0
251315,2015,1,0,0,1,100.0
251315,2017,1,0,0,1,100.0
251315,2019,3,0,0,3,100.0
251315,2020,0,0,1,1,0.0
251320,2012,0,0,1,1,0.0
251320,2013,0,0,2,2,0.0
251320,2014,1,0,0,1,100.0
251320,2015,4,0,0,4,100.0
251320,2017,1,1,1,3,66.66666666666666
251320,2018,0,0,1,1,0.0
251320,2019,0,1,4,5,20.0
251320,2020,1,0,0,1,100.0
251330,2013,2,0,0,2,100.0
251330,2014,3,0,0,3,100.0
251330,2015,1,0,0,1,100.0
251330,2016,0,0,2,2,0.0
251330,2017,0,0,3,3,0.0
251330,2018,2,0,0,2,100.0
251330,2019,2,0,0,2,100.0
251330,2020,4,0,0,4,100.0
251335,2012,0,0,1,1,0.0
251335,2013,0,0,1,1,0.0
251335,2014,0,0,3,3,0.0
251335,2016,0,0,1,1,0.0
251335,2017,0,0,2,2,0.0
251335,2019,0,0,1,1,0.0
251340,2012,4,0,0,4,100.0
251340,2013,6,0,0,6,100.0
251340,2014,3,0,0,3,100.0
251340,2015,1,0,0,1,100.0
251340,2016,4,0,3,7,57.14285714285714
251340,2018,2,0,1,3,66.66666666666666
251340,2019,1,0,0,1,100.0
251340,2020,4,0,1,5,80.0
251350,2012,0,0,3,3,0.0
251350,2013,0,0,1,1,0.0
251350,2014,1,0,1,2,50.0
251350,2015,0,0,2,2,0.0
251350,2017,1,0,0,1,100.0
251350,2019,0,0,1,1,0.0
251350,2020,1,0,0,1,100.0
251360,2013,1,0,0,1,100.0
251360,2014,5,0,0,5,100.0
251360,2015,2,0,0,2,100.0
251360,2016,3,0,0,3,100.0
251360,2017,2,0,0,2,100.0
251360,2018,2,0,0,2,100.0
251360,2019,0,0,2,2,0.0
251360,2020,3,0,1,4,75.0
251365,2014,1,0,0,1,100.0
251365,2017,0,0,1,1,0.0
251370,2012,16,18,17,51,66.66666666666666
251370,2013,31,13,24,68,64.70588235294117
251370,2014,42,0,7,49,85.71428571428571
251370,2015,16,12,28,56,50.0
251370,2016,67,0,8,75,89.33333333333333
251370,2017,47,0,0,47,100.0
251370,2018,54,0,4,58,93.10344827586206
251370,2019,62,0,1,63,98.4126984126984
251370,2020,58,0,0,58,100.0
251380,2013,3,0,0,3,100.0
251380,2014,2,0,0,2,100.0
251380,2016,0,0,1,1,0.0
251380,2017,2,1,1,4,75.0
251380,2018,1,2,0,3,100.0
251380,2019,0,0,2,2,0.0
251380,2020,0,1,0,1,100.0
251385,2012,2,0,0,2,100.0
251385,2013,1,0,0,1,100.0
251385,2014,1,0,0,1,100.0
251385,2019,0,2,0,2,100.0
251385,2020,1,0,0,1,100.0
251390,2012,11,0,0,11,100.0
251390,2013,13,0,0,13,100.0
251390,2014,13,0,0,13,100.0
251390,2015,11,0,0,11,100.0
251390,2016,19,0,0,19,100.0
251390,2017,12,0,0,12,100.0
251390,2018,9,1,0,10,100.0
251390,2019,8,0,0,8,100.0
251390,2020,10,0,1,11,90.9090909090909
251392,2012,1,0,0,1,100.0
251392,2014,1,0,0,1,100.0
251392,2016,1,0,0,1,100.0
251392,2017,4,0,0,4,100.0
251394,2013,0,0,1,1,0.0
251394,2014,0,0,1,1,0.0
251394,2018,0,0,1,1,0.0
251394,2019,1,0,0,1,100.0
251396,2012,0,0,1,1,0.0
251396,2013,1,0,0,1,100.0
251396,2014,1,0,0,1,100.0
251396,2015,2,0,0,2,100.0
251396,2016,4,0,0,4,100.0
251396,2018,1,0,0,1,100.0
251396,2019,1,0,1,2,50.0
251396,2020,1,0,0,1,100.0
251398,2012,5,0,0,5,100.0
251398,2013,1,0,0,1,100.0
251398,2014,1,0,0,1,100.0
251398,2015,1,0,0,1,100.0
251398,2016,2,0,0,2,100.0
251398,2017,2,0,0,2,100.0
251398,2019,0,0,1,1,0.0
251398,2020,2,0,0,2,100.0
251400,2012,0,1,0,1,100.0
251400,2013,0,0,1,1,0.0
251400,2014,2,0,0,2,100.0
251400,2015,5,0,0,5,100.0
251400,2016,3,0,0,3,100.0
251400,2017,3,0,0,3,100.0
251400,2019,0,0,1,1,0.0
251410,2012,0,0,1,1,0.0
251410,2013,1,0,0,1,100.0
251410,2014,2,0,0,2,100.0
251410,2015,1,0,0,1,100.0
251410,2016,1,0,0,1,100.0
251410,2017,3,0,0,3,100.0
251410,2018,1,0,0,1,100.0
251410,2019,1,0,1,2,50.0
251410,2020,5,0,0,5,100.0
251420,2012,4,0,0,4,100.0
251420,2013,1,0,0,1,100.0
251420,2014,2,0,0,2,100.0
251420,2015,3,0,0,3,100.0
251420,2016,2,0,0,2,100.0
251420,2017,2,0,0,2,100.0
251420,2018,2,0,0,2,100.0
251420,2019,5,0,0,5,100.0
251430,2012,0,0,1,1,0.0
251430,2013,1,1,0,2,100.0
251430,2014,0,0,1,1,0.0
251430,2015,0,0,1,1,0.0
251430,2016,0,0,1,1,0.0
251430,2019,4,0,0,4,100.0
251430,2020,2,0,0,2,100.0
251440,2012,0,0,1,1,0.0
251440,2013,2,0,0,2,100.0
251440,2014,2,0,0,2,100.0
251440,2017,2,0,0,2,100.0
251440,2019,1,0,0,1,100.0
251440,2020,2,0,0,2,100.0
251445,2013,3,0,0,3,100.0
251445,2014,1,0,0,1,100.0
251445,2015,1,0,0,1,100.0
251445,2016,2,0,0,2,100.0
251445,2017,2,0,0,2,100.0
251445,2019,4,0,0,4,100.0
251445,2020,3,0,1,4,75.0
251450,2012,5,1,1,7,85.71428571428571
251450,2013,3,0,1,4,75.0
251450,2014,4,0,0,4,100.0
251450,2015,4,0,0,4,100.0
251450,2016,5,0,0,5,100.0
251450,2017,5,0,0,5,100.0
251450,2018,3,0,0,3,100.0
251450,2019,6,0,0,6,100.0
251450,2020,10,0,0,10,100.0
251455,2012,1,0,0,1,100.0
251455,2013,1,1,0,2,100.0
251455,2014,1,0,0,1,100.0
251455,2015,3,0,0,3,100.0
251455,2016,1,0,0,1,100.0
251455,2017,1,0,1,2,50.0
251455,2018,0,0,1,1,0.0
251455,2020,1,0,0,1,100.0
251460,2012,0,0,2,2,0.0
251460,2014,0,0,1,1,0.0
251460,2015,0,0,1,1,0.0
251460,2017,0,0,1,1,0.0
251460,2018,1,1,2,4,50.0
251460,2019,0,0,1,1,0.0
251460,2020,2,0,1,3,66.66666666666666
251465,2012,0,1,0,1,100.0
251465,2015,1,0,0,1,100.0
251465,2019,1,0,0,1,100.0
251465,2020,1,0,0,1,100.0
251470,2015,1,0,0,1,100.0
251470,2016,1,0,0,1,100.0
251470,2018,2,0,2,4,50.0
251470,2020,0,0,1,1,0.0
251480,2012,0,0,1,1,0.0
251480,2013,1,0,0,1,100.0
251480,2014,0,0,1,1,0.0
251480,2016,0,0,1,1,0.0
251480,2017,0,0,2,2,0.0
251480,2018,0,0,3,3,0.0
251480,2019,0,0,3,3,0.0
251480,2020,0,0,1,1,0.0
251490,2012,0,0,1,1,0.0
251490,2013,3,0,0,3,100.0
251490,2014,1,0,0,1,100.0
251490,2015,3,0,0,3,100.0
251490,2017,1,0,0,1,100.0
251490,2019,2,0,0,2,100.0
251490,2020,1,0,0,1,100.0
251500,2012,0,0,1,1,0.0
251500,2013,2,0,0,2,100.0
251500,2014,1,0,0,1,100.0
251500,2015,4,0,0,4,100.0
251500,2016,2,0,0,2,100.0
251500,2017,1,0,0,1,100.0
251500,2018,1,0,0,1,100.0
251500,2019,3,0,0,3,100.0
251500,2020,1,0,0,1,100.0
251510,2012,8,0,1,9,88.88888888888889
251510,2013,4,0,0,4,100.0
251510,2014,3,0,0,3,100.0
251510,2015,2,0,0,2,100.0
251510,2016,3,0,0,3,100.0
251510,2017,3,0,0,3,100.0
251510,2018,3,0,0,3,100.0
251510,2019,6,0,0,6,100.0
251510,2020,5,0,0,5,100.0
251520,2014,0,0,1,1,0.0
251520,2016,1,0,0,1,100.0
251520,2017,0,0,1,1,0.0
251520,2018,2,0,1,3,66.66666666666666
251520,2019,0,1,0,1,100.0
251520,2020,0,0,4,4,0.0
251530,2012,18,0,1,19,94.73684210526315
251530,2013,18,0,0,18,100.0
251530,2014,14,0,0,14,100.0
251530,2015,19,0,0,19,100.0
251530,2016,17,0,0,17,100.0
251530,2017,17,0,0,17,100.0
251530,2018,16,0,0,16,100.0
251530,2019,15,0,0,15,100.0
251530,2020,25,0,1,26,96.15384615384616
251540,2012,0,0,2,2,0.0
251540,2013,1,0,2,3,33.33333333333333
251540,2014,1,0,1,2,50.0
251540,2015,0,0,3,3,0.0
251540,2016,0,0,1,1,0.0
251540,2017,3,0,0,3,100.0
251540,2018,1,0,0,1,100.0
251540,2019,1,0,0,1,100.0
251540,2020,3,0,0,3,100.0
251550,2012,0,2,2,4,50.0
251550,2013,0,2,0,2,100.0
251550,2014,1,0,3,4,25.0
251550,2015,2,0,0,2,100.0
251550,2016,2,0,0,2,100.0
251550,2017,7,0,0,7,100.0
251550,2018,3,0,0,3,100.0
251550,2020,3,0,1,4,75.0
251560,2012,0,0,1,1,0.0
251560,2013,2,0,0,2,100.0
251560,2016,1,0,0,1,100.0
251560,2017,1,0,0,1,100.0
251560,2019,1,0,0,1,100.0
251570,2013,1,0,0,1,100.0
251570,2016,1,0,0,1,100.0
251570,2017,0,0,1,1,0.0
251570,2019,0,0,1,1,0.0
251580,2012,0,0,2,2,0.0
251580,2013,0,0,1,1,0.0
251580,2014,3,0,0,3,100.0
251580,2015,1,0,0,1,100.0
251580,2016,5,0,0,5,100.0
251580,2017,4,0,0,4,100.0
251580,2019,1,0,0,1,100.0
251580,2020,2,0,0,2,100.0
251590,2012,0,0,1,1,0.0
251590,2013,4,0,0,4,100.0
251590,2015,2,0,0,2,100.0
251590,2016,1,0,0,1,100.0
251590,2017,1,0,0,1,100.0
251590,2018,5,0,0,5,100.0
251590,2019,2,0,0,2,100.0
251590,2020,1,0,0,1,100.0
251593,2012,2,0,0,2,100.0
251593,2013,1,0,0,1,100.0
251593,2014,1,0,0,1,100.0
251593,2015,1,0,0,1,100.0
251593,2016,4,0,0,4,100.0
251593,2017,1,0,0,1,100.0
251593,2018,2,0,0,2,100.0
251593,2019,2,0,0,2,100.0
251597,2012,2,0,1,3,66.66666666666666
251597,2013,1,0,0,1,100.0
251597,2014,1,0,0,1,100.0
251597,2015,1,0,0,1,100.0
251597,2018,6,0,0,6,100.0
251597,2019,4,0,2,6,66.66666666666666
251597,2020,3,0,0,3,100.0
251600,2012,9,0,0,9,100.0
251600,2013,7,0,0,7,100.0
251600,2014,10,0,0,10,100.0
251600,2015,15,0,0,15,100.0
251600,2016,5,0,0,5,100.0
251600,2017,5,0,0,5,100.0
251600,2018,11,0,0,11,100.0
251600,2019,7,0,0,7,100.0
251600,2020,14,0,0,14,100.0
251610,2012,9,0,0,9,100.0
251610,2013,0,0,2,2,0.0
251610,2014,7,0,0,7,100.0
251610,2015,5,0,0,5,100.0
251610,2016,8,0,1,9,88.88888888888889
251610,2017,4,0,1,5,80.0
251610,2018,7,0,0,7,100.0
251610,2019,11,0,0,11,100.0
251610,2020,4,0,0,4,100.0
251615,2012,0,0,2,2,0.0
251615,2014,2,0,0,2,100.0
251615,2015,1,0,0,1,100.0
251615,2016,3,0,0,3,100.0
251615,2018,1,0,0,1,100.0
251615,2019,2,0,0,2,100.0
251620,2012,19,0,2,21,90.47619047619048
251620,2013,13,0,0,13,100.0
251620,2014,15,0,0,15,100.0
251620,2015,38,0,0,38,100.0
251620,2016,18,0,0,18,100.0
251620,2017,13,0,0,13,100.0
251620,2018,22,0,0,22,100.0
251620,2019,26,0,1,27,96.29629629629629
251620,2020,24,0,0,24,100.0
251630,2012,9,0,0,9,100.0
251630,2013,3,0,1,4,75.0
251630,2014,10,0,0,10,100.0
251630,2015,6,0,0,6,100.0
251630,2016,5,0,0,5,100.0
251630,2017,8,0,0,8,100.0
251630,2018,8,0,0,8,100.0
251630,2019,1,0,0,1,100.0
251630,2020,5,0,0,5,100.0
251640,2012,0,2,6,8,25.0
251640,2013,0,0,1,1,0.0
251640,2014,2,1,2,5,60.0
251640,2015,4,0,0,4,100.0
251640,2016,5,0,0,5,100.0
251640,2017,3,0,0,3,100.0
251640,2018,3,0,0,3,100.0
251640,2020,2,0,0,2,100.0
251650,2012,7,0,0,7,100.0
251650,2013,4,0,0,4,100.0
251650,2014,8,0,0,8,100.0
251650,2015,6,0,0,6,100.0
251650,2016,5,0,0,5,100.0
251650,2017,4,0,0,4,100.0
251650,2018,6,0,0,6,100.0
251650,2019,6,0,1,7,85.71428571428571
251650,2020,7,0,0,7,100.0
251660,2012,0,3,2,5,60.0
251660,2013,3,0,0,3,100.0
251660,2014,7,0,0,7,100.0
251660,2015,8,0,0,8,100.0
251660,2016,4,0,0,4,100.0
251660,2017,4,0,0,4,100.0
251660,2018,3,0,0,3,100.0
251660,2019,5,0,0,5,100.0
251660,2020,2,0,0,2,100.0
251670,2012,1,0,4,5,20.0
251670,2013,4,0,1,5,80.0
251670,2014,4,0,0,4,100.0
251670,2015,5,0,0,5,100.0
251670,2016,5,0,0,5,100.0
251670,2017,5,0,0,5,100.0
251670,2018,4,0,0,4,100.0
251670,2019,9,0,0,9,100.0
251670,2020,2,0,1,3,66.66666666666666
251675,2012,0,0,1,1,0.0
251675,2013,0,0,1,1,0.0
251675,2014,2,0,0,2,100.0
251675,2015,1,0,0,1,100.0
251675,2017,1,0,0,1,100.0
251675,2018,0,0,1,1,0.0
251675,2019,0,0,1,1,0.0
251680,2013,1,0,0,1,100.0
251680,2014,3,0,0,3,100.0
251680,2015,1,0,0,1,100.0
251680,2016,4,0,0,4,100.0
251680,2017,2,0,0,2,100.0
251680,2018,1,0,0,1,100.0
251680,2019,8,0,0,8,100.0
251680,2020,3,0,1,4,75.0
251690,2012,1,0,6,7,14.285714285714285
251690,2013,5,0,0,5,100.0
251690,2014,3,0,0,3,100.0
251690,2015,2,1,1,4,75.0
251690,2016,2,0,0,2,100.0
251690,2017,6,0,0,6,100.0
251690,2018,6,0,0,6,100.0
251690,2019,4,0,0,4,100.0
251690,2020,4,0,0,4,100.0
251700,2012,1,0,2,3,33.33333333333333
251700,2014,1,0,0,1,100.0
251700,2015,3,0,0,3,100.0
251700,2016,2,0,0,2,100.0
251700,2017,2,0,0,2,100.0
251700,2018,2,0,0,2,100.0
251700,2019,5,0,0,5,100.0
251700,2020,6,0,0,6,100.0
251710,2012,1,0,0,1,100.0
251710,2013,5,0,0,5,100.0
251710,2017,2,0,0,2,100.0
251710,2018,1,0,0,1,100.0
251710,2019,1,0,0,1,100.0
251710,2020,1,0,0,1,100.0
251720,2014,0,0,1,1,0.0
251720,2015,1,0,0,1,100.0
251720,2017,1,0,0,1,100.0
251720,2019,1,0,0,1,100.0
251720,2020,1,0,0,1,100.0
251740,2012,0,1,0,1,100.0
251740,2014,1,0,0,1,100.0
251740,2016,1,0,0,1,100.0
251740,2017,1,0,0,1,100.0
251740,2018,1,0,0,1,100.0
251740,2019,1,0,0,1,100.0
251740,2020,0,0,3,3,0.0
260000,2012,3,0,6,9,33.33333333333333
260000,2013,2,2,6,10,40.0
260000,2014,4,2,11,17,35.294117647058826
260000,2015,1,7,5,13,61.53846153846154
260000,2016,1,8,4,13,69.23076923076923
260000,2017,2,4,2,8,75.0
260000,2019,0,3,0,3,100.0
260000,2020,0,0,3,3,0.0
260005,2012,37,0,0,37,100.0
260005,2013,23,0,0,23,100.0
260005,2014,38,0,0,38,100.0
260005,2015,32,0,0,32,100.0
260005,2016,28,1,1,30,96.66666666666667
260005,2017,39,0,0,39,100.0
260005,2018,38,0,0,38,100.0
260005,2019,31,0,0,31,100.0
260005,2020,45,0,0,45,100.0
260010,2012,13,0,1,14,92.85714285714286
260010,2013,8,0,0,8,100.0
260010,2014,13,0,0,13,100.0
260010,2015,18,0,0,18,100.0
260010,2016,15,0,0,15,100.0
260010,2017,13,0,0,13,100.0
260010,2018,10,0,0,10,100.0
260010,2019,9,0,0,9,100.0
260010,2020,31,0,0,31,100.0
260020,2012,6,0,0,6,100.0
260020,2013,4,0,0,4,100.0
260020,2014,6,0,0,6,100.0
260020,2015,6,0,0,6,100.0
260020,2016,2,0,0,2,100.0
260020,2017,1,3,2,6,66.66666666666666
260020,2018,4,0,0,4,100.0
260020,2019,5,0,0,5,100.0
260020,2020,7,0,0,7,100.0
260030,2012,8,0,0,8,100.0
260030,2013,14,0,2,16,87.5
260030,2014,8,0,0,8,100.0
260030,2015,8,0,0,8,100.0
260030,2016,9,0,0,9,100.0
260030,2017,12,0,0,12,100.0
260030,2018,16,0,0,16,100.0
260030,2019,10,0,0,10,100.0
260030,2020,10,0,0,10,100.0
260040,2012,8,0,2,10,80.0
260040,2013,4,0,0,4,100.0
260040,2014,9,0,0,9,100.0
260040,2015,12,0,0,12,100.0
260040,2016,12,0,0,12,100.0
260040,2017,10,0,0,10,100.0
260040,2018,16,0,0,16,100.0
260040,2019,14,0,0,14,100.0
260040,2020,23,0,0,23,100.0
260050,2012,16,0,0,16,100.0
260050,2013,14,0,0,14,100.0
260050,2014,14,0,0,14,100.0
260050,2015,11,0,1,12,91.66666666666666
260050,2016,20,0,0,20,100.0
260050,2017,15,0,0,15,100.0
260050,2018,14,0,0,14,100.0
260050,2019,12,0,0,12,100.0
260050,2020,20,0,0,20,100.0
260060,2012,4,0,0,4,100.0
260060,2013,5,0,0,5,100.0
260060,2014,6,0,0,6,100.0
260060,2015,3,0,0,3,100.0
260060,2016,10,0,0,10,100.0
260060,2017,3,0,0,3,100.0
260060,2018,8,0,0,8,100.0
260060,2019,4,0,0,4,100.0
260060,2020,5,0,0,5,100.0
260070,2012,16,0,0,16,100.0
260070,2013,12,0,1,13,92.3076923076923
260070,2014,12,0,1,13,92.3076923076923
260070,2015,17,0,0,17,100.0
260070,2016,12,0,0,12,100.0
260070,2017,17,0,0,17,100.0
260070,2018,15,0,0,15,100.0
260070,2019,13,0,0,13,100.0
260070,2020,17,1,0,18,100.0
260080,2012,9,0,0,9,100.0
260080,2013,8,0,0,8,100.0
260080,2014,12,0,0,12,100.0
260080,2015,8,0,0,8,100.0
260080,2016,7,0,0,7,100.0
260080,2017,9,0,0,9,100.0
260080,2018,6,0,0,6,100.0
260080,2019,9,0,0,9,100.0
260080,2020,8,0,0,8,100.0
260090,2012,7,1,0,8,100.0
260090,2013,5,0,0,5,100.0
260090,2014,9,0,0,9,100.0
260090,2015,8,0,0,8,100.0
260090,2016,8,0,0,8,100.0
260090,2017,6,0,0,6,100.0
260090,2018,7,0,0,7,100.0
260090,2019,4,0,0,4,100.0
260090,2020,7,0,1,8,87.5
260100,2012,3,0,0,3,100.0
260100,2013,3,0,0,3,100.0
260100,2014,4,0,0,4,100.0
260100,2015,2,0,0,2,100.0
260100,2016,8,0,0,8,100.0
260100,2017,2,0,0,2,100.0
260100,2018,1,0,0,1,100.0
260100,2020,4,0,0,4,100.0
260105,2012,11,0,0,11,100.0
260105,2013,6,0,0,6,100.0
260105,2014,3,0,0,3,100.0
260105,2015,2,1,4,7,42.857142857142854
260105,2016,9,0,0,9,100.0
260105,2017,7,0,0,7,100.0
260105,2018,6,0,1,7,85.71428571428571
260105,2019,5,0,3,8,62.5
260105,2020,5,0,0,5,100.0
260110,2012,30,0,0,30,100.0
260110,2013,41,0,0,41,100.0
260110,2014,29,0,0,29,100.0
260110,2015,30,0,0,30,100.0
260110,2016,38,0,0,38,100.0
260110,2017,35,0,1,36,97.22222222222221
260110,2018,25,0,0,25,100.0
260110,2019,23,0,2,25,92.0
260110,2020,42,0,0,42,100.0
260120,2012,27,0,1,28,96.42857142857143
260120,2013,20,0,0,20,100.0
260120,2014,20,0,0,20,100.0
260120,2015,28,0,1,29,96.55172413793103
260120,2016,33,0,0,33,100.0
260120,2017,24,0,0,24,100.0
260120,2018,20,0,0,20,100.0
260120,2019,31,0,0,31,100.0
260120,2020,32,0,0,32,100.0
260130,2012,2,0,0,2,100.0
260130,2013,2,0,0,2,100.0
260130,2014,8,0,0,8,100.0
260130,2015,4,0,0,4,100.0
260130,2016,1,0,0,1,100.0
260130,2017,6,0,0,6,100.0
260130,2018,5,0,0,5,100.0
260130,2019,6,0,0,6,100.0
260130,2020,1,0,0,1,100.0
260140,2012,11,3,4,18,77.77777777777779
260140,2013,15,0,0,15,100.0
260140,2014,21,0,0,21,100.0
260140,2015,18,0,0,18,100.0
260140,2016,26,0,1,27,96.29629629629629
260140,2017,21,0,0,21,100.0
260140,2018,17,0,0,17,100.0
260140,2019,18,0,0,18,100.0
260140,2020,28,0,0,28,100.0
260150,2012,2,0,1,3,66.66666666666666
260150,2013,7,0,0,7,100.0
260150,2014,4,0,0,4,100.0
260150,2015,5,0,1,6,83.33333333333334
260150,2016,2,0,0,2,100.0
260150,2017,2,0,0,2,100.0
260150,2018,3,0,0,3,100.0
260150,2019,5,0,0,5,100.0
260150,2020,7,0,0,7,100.0
260160,2012,5,0,3,8,62.5
260160,2013,7,0,0,7,100.0
260160,2014,6,0,0,6,100.0
260160,2015,3,0,0,3,100.0
260160,2016,6,0,0,6,100.0
260160,2017,6,0,0,6,100.0
260160,2018,6,0,0,6,100.0
260160,2019,6,0,0,6,100.0
260160,2020,10,0,0,10,100.0
260170,2012,33,0,0,33,100.0
260170,2013,30,0,0,30,100.0
260170,2014,28,0,0,28,100.0
260170,2015,28,0,0,28,100.0
260170,2016,22,0,0,22,100.0
260170,2017,30,0,0,30,100.0
260170,2018,24,0,0,24,100.0
260170,2019,25,0,0,25,100.0
260170,2020,40,0,0,40,100.0
260180,2012,5,0,0,5,100.0
260180,2013,4,0,0,4,100.0
260180,2014,2,0,0,2,100.0
260180,2015,7,0,0,7,100.0
260180,2016,4,0,0,4,100.0
260180,2017,5,0,0,5,100.0
260180,2018,8,0,1,9,88.88888888888889
260180,2019,1,0,1,2,50.0
260180,2020,4,0,0,4,100.0
260190,2012,24,0,0,24,100.0
260190,2013,33,0,0,33,100.0
260190,2014,31,0,0,31,100.0
260190,2015,22,0,0,22,100.0
260190,2016,15,0,0,15,100.0
260190,2017,19,0,0,19,100.0
260190,2018,24,0,0,24,100.0
260190,2019,18,0,1,19,94.73684210526315
260190,2020,32,0,0,32,100.0
260200,2012,11,0,0,11,100.0
260200,2013,7,0,0,7,100.0
260200,2014,16,0,0,16,100.0
260200,2015,10,0,0,10,100.0
260200,2016,12,0,0,12,100.0
260200,2017,15,0,1,16,93.75
260200,2018,9,0,0,9,100.0
260200,2019,7,0,0,7,100.0
260200,2020,8,0,0,8,100.0
260210,2012,14,0,2,16,87.5
260210,2013,19,0,3,22,86.36363636363636
260210,2014,14,0,3,17,82.35294117647058
260210,2015,15,0,0,15,100.0
260210,2016,14,1,0,15,100.0
260210,2017,10,2,0,12,100.0
260210,2018,11,2,3,16,81.25
260210,2019,15,2,4,21,80.95238095238095
260210,2020,4,6,13,23,43.47826086956522
260220,2012,12,0,0,12,100.0
260220,2013,11,0,0,11,100.0
260220,2014,7,0,0,7,100.0
260220,2015,13,0,0,13,100.0
260220,2016,6,0,0,6,100.0
260220,2017,17,0,0,17,100.0
260220,2018,11,0,0,11,100.0
260220,2019,14,0,0,14,100.0
260220,2020,17,2,0,19,100.0
260230,2012,11,0,0,11,100.0
260230,2013,7,0,0,7,100.0
260230,2014,11,0,0,11,100.0
260230,2015,10,0,0,10,100.0
260230,2016,25,1,0,26,100.0
260230,2017,21,0,0,21,100.0
260230,2018,12,0,0,12,100.0
260230,2019,14,0,0,14,100.0
260230,2020,12,0,0,12,100.0
260240,2012,10,0,0,10,100.0
260240,2013,11,0,0,11,100.0
260240,2014,4,0,0,4,100.0
260240,2015,7,0,0,7,100.0
260240,2016,3,0,0,3,100.0
260240,2017,9,0,0,9,100.0
260240,2018,3,0,0,3,100.0
260240,2019,4,0,0,4,100.0
260240,2020,3,0,0,3,100.0
260250,2012,2,0,0,2,100.0
260250,2013,3,0,0,3,100.0
260250,2014,5,0,0,5,100.0
260250,2015,1,0,0,1,100.0
260250,2016,5,0,0,5,100.0
260250,2017,1,0,0,1,100.0
260250,2018,2,0,0,2,100.0
260250,2019,2,0,0,2,100.0
260250,2020,5,0,0,5,100.0
260260,2012,24,0,0,24,100.0
260260,2013,17,0,0,17,100.0
260260,2014,13,0,0,13,100.0
260260,2015,20,0,0,20,100.0
260260,2016,21,0,0,21,100.0
260260,2017,16,0,0,16,100.0
260260,2018,18,0,0,18,100.0
260260,2019,21,0,0,21,100.0
260260,2020,18,0,0,18,100.0
260270,2012,5,0,0,5,100.0
260270,2013,7,0,0,7,100.0
260270,2015,7,0,0,7,100.0
260270,2016,5,0,0,5,100.0
260270,2017,4,0,0,4,100.0
260270,2018,12,0,1,13,92.3076923076923
260270,2019,7,0,1,8,87.5
260270,2020,7,0,2,9,77.77777777777779
260280,2012,19,0,1,20,95.0
260280,2013,16,0,0,16,100.0
260280,2014,20,0,1,21,95.23809523809523
260280,2015,15,0,1,16,93.75
260280,2016,14,0,0,14,100.0
260280,2017,18,0,0,18,100.0
260280,2018,10,0,0,10,100.0
260280,2019,26,0,0,26,100.0
260280,2020,16,0,0,16,100.0
260290,2012,91,0,0,91,100.0
260290,2013,83,0,0,83,100.0
260290,2014,78,0,0,78,100.0
260290,2015,77,1,0,78,100.0
260290,2016,71,0,0,71,100.0
260290,2017,93,0,0,93,100.0
260290,2018,86,1,1,88,98.86363636363636
260290,2019,85,0,0,85,100.0
260290,2020,95,0,6,101,94.05940594059405
260300,2012,15,0,0,15,100.0
260300,2013,13,0,0,13,100.0
260300,2014,4,0,0,4,100.0
260300,2015,12,0,0,12,100.0
260300,2016,12,0,0,12,100.0
260300,2017,7,0,0,7,100.0
260300,2018,11,0,0,11,100.0
260300,2019,14,0,0,14,100.0
260300,2020,12,0,0,12,100.0
260310,2012,6,0,0,6,100.0
260310,2013,8,1,0,9,100.0
260310,2014,7,0,0,7,100.0
260310,2015,6,0,0,6,100.0
260310,2016,6,0,0,6,100.0
260310,2017,9,0,0,9,100.0
260310,2018,6,0,0,6,100.0
260310,2019,6,0,0,6,100.0
260310,2020,3,0,0,3,100.0
260320,2012,6,0,0,6,100.0
260320,2013,8,0,0,8,100.0
260320,2014,3,0,0,3,100.0
260320,2015,10,0,0,10,100.0
260320,2016,9,0,0,9,100.0
260320,2017,6,0,0,6,100.0
260320,2018,8,0,1,9,88.88888888888889
260320,2019,5,0,2,7,71.42857142857143
260320,2020,0,3,6,9,33.33333333333333
260330,2012,1,0,0,1,100.0
260330,2013,2,0,0,2,100.0
260330,2014,1,0,0,1,100.0
260330,2015,5,0,0,5,100.0
260330,2016,1,0,0,1,100.0
260330,2017,1,0,0,1,100.0
260330,2018,1,0,0,1,100.0
260330,2019,7,0,0,7,100.0
260330,2020,3,0,0,3,100.0
260340,2012,2,0,0,2,100.0
260340,2013,1,0,0,1,100.0
260340,2014,3,0,0,3,100.0
260340,2015,2,0,0,2,100.0
260340,2016,2,0,0,2,100.0
260340,2017,1,0,0,1,100.0
260340,2018,2,0,0,2,100.0
260340,2020,4,0,0,4,100.0
260345,2012,50,0,1,51,98.0392156862745
260345,2013,47,0,2,49,95.91836734693877
260345,2014,66,0,2,68,97.05882352941177
260345,2015,52,0,2,54,96.29629629629629
260345,2016,66,0,0,66,100.0
260345,2017,66,0,0,66,100.0
260345,2018,46,0,0,46,100.0
260345,2019,42,0,0,42,100.0
260345,2020,66,0,0,66,100.0
260350,2012,6,0,0,6,100.0
260350,2013,8,0,0,8,100.0
260350,2014,2,0,0,2,100.0
260350,2015,10,0,0,10,100.0
260350,2016,1,0,0,1,100.0
260350,2017,7,0,0,7,100.0
260350,2018,10,0,0,10,100.0
260350,2019,13,0,0,13,100.0
260350,2020,7,0,0,7,100.0
260360,2012,5,0,0,5,100.0
260360,2013,4,0,0,4,100.0
260360,2014,4,0,0,4,100.0
260360,2015,6,0,0,6,100.0
260360,2016,7,0,0,7,100.0
260360,2017,2,0,0,2,100.0
260360,2018,4,0,0,4,100.0
260360,2019,3,0,1,4,75.0
260360,2020,2,0,0,2,100.0
260370,2012,6,0,0,6,100.0
260370,2013,12,0,0,12,100.0
260370,2014,9,0,0,9,100.0
260370,2015,8,0,0,8,100.0
260370,2016,8,0,0,8,100.0
260370,2017,6,1,0,7,100.0
260370,2018,6,0,0,6,100.0
260370,2019,7,0,0,7,100.0
260370,2020,8,0,0,8,100.0
260380,2012,6,0,0,6,100.0
260380,2013,13,0,0,13,100.0
260380,2014,5,0,0,5,100.0
260380,2015,5,0,0,5,100.0
260380,2016,3,0,0,3,100.0
260380,2017,6,0,1,7,85.71428571428571
260380,2018,4,0,0,4,100.0
260380,2019,6,0,0,6,100.0
260380,2020,5,0,0,5,100.0
260390,2012,9,0,0,9,100.0
260390,2013,5,0,0,5,100.0
260390,2014,3,0,0,3,100.0
260390,2015,5,0,0,5,100.0
260390,2016,6,0,0,6,100.0
260390,2017,8,0,0,8,100.0
260390,2018,3,0,0,3,100.0
260390,2019,3,1,0,4,100.0
260390,2020,11,0,0,11,100.0
260392,2012,5,0,0,5,100.0
260392,2014,8,0,0,8,100.0
260392,2015,7,0,0,7,100.0
260392,2016,9,0,0,9,100.0
260392,2018,1,0,0,1,100.0
260392,2019,2,0,0,2,100.0
260392,2020,5,0,1,6,83.33333333333334
260400,2012,20,0,9,29,68.96551724137932
260400,2013,41,0,0,41,100.0
260400,2014,28,0,0,28,100.0
260400,2015,30,0,1,31,96.7741935483871
260400,2016,25,0,2,27,92.5925925925926
260400,2017,22,0,0,22,100.0
260400,2018,23,0,0,23,100.0
260400,2019,23,0,0,23,100.0
260400,2020,29,1,0,30,100.0
260410,2012,101,0,2,103,98.05825242718447
260410,2013,126,0,0,126,100.0
260410,2014,122,1,0,123,100.0
260410,2015,134,0,0,134,100.0
260410,2016,129,0,0,129,100.0
260410,2017,114,0,0,114,100.0
260410,2018,121,0,1,122,99.18032786885246
260410,2019,102,0,0,102,100.0
260410,2020,128,0,0,128,100.0
260415,2013,1,0,0,1,100.0
260415,2014,2,0,0,2,100.0
260415,2015,4,0,0,4,100.0
260415,2016,8,0,0,8,100.0
260415,2017,3,0,0,3,100.0
260415,2018,4,0,0,4,100.0
260415,2019,1,0,0,1,100.0
260415,2020,7,0,0,7,100.0
260420,2012,21,0,1,22,95.45454545454545
260420,2013,12,0,1,13,92.3076923076923
260420,2014,18,0,1,19,94.73684210526315
260420,2015,16,0,0,16,100.0
260420,2016,14,0,0,14,100.0
260420,2017,22,0,0,22,100.0
260420,2018,11,0,0,11,100.0
260420,2019,13,0,0,13,100.0
260420,2020,14,0,0,14,100.0
260430,2012,2,0,0,2,100.0
260430,2013,1,0,0,1,100.0
260430,2014,3,0,0,3,100.0
260430,2015,6,0,0,6,100.0
260430,2016,1,0,0,1,100.0
260430,2017,3,0,0,3,100.0
260430,2018,2,0,0,2,100.0
260430,2019,8,0,0,8,100.0
260430,2020,1,0,0,1,100.0
260440,2012,4,0,4,8,50.0
260440,2013,1,0,0,1,100.0
260440,2014,3,0,0,3,100.0
260440,2015,3,0,0,3,100.0
260440,2016,1,1,0,2,100.0
260440,2017,6,0,1,7,85.71428571428571
260440,2018,8,0,0,8,100.0
260440,2019,2,0,0,2,100.0
260440,2020,4,0,0,4,100.0
260450,2012,7,0,0,7,100.0
260450,2013,8,0,0,8,100.0
260450,2014,3,0,0,3,100.0
260450,2015,9,0,0,9,100.0
260450,2016,5,0,1,6,83.33333333333334
260450,2017,8,0,2,10,80.0
260450,2018,4,0,0,4,100.0
260450,2019,7,0,0,7,100.0
260450,2020,10,0,0,10,100.0
260460,2012,13,0,0,13,100.0
260460,2013,9,0,0,9,100.0
260460,2014,8,0,0,8,100.0
260460,2015,10,0,0,10,100.0
260460,2016,5,0,0,5,100.0
260460,2017,14,0,0,14,100.0
260460,2018,4,0,0,4,100.0
260460,2019,10,0,0,10,100.0
260460,2020,9,0,0,9,100.0
260470,2012,3,1,0,4,100.0
260470,2013,9,0,0,9,100.0
260470,2014,3,0,0,3,100.0
260470,2015,6,0,0,6,100.0
260470,2016,9,0,0,9,100.0
260470,2017,2,0,2,4,50.0
260470,2018,2,0,2,4,50.0
260470,2019,5,0,3,8,62.5
260470,2020,3,0,1,4,75.0
260480,2012,3,0,0,3,100.0
260480,2013,1,0,0,1,100.0
260480,2014,1,0,0,1,100.0
260480,2015,8,0,0,8,100.0
260480,2016,3,0,0,3,100.0
260480,2017,8,0,0,8,100.0
260480,2018,6,0,0,6,100.0
260480,2019,7,0,0,7,100.0
260480,2020,4,0,0,4,100.0
260490,2012,3,0,0,3,100.0
260490,2013,7,0,0,7,100.0
260490,2014,6,0,0,6,100.0
260490,2015,2,0,0,2,100.0
260490,2016,3,0,0,3,100.0
260490,2017,5,0,0,5,100.0
260490,2018,3,0,0,3,100.0
260490,2019,5,0,0,5,100.0
260490,2020,3,1,0,4,100.0
260500,2012,9,0,0,9,100.0
260500,2013,11,0,0,11,100.0
260500,2014,10,0,0,10,100.0
260500,2015,9,0,0,9,100.0
260500,2016,9,0,0,9,100.0
260500,2017,7,0,0,7,100.0
260500,2018,13,0,0,13,100.0
260500,2019,18,0,0,18,100.0
260500,2020,14,0,0,14,100.0
260510,2012,13,0,0,13,100.0
260510,2013,9,0,0,9,100.0
260510,2014,19,0,0,19,100.0
260510,2015,10,0,0,10,100.0
260510,2016,8,0,0,8,100.0
260510,2017,8,0,0,8,100.0
260510,2018,10,0,0,10,100.0
260510,2019,6,0,0,6,100.0
260510,2020,9,0,0,9,100.0
260515,2012,5,0,0,5,100.0
260515,2013,5,0,0,5,100.0
260515,2014,6,0,0,6,100.0
260515,2015,7,0,0,7,100.0
260515,2016,5,0,0,5,100.0
260515,2017,8,0,0,8,100.0
260515,2018,7,0,0,7,100.0
260515,2019,4,0,0,4,100.0
260515,2020,4,0,0,4,100.0
260520,2012,21,4,17,42,59.523809523809526
260520,2013,24,0,2,26,92.3076923076923
260520,2014,30,0,0,30,100.0
260520,2015,26,0,0,26,100.0
260520,2016,22,0,2,24,91.66666666666666
260520,2017,22,0,0,22,100.0
260520,2018,26,0,1,27,96.29629629629629
260520,2019,21,1,2,24,91.66666666666666
260520,2020,29,0,6,35,82.85714285714286
260530,2012,5,0,0,5,100.0
260530,2013,7,0,0,7,100.0
260530,2014,16,0,0,16,100.0
260530,2015,6,0,0,6,100.0
260530,2016,9,0,0,9,100.0
260530,2017,15,0,0,15,100.0
260530,2018,5,0,0,5,100.0
260530,2019,11,0,0,11,100.0
260530,2020,7,0,0,7,100.0
260540,2012,8,0,0,8,100.0
260540,2013,5,0,0,5,100.0
260540,2014,14,0,0,14,100.0
260540,2015,5,0,0,5,100.0
260540,2016,9,0,1,10,90.0
260540,2017,5,0,0,5,100.0
260540,2018,11,0,0,11,100.0
260540,2019,6,0,0,6,100.0
260540,2020,7,0,0,7,100.0
260545,2012,1,0,0,1,100.0
260545,2017,0,2,0,2,100.0
260545,2018,0,0,1,1,0.0
260550,2012,2,0,0,2,100.0
260550,2013,1,0,0,1,100.0
260550,2014,4,0,0,4,100.0
260550,2015,2,0,0,2,100.0
260550,2016,3,0,0,3,100.0
260550,2017,3,0,0,3,100.0
260550,2018,3,0,0,3,100.0
260550,2019,10,0,0,10,100.0
260550,2020,3,0,0,3,100.0
260560,2012,6,0,1,7,85.71428571428571
260560,2013,10,0,0,10,100.0
260560,2014,3,0,0,3,100.0
260560,2015,4,0,0,4,100.0
260560,2016,5,0,0,5,100.0
260560,2017,5,0,0,5,100.0
260560,2018,7,0,0,7,100.0
260560,2019,2,0,2,4,50.0
260560,2020,4,0,0,4,100.0
260570,2012,18,0,2,20,90.0
260570,2013,9,0,0,9,100.0
260570,2014,15,0,0,15,100.0
260570,2015,15,0,0,15,100.0
260570,2016,11,0,0,11,100.0
260570,2017,10,1,0,11,100.0
260570,2018,8,0,0,8,100.0
260570,2019,15,0,0,15,100.0
260570,2020,15,0,0,15,100.0
260580,2013,5,0,0,5,100.0
260580,2014,10,0,0,10,100.0
260580,2015,3,0,0,3,100.0
260580,2016,6,0,1,7,85.71428571428571
260580,2017,0,1,2,3,33.33333333333333
260580,2018,0,1,2,3,33.33333333333333
260580,2019,0,1,4,5,20.0
260580,2020,0,3,4,7,42.857142857142854
260590,2012,6,0,0,6,100.0
260590,2013,10,0,0,10,100.0
260590,2014,12,0,0,12,100.0
260590,2015,16,0,2,18,88.88888888888889
260590,2016,5,2,6,13,53.84615384615385
260590,2017,5,0,0,5,100.0
260590,2018,6,1,0,7,100.0
260590,2019,10,0,0,10,100.0
260590,2020,11,0,0,11,100.0
260600,2012,56,0,0,56,100.0
260600,2013,57,1,1,59,98.30508474576271
260600,2014,58,0,0,58,100.0
260600,2015,41,0,1,42,97.61904761904762
260600,2016,57,0,0,57,100.0
260600,2017,49,0,0,49,100.0
260600,2018,42,0,0,42,100.0
260600,2019,35,0,0,35,100.0
260600,2020,67,0,0,67,100.0
260610,2012,6,0,1,7,85.71428571428571
260610,2013,5,0,0,5,100.0
260610,2014,4,0,3,7,57.14285714285714
260610,2015,1,2,6,9,33.33333333333333
260610,2016,0,4,6,10,40.0
260610,2017,4,1,0,5,100.0
260610,2018,6,0,0,6,100.0
260610,2019,10,0,0,10,100.0
260610,2020,13,0,0,13,100.0
260620,2012,19,0,3,22,86.36363636363636
260620,2013,30,0,0,30,100.0
260620,2014,23,0,0,23,100.0
260620,2015,39,0,0,39,100.0
260620,2016,35,0,1,36,97.22222222222221
260620,2017,31,0,0,31,100.0
260620,2018,22,1,0,23,100.0
260620,2019,30,0,0,30,100.0
260620,2020,22,0,0,22,100.0
260630,2012,1,0,0,1,100.0
260630,2013,5,0,0,5,100.0
260630,2014,1,0,0,1,100.0
260630,2015,5,0,0,5,100.0
260630,2016,2,0,0,2,100.0
260630,2017,3,0,0,3,100.0
260630,2019,3,0,0,3,100.0
260630,2020,7,0,0,7,100.0
260640,2012,34,0,0,34,100.0
260640,2013,23,2,0,25,100.0
260640,2014,26,0,1,27,96.29629629629629
260640,2015,30,1,3,34,91.17647058823529
260640,2016,19,1,5,25,80.0
260640,2017,31,0,0,31,100.0
260640,2018,34,0,1,35,97.14285714285714
260640,2019,30,1,0,31,100.0
260640,2020,35,0,2,37,94.5945945945946
260650,2012,4,0,0,4,100.0
260650,2013,7,0,0,7,100.0
260650,2014,6,0,0,6,100.0
260650,2015,3,0,0,3,100.0
260650,2016,2,0,0,2,100.0
260650,2017,6,0,0,6,100.0
260650,2018,3,0,0,3,100.0
260650,2019,5,0,0,5,100.0
260650,2020,4,0,0,4,100.0
260660,2012,10,0,0,10,100.0
260660,2013,6,0,0,6,100.0
260660,2014,9,0,0,9,100.0
260660,2015,5,0,0,5,100.0
260660,2016,9,0,0,9,100.0
260660,2017,15,0,0,15,100.0
260660,2018,6,0,0,6,100.0
260660,2019,4,0,0,4,100.0
260660,2020,5,0,0,5,100.0
260670,2012,5,0,0,5,100.0
260670,2013,2,0,0,2,100.0
260670,2014,3,0,0,3,100.0
260670,2015,3,0,0,3,100.0
260670,2016,1,0,0,1,100.0
260670,2017,3,0,0,3,100.0
260670,2018,2,0,0,2,100.0
260670,2019,1,0,2,3,33.33333333333333
260670,2020,3,0,1,4,75.0
260680,2012,12,2,21,35,40.0
260680,2013,29,0,0,29,100.0
260680,2014,34,0,0,34,100.0
260680,2015,34,0,0,34,100.0
260680,2016,43,0,0,43,100.0
260680,2017,41,0,0,41,100.0
260680,2018,31,0,0,31,100.0
260680,2019,33,0,0,33,100.0
260680,2020,43,1,2,46,95.65217391304348
260690,2012,8,0,0,8,100.0
260690,2013,6,0,0,6,100.0
260690,2014,2,0,0,2,100.0
260690,2015,7,0,0,7,100.0
260690,2016,3,0,0,3,100.0
260690,2017,2,0,0,2,100.0
260690,2018,1,0,0,1,100.0
260690,2019,2,0,0,2,100.0
260690,2020,2,0,0,2,100.0
260700,2012,6,0,0,6,100.0
260700,2013,7,0,0,7,100.0
260700,2014,8,0,0,8,100.0
260700,2015,5,0,0,5,100.0
260700,2016,6,0,0,6,100.0
260700,2017,6,0,0,6,100.0
260700,2018,6,0,0,6,100.0
260700,2019,6,0,0,6,100.0
260700,2020,5,0,0,5,100.0
260710,2013,2,0,0,2,100.0
260710,2014,3,0,0,3,100.0
260710,2015,2,0,0,2,100.0
260710,2016,2,0,0,2,100.0
260710,2018,3,0,0,3,100.0
260710,2019,4,0,0,4,100.0
260720,2012,29,1,10,40,75.0
260720,2013,28,0,2,30,93.33333333333333
260720,2014,49,0,0,49,100.0
260720,2015,20,0,0,20,100.0
260720,2016,31,4,0,35,100.0
260720,2017,44,0,0,44,100.0
260720,2018,30,0,0,30,100.0
260720,2019,27,0,6,33,81.81818181818183
260720,2020,50,0,0,50,100.0
260730,2012,14,0,0,14,100.0
260730,2013,8,0,0,8,100.0
260730,2014,8,0,0,8,100.0
260730,2015,11,0,0,11,100.0
260730,2016,9,0,0,9,100.0
260730,2017,11,0,0,11,100.0
260730,2018,5,0,0,5,100.0
260730,2019,9,0,0,9,100.0
260730,2020,13,0,2,15,86.66666666666667
260740,2012,1,0,0,1,100.0
260740,2013,4,0,0,4,100.0
260740,2015,1,0,0,1,100.0
260740,2017,1,0,0,1,100.0
260740,2019,3,0,0,3,100.0
260740,2020,1,0,0,1,100.0
260750,2012,4,0,1,5,80.0
260750,2013,3,0,1,4,75.0
260750,2014,7,0,0,7,100.0
260750,2015,5,0,0,5,100.0
260750,2016,8,0,0,8,100.0
260750,2017,8,0,0,8,100.0
260750,2018,5,0,0,5,100.0
260750,2019,4,1,0,5,100.0
260750,2020,6,0,0,6,100.0
260760,2012,7,0,1,8,87.5
260760,2013,6,0,0,6,100.0
260760,2014,6,0,0,6,100.0
260760,2015,6,1,1,8,87.5
260760,2016,6,0,0,6,100.0
260760,2017,9,0,0,9,100.0
260760,2018,5,0,0,5,100.0
260760,2019,7,0,2,9,77.77777777777779
260760,2020,0,1,3,4,25.0
260765,2012,8,0,0,8,100.0
260765,2013,10,0,0,10,100.0
260765,2014,12,0,0,12,100.0
260765,2015,9,0,0,9,100.0
260765,2016,8,0,0,8,100.0
260765,2017,5,0,0,5,100.0
260765,2018,10,0,0,10,100.0
260765,2019,9,0,0,9,100.0
260765,2020,8,0,0,8,100.0
260770,2012,3,0,0,3,100.0
260770,2013,4,0,0,4,100.0
260770,2014,7,0,0,7,100.0
260770,2015,6,0,0,6,100.0
260770,2016,3,0,0,3,100.0
260770,2017,2,0,0,2,100.0
260770,2018,4,0,0,4,100.0
260770,2019,4,1,0,5,100.0
260770,2020,5,0,0,5,100.0
260775,2012,8,0,1,9,88.88888888888889
260775,2013,7,0,1,8,87.5
260775,2014,5,0,5,10,50.0
260775,2015,9,0,2,11,81.81818181818183
260775,2016,6,4,4,14,71.42857142857143
260775,2017,10,0,3,13,76.92307692307693
260775,2018,6,0,2,8,75.0
260775,2019,2,1,6,9,33.33333333333333
260775,2020,11,1,0,12,100.0
260780,2012,6,0,0,6,100.0
260780,2013,6,0,0,6,100.0
260780,2014,3,0,0,3,100.0
260780,2015,4,0,0,4,100.0
260780,2016,8,0,0,8,100.0
260780,2017,4,0,0,4,100.0
260780,2018,6,0,1,7,85.71428571428571
260780,2019,10,0,0,10,100.0
260780,2020,8,0,0,8,100.0
260790,2012,223,4,20,247,91.90283400809717
260790,2013,218,12,27,257,89.49416342412452
260790,2014,148,18,75,241,68.87966804979253
260790,2015,208,14,31,253,87.74703557312253
260790,2016,212,11,30,253,88.14229249011858
260790,2017,209,5,31,245,87.34693877551021
260790,2018,188,8,22,218,89.90825688073394
260790,2019,227,1,13,241,94.6058091286307
260790,2020,207,12,27,246,89.02439024390245
260795,2012,2,0,0,2,100.0
260795,2013,3,0,0,3,100.0
260795,2014,4,0,0,4,100.0
260795,2015,2,0,0,2,100.0
260795,2016,9,0,0,9,100.0
260795,2017,5,0,0,5,100.0
260795,2018,3,0,0,3,100.0
260795,2020,6,0,0,6,100.0
260800,2012,9,0,0,9,100.0
260800,2013,8,0,0,8,100.0
260800,2014,6,0,0,6,100.0
260800,2015,4,0,0,4,100.0
260800,2016,9,0,0,9,100.0
260800,2017,5,0,0,5,100.0
260800,2018,8,0,0,8,100.0
260800,2019,5,0,0,5,100.0
260800,2020,5,0,0,5,100.0
260805,2012,4,0,0,4,100.0
260805,2013,4,0,0,4,100.0
260805,2014,3,0,0,3,100.0
260805,2015,3,0,0,3,100.0
260805,2016,11,0,0,11,100.0
260805,2017,3,0,0,3,100.0
260805,2018,2,0,0,2,100.0
260805,2019,4,0,0,4,100.0
260805,2020,1,0,0,1,100.0
260810,2012,12,0,0,12,100.0
260810,2013,8,0,0,8,100.0
260810,2014,12,0,0,12,100.0
260810,2015,10,0,0,10,100.0
260810,2016,11,0,0,11,100.0
260810,2017,11,0,0,11,100.0
260810,2018,7,0,0,7,100.0
260810,2019,9,0,0,9,100.0
260810,2020,8,0,0,8,100.0
260820,2012,3,0,3,6,50.0
260820,2013,2,0,0,2,100.0
260820,2014,1,0,0,1,100.0
260820,2015,7,0,0,7,100.0
260820,2016,10,0,0,10,100.0
260820,2017,4,0,0,4,100.0
260820,2018,9,0,0,9,100.0
260820,2019,6,0,0,6,100.0
260820,2020,4,0,0,4,100.0
260825,2012,2,0,0,2,100.0
260825,2013,7,0,0,7,100.0
260825,2014,2,0,0,2,100.0
260825,2016,3,0,0,3,100.0
260825,2017,4,0,0,4,100.0
260825,2018,4,0,0,4,100.0
260825,2020,3,0,0,3,100.0
260830,2012,6,0,2,8,75.0
260830,2013,5,0,0,5,100.0
260830,2014,7,0,0,7,100.0
260830,2015,5,0,0,5,100.0
260830,2016,2,0,1,3,66.66666666666666
260830,2017,5,0,0,5,100.0
260830,2018,4,0,0,4,100.0
260830,2019,1,0,2,3,33.33333333333333
260830,2020,0,1,2,3,33.33333333333333
260840,2012,3,0,0,3,100.0
260840,2013,3,0,0,3,100.0
260840,2014,7,0,0,7,100.0
260840,2015,5,0,0,5,100.0
260840,2016,11,0,0,11,100.0
260840,2017,7,0,0,7,100.0
260840,2018,4,0,0,4,100.0
260840,2019,4,0,0,4,100.0
260840,2020,5,0,0,5,100.0
260845,2012,2,0,3,5,40.0
260845,2013,4,0,0,4,100.0
260845,2014,4,0,0,4,100.0
260845,2015,5,0,0,5,100.0
260845,2016,4,0,1,5,80.0
260845,2017,5,0,0,5,100.0
260845,2018,4,0,0,4,100.0
260845,2019,9,0,0,9,100.0
260845,2020,9,0,0,9,100.0
260850,2012,5,0,2,7,71.42857142857143
260850,2013,6,0,0,6,100.0
260850,2014,3,0,0,3,100.0
260850,2015,10,0,0,10,100.0
260850,2016,5,0,0,5,100.0
260850,2017,6,0,0,6,100.0
260850,2018,8,0,0,8,100.0
260850,2019,8,0,1,9,88.88888888888889
260850,2020,14,0,0,14,100.0
260860,2012,3,0,0,3,100.0
260860,2013,6,0,0,6,100.0
260860,2014,4,0,0,4,100.0
260860,2015,3,0,0,3,100.0
260860,2016,3,0,0,3,100.0
260860,2017,2,1,0,3,100.0
260860,2018,4,0,0,4,100.0
260860,2019,3,0,0,3,100.0
260860,2020,2,0,1,3,66.66666666666666
260870,2012,3,0,1,4,75.0
260870,2013,7,0,0,7,100.0
260870,2014,5,0,0,5,100.0
260870,2015,3,0,0,3,100.0
260870,2016,3,1,1,5,80.0
260870,2017,11,0,0,11,100.0
260870,2018,8,0,0,8,100.0
260870,2019,9,0,0,9,100.0
260870,2020,4,0,0,4,100.0
260875,2012,5,0,0,5,100.0
260875,2013,10,0,0,10,100.0
260875,2014,11,0,0,11,100.0
260875,2015,6,0,0,6,100.0
260875,2016,10,0,1,11,90.9090909090909
260875,2017,10,0,0,10,100.0
260875,2018,11,0,0,11,100.0
260875,2019,5,0,0,5,100.0
260875,2020,14,0,0,14,100.0
260880,2012,15,0,0,15,100.0
260880,2013,22,0,0,22,100.0
260880,2014,13,0,0,13,100.0
260880,2015,23,0,0,23,100.0
260880,2016,13,0,0,13,100.0
260880,2017,17,0,0,17,100.0
260880,2018,12,0,0,12,100.0
260880,2019,11,0,0,11,100.0
260880,2020,21,0,0,21,100.0
260890,2012,20,0,0,20,100.0
260890,2013,21,0,0,21,100.0
260890,2014,16,0,0,16,100.0
260890,2015,20,0,0,20,100.0
260890,2016,27,0,0,27,100.0
260890,2017,22,0,0,22,100.0
260890,2018,18,0,0,18,100.0
260890,2019,23,0,1,24,95.83333333333334
260890,2020,29,1,0,30,100.0
260900,2012,6,0,0,6,100.0
260900,2013,8,0,0,8,100.0
260900,2014,8,0,0,8,100.0
260900,2015,10,0,1,11,90.9090909090909
260900,2016,6,0,0,6,100.0
260900,2017,6,0,0,6,100.0
260900,2018,10,0,0,10,100.0
260900,2019,11,0,0,11,100.0
260900,2020,5,0,0,5,100.0
260910,2012,4,0,0,4,100.0
260910,2013,5,1,0,6,100.0
260910,2014,9,0,0,9,100.0
260910,2015,4,0,0,4,100.0
260910,2016,5,0,0,5,100.0
260910,2017,4,0,0,4,100.0
260910,2018,2,0,0,2,100.0
260910,2019,3,0,0,3,100.0
260910,2020,5,0,0,5,100.0
260915,2012,3,0,1,4,75.0
260915,2013,4,0,0,4,100.0
260915,2014,4,0,0,4,100.0
260915,2015,7,0,0,7,100.0
260915,2016,5,0,0,5,100.0
260915,2017,3,0,0,3,100.0
260915,2018,6,0,0,6,100.0
260915,2019,3,0,0,3,100.0
260915,2020,6,0,0,6,100.0
260920,2012,2,0,1,3,66.66666666666666
260920,2013,4,0,0,4,100.0
260920,2014,4,0,0,4,100.0
260920,2015,2,0,0,2,100.0
260920,2016,2,0,0,2,100.0
260920,2017,5,0,1,6,83.33333333333334
260920,2018,1,1,1,3,66.66666666666666
260920,2019,7,0,0,7,100.0
260920,2020,2,0,0,2,100.0
260930,2012,6,0,0,6,100.0
260930,2013,6,0,0,6,100.0
260930,2014,1,0,0,1,100.0
260930,2015,5,0,0,5,100.0
260930,2016,5,0,0,5,100.0
260930,2017,3,0,0,3,100.0
260930,2018,5,0,0,5,100.0
260930,2019,4,0,0,4,100.0
260930,2020,6,1,0,7,100.0
260940,2012,11,0,0,11,100.0
260940,2013,23,0,0,23,100.0
260940,2014,16,0,0,16,100.0
260940,2015,26,0,0,26,100.0
260940,2016,27,3,3,33,90.9090909090909
260940,2017,30,1,2,33,93.93939393939394
260940,2018,19,0,0,19,100.0
260940,2019,12,0,2,14,85.71428571428571
260940,2020,28,0,1,29,96.55172413793103
260950,2012,17,0,0,17,100.0
260950,2013,11,0,0,11,100.0
260950,2014,12,0,0,12,100.0
260950,2015,9,0,1,10,90.0
260950,2016,10,0,0,10,100.0
260950,2017,10,0,0,10,100.0
260950,2018,10,0,0,10,100.0
260950,2019,10,0,0,10,100.0
260950,2020,10,0,0,10,100.0
260960,2012,125,0,15,140,89.28571428571429
260960,2013,172,2,2,176,98.86363636363636
260960,2014,139,3,8,150,94.66666666666667
260960,2015,135,0,9,144,93.75
260960,2016,141,8,10,159,93.71069182389937
260960,2017,141,2,9,152,94.07894736842105
260960,2018,117,1,7,125,94.39999999999999
260960,2019,111,1,12,124,90.32258064516128
260960,2020,154,7,19,180,89.44444444444444
260970,2012,1,0,0,1,100.0
260970,2013,2,0,0,2,100.0
260970,2014,4,0,0,4,100.0
260970,2015,4,0,0,4,100.0
260970,2016,4,0,0,4,100.0
260970,2017,9,1,0,10,100.0
260970,2018,7,0,0,7,100.0
260970,2019,6,0,0,6,100.0
260970,2020,5,0,0,5,100.0
260980,2012,3,0,0,3,100.0
260980,2013,4,0,0,4,100.0
260980,2014,2,0,0,2,100.0
260980,2015,6,0,0,6,100.0
260980,2016,7,0,0,7,100.0
260980,2017,6,0,0,6,100.0
260980,2018,5,0,0,5,100.0
260980,2019,1,0,1,2,50.0
260980,2020,1,0,0,1,100.0
260990,2012,32,0,0,32,100.0
260990,2013,23,0,0,23,100.0
260990,2014,26,0,1,27,96.29629629629629
260990,2015,21,0,0,21,100.0
260990,2016,15,0,0,15,100.0
260990,2017,20,0,0,20,100.0
260990,2018,20,0,0,20,100.0
260990,2019,24,0,1,25,96.0
260990,2020,22,0,0,22,100.0
261000,2012,14,2,5,21,76.19047619047619
261000,2013,16,0,0,16,100.0
261000,2014,23,0,0,23,100.0
261000,2015,18,0,1,19,94.73684210526315
261000,2016,24,0,0,24,100.0
261000,2017,23,0,0,23,100.0
261000,2018,27,0,0,27,100.0
261000,2019,22,0,0,22,100.0
261000,2020,24,0,1,25,96.0
261010,2013,3,0,0,3,100.0
261010,2014,2,0,0,2,100.0
261010,2016,2,0,2,4,50.0
261010,2018,1,0,0,1,100.0
261010,2019,0,1,0,1,100.0
261010,2020,0,0,6,6,0.0
261020,2012,6,1,0,7,100.0
261020,2013,6,0,0,6,100.0
261020,2014,4,0,0,4,100.0
261020,2015,8,0,0,8,100.0
261020,2016,10,0,0,10,100.0
261020,2017,3,0,0,3,100.0
261020,2018,10,0,0,10,100.0
261020,2019,6,0,0,6,100.0
261020,2020,12,0,0,12,100.0
261030,2012,3,0,0,3,100.0
261030,2013,5,0,0,5,100.0
261030,2014,2,0,0,2,100.0
261030,2016,2,0,0,2,100.0
261030,2017,6,0,0,6,100.0
261030,2018,5,0,1,6,83.33333333333334
261030,2019,0,3,1,4,75.0
261030,2020,8,0,0,8,100.0
261040,2012,6,0,0,6,100.0
261040,2013,7,0,0,7,100.0
261040,2014,10,0,0,10,100.0
261040,2015,3,0,0,3,100.0
261040,2016,6,0,0,6,100.0
261040,2017,5,0,0,5,100.0
261040,2018,10,0,0,10,100.0
261040,2019,9,0,0,9,100.0
261040,2020,4,0,0,4,100.0
261050,2012,11,0,0,11,100.0
261050,2013,8,0,0,8,100.0
261050,2014,9,0,0,9,100.0
261050,2015,5,0,0,5,100.0
261050,2016,3,0,0,3,100.0
261050,2017,11,0,0,11,100.0
261050,2018,8,0,0,8,100.0
261050,2019,10,0,0,10,100.0
261050,2020,5,1,3,9,66.66666666666666
261060,2012,12,2,9,23,60.86956521739131
261060,2013,10,0,0,10,100.0
261060,2014,14,0,0,14,100.0
261060,2015,23,0,0,23,100.0
261060,2016,20,0,0,20,100.0
261060,2017,15,0,0,15,100.0
261060,2018,13,0,2,15,86.66666666666667
261060,2019,14,0,1,15,93.33333333333333
261060,2020,25,0,5,30,83.33333333333334
261070,2012,40,10,60,110,45.45454545454545
261070,2013,77,1,15,93,83.87096774193549
261070,2014,69,4,43,116,62.93103448275862
261070,2015,47,9,43,99,56.56565656565656
261070,2016,76,7,33,116,71.55172413793103
261070,2017,58,10,34,102,66.66666666666666
261070,2018,68,4,29,101,71.28712871287128
261070,2019,65,7,45,117,61.53846153846154
261070,2020,63,13,37,113,67.2566371681416
261080,2012,6,0,2,8,75.0
261080,2013,2,0,0,2,100.0
261080,2014,8,0,0,8,100.0
261080,2015,5,0,0,5,100.0
261080,2016,8,0,1,9,88.88888888888889
261080,2017,3,0,0,3,100.0
261080,2018,4,0,0,4,100.0
261080,2019,9,0,0,9,100.0
261080,2020,9,0,0,9,100.0
261090,2012,22,0,0,22,100.0
261090,2013,13,0,0,13,100.0
261090,2014,25,0,0,25,100.0
261090,2015,20,0,0,20,100.0
261090,2016,30,0,0,30,100.0
261090,2017,26,0,0,26,100.0
261090,2018,21,0,0,21,100.0
261090,2019,22,0,1,23,95.65217391304348
261090,2020,28,0,0,28,100.0
261100,2012,13,0,0,13,100.0
261100,2013,6,0,0,6,100.0
261100,2014,18,0,0,18,100.0
261100,2015,4,0,0,4,100.0
261100,2016,15,0,0,15,100.0
261100,2017,9,0,0,9,100.0
261100,2018,14,0,0,14,100.0
261100,2019,21,0,0,21,100.0
261100,2020,7,0,0,7,100.0
261110,2012,103,0,0,103,100.0
261110,2013,113,0,0,113,100.0
261110,2014,99,0,0,99,100.0
261110,2015,110,1,1,112,99.10714285714286
261110,2016,132,0,0,132,100.0
261110,2017,119,0,0,119,100.0
261110,2018,126,0,2,128,98.4375
261110,2019,142,1,0,143,100.0
261110,2020,152,0,0,152,100.0
261120,2012,5,0,0,5,100.0
261120,2013,10,0,0,10,100.0
261120,2014,2,0,0,2,100.0
261120,2015,8,0,0,8,100.0
261120,2016,1,0,0,1,100.0
261120,2017,3,0,0,3,100.0
261120,2018,3,0,0,3,100.0
261120,2019,6,0,0,6,100.0
261120,2020,7,0,0,7,100.0
261130,2012,6,0,0,6,100.0
261130,2013,8,0,0,8,100.0
261130,2014,6,0,0,6,100.0
261130,2015,2,0,0,2,100.0
261130,2016,9,0,0,9,100.0
261130,2017,5,0,0,5,100.0
261130,2018,11,0,0,11,100.0
261130,2019,9,0,0,9,100.0
261130,2020,9,0,0,9,100.0
261140,2012,4,0,0,4,100.0
261140,2013,12,0,0,12,100.0
261140,2014,4,0,0,4,100.0
261140,2015,4,0,0,4,100.0
261140,2016,1,1,0,2,100.0
261140,2017,0,3,5,8,37.5
261140,2018,1,0,3,4,25.0
261140,2019,2,0,0,2,100.0
261140,2020,6,0,0,6,100.0
261150,2012,7,0,1,8,87.5
261150,2013,3,0,0,3,100.0
261150,2014,3,0,0,3,100.0
261150,2015,4,0,1,5,80.0
261150,2016,9,0,0,9,100.0
261150,2017,4,0,0,4,100.0
261150,2018,9,0,0,9,100.0
261150,2019,5,0,0,5,100.0
261150,2020,5,0,0,5,100.0
261153,2012,1,0,0,1,100.0
261153,2013,1,0,0,1,100.0
261153,2014,1,0,1,2,50.0
261153,2015,1,0,0,1,100.0
261153,2016,2,0,0,2,100.0
261153,2018,1,1,0,2,100.0
261153,2020,1,0,0,1,100.0
261160,2012,516,7,33,556,94.06474820143885
261160,2013,521,3,11,535,97.94392523364486
261160,2014,524,5,11,540,97.96296296296296
261160,2015,533,2,5,540,99.07407407407408
261160,2016,555,3,11,569,98.06678383128296
261160,2017,517,7,14,538,97.39776951672863
261160,2018,477,7,5,489,98.97750511247445
261160,2019,512,9,17,538,96.84014869888475
261160,2020,632,22,17,671,97.46646795827124
261170,2012,4,0,0,4,100.0
261170,2013,9,0,0,9,100.0
261170,2014,3,0,2,5,60.0
261170,2015,6,0,0,6,100.0
261170,2016,6,0,0,6,100.0
261170,2017,8,0,0,8,100.0
261170,2018,6,0,0,6,100.0
261170,2019,11,0,1,12,91.66666666666666
261170,2020,13,0,0,13,100.0
261180,2012,12,2,5,19,73.68421052631578
261180,2013,13,1,0,14,100.0
261180,2014,16,0,0,16,100.0
261180,2015,13,0,0,13,100.0
261180,2016,16,0,0,16,100.0
261180,2017,20,0,0,20,100.0
261180,2018,16,0,0,16,100.0
261180,2019,20,0,0,20,100.0
261180,2020,17,0,0,17,100.0
261190,2012,9,0,2,11,81.81818181818183
261190,2013,15,1,1,17,94.11764705882352
261190,2014,8,0,1,9,88.88888888888889
261190,2015,6,0,0,6,100.0
261190,2016,9,0,0,9,100.0
261190,2017,7,0,0,7,100.0
261190,2018,8,0,0,8,100.0
261190,2019,9,0,0,9,100.0
261190,2020,14,0,0,14,100.0
261200,2012,3,0,0,3,100.0
261200,2013,1,0,0,1,100.0
261200,2014,2,0,0,2,100.0
261200,2015,3,0,0,3,100.0
261200,2016,5,0,0,5,100.0
261200,2017,6,0,0,6,100.0
261200,2018,4,0,0,4,100.0
261200,2019,3,0,0,3,100.0
261200,2020,0,0,1,1,0.0
261210,2012,0,0,1,1,0.0
261210,2013,1,0,0,1,100.0
261210,2016,2,0,0,2,100.0
261210,2017,1,0,0,1,100.0
261210,2018,1,0,0,1,100.0
261210,2019,1,0,0,1,100.0
261210,2020,2,0,0,2,100.0
261220,2012,23,0,0,23,100.0
261220,2013,20,0,0,20,100.0
261220,2014,19,0,0,19,100.0
261220,2015,21,0,0,21,100.0
261220,2016,28,0,0,28,100.0
261220,2017,34,0,0,34,100.0
261220,2018,16,0,0,16,100.0
261220,2019,13,0,7,20,65.0
261220,2020,35,3,2,40,95.0
261230,2012,5,0,0,5,100.0
261230,2013,7,0,0,7,100.0
261230,2014,4,0,0,4,100.0
261230,2015,2,0,0,2,100.0
261230,2016,8,0,0,8,100.0
261230,2017,3,0,0,3,100.0
261230,2018,2,0,0,2,100.0
261230,2019,4,0,0,4,100.0
261230,2020,9,0,0,9,100.0
261240,2012,8,0,0,8,100.0
261240,2013,12,0,0,12,100.0
261240,2014,10,0,0,10,100.0
261240,2015,5,0,0,5,100.0
261240,2016,8,0,0,8,100.0
261240,2017,9,0,0,9,100.0
261240,2018,11,0,0,11,100.0
261240,2019,9,0,0,9,100.0
261240,2020,10,0,0,10,100.0
261245,2012,4,0,0,4,100.0
261245,2013,4,0,0,4,100.0
261245,2014,6,0,0,6,100.0
261245,2015,4,0,0,4,100.0
261245,2016,4,0,0,4,100.0
261245,2017,4,0,0,4,100.0
261245,2018,3,0,0,3,100.0
261245,2019,6,0,0,6,100.0
261245,2020,4,0,1,5,80.0
261247,2012,4,0,0,4,100.0
261247,2013,3,0,0,3,100.0
261247,2014,2,0,0,2,100.0
261247,2015,4,0,0,4,100.0
261247,2016,2,0,2,4,50.0
261247,2017,6,0,0,6,100.0
261247,2018,8,0,0,8,100.0
261247,2019,3,0,0,3,100.0
261247,2020,6,0,0,6,100.0
261250,2012,18,0,0,18,100.0
261250,2013,28,0,0,28,100.0
261250,2014,25,0,0,25,100.0
261250,2015,23,0,0,23,100.0
261250,2016,40,0,0,40,100.0
261250,2017,21,0,1,22,95.45454545454545
261250,2018,30,0,0,30,100.0
261250,2019,27,0,0,27,100.0
261250,2020,35,0,0,35,100.0
261255,2012,1,0,0,1,100.0
261255,2013,4,0,0,4,100.0
261255,2014,5,0,0,5,100.0
261255,2015,2,0,0,2,100.0
261255,2016,4,0,0,4,100.0
261255,2017,3,0,0,3,100.0
261255,2018,3,0,0,3,100.0
261255,2019,2,0,0,2,100.0
261255,2020,7,0,0,7,100.0
261260,2012,15,0,0,15,100.0
261260,2013,13,0,0,13,100.0
261260,2014,8,0,0,8,100.0
261260,2015,14,0,0,14,100.0
261260,2016,19,0,0,19,100.0
261260,2017,13,0,0,13,100.0
261260,2018,7,0,0,7,100.0
261260,2019,7,0,0,7,100.0
261260,2020,9,0,0,9,100.0
261270,2012,5,0,0,5,100.0
261270,2013,5,0,0,5,100.0
261270,2014,4,1,0,5,100.0
261270,2015,4,0,0,4,100.0
261270,2016,6,0,0,6,100.0
261270,2017,5,0,0,5,100.0
261270,2018,6,0,0,6,100.0
261270,2019,4,0,1,5,80.0
261270,2020,6,0,0,6,100.0
261280,2012,3,0,0,3,100.0
261280,2013,3,0,0,3,100.0
261280,2014,5,0,0,5,100.0
261280,2015,2,0,0,2,100.0
261280,2016,5,0,0,5,100.0
261280,2017,4,0,0,4,100.0
261280,2018,3,0,0,3,100.0
261280,2019,1,0,0,1,100.0
261280,2020,3,0,0,3,100.0
261290,2012,2,0,0,2,100.0
261290,2013,3,0,0,3,100.0
261290,2014,1,0,0,1,100.0
261290,2015,4,0,0,4,100.0
261290,2016,1,0,0,1,100.0
261290,2017,5,0,0,5,100.0
261290,2018,5,0,0,5,100.0
261290,2019,1,0,0,1,100.0
261290,2020,1,0,0,1,100.0
261300,2012,12,0,0,12,100.0
261300,2013,20,0,0,20,100.0
261300,2014,14,0,0,14,100.0
261300,2015,15,0,0,15,100.0
261300,2016,17,0,0,17,100.0
261300,2017,12,0,0,12,100.0
261300,2018,14,0,0,14,100.0
261300,2019,10,0,0,10,100.0
261300,2020,15,0,0,15,100.0
261310,2012,16,0,0,16,100.0
261310,2013,16,0,0,16,100.0
261310,2014,14,0,0,14,100.0
261310,2015,15,0,0,15,100.0
261310,2016,20,0,0,20,100.0
261310,2017,8,0,0,8,100.0
261310,2018,19,0,0,19,100.0
261310,2019,18,0,0,18,100.0
261310,2020,16,0,0,16,100.0
261320,2012,3,0,1,4,75.0
261320,2013,4,0,0,4,100.0
261320,2014,6,0,0,6,100.0
261320,2015,6,0,0,6,100.0
261320,2016,4,0,0,4,100.0
261320,2017,9,0,0,9,100.0
261320,2018,7,0,0,7,100.0
261320,2019,10,0,0,10,100.0
261320,2020,11,0,0,11,100.0
261330,2012,6,0,0,6,100.0
261330,2013,8,0,0,8,100.0
261330,2014,7,0,0,7,100.0
261330,2015,7,0,0,7,100.0
261330,2016,9,0,0,9,100.0
261330,2017,11,0,0,11,100.0
261330,2018,10,0,0,10,100.0
261330,2019,4,0,0,4,100.0
261330,2020,3,0,0,3,100.0
261340,2012,6,1,4,11,63.63636363636363
261340,2013,8,0,0,8,100.0
261340,2014,6,0,0,6,100.0
261340,2015,12,0,1,13,92.3076923076923
261340,2016,6,2,0,8,100.0
261340,2017,10,0,0,10,100.0
261340,2018,7,0,0,7,100.0
261340,2019,11,0,0,11,100.0
261340,2020,6,0,1,7,85.71428571428571
261350,2012,15,0,0,15,100.0
261350,2013,11,0,0,11,100.0
261350,2014,12,0,0,12,100.0
261350,2015,9,0,0,9,100.0
261350,2016,19,0,0,19,100.0
261350,2017,10,0,0,10,100.0
261350,2018,8,0,0,8,100.0
261350,2019,9,0,1,10,90.0
261350,2020,14,0,0,14,100.0
261360,2012,6,0,0,6,100.0
261360,2013,10,0,0,10,100.0
261360,2014,10,0,0,10,100.0
261360,2015,15,0,0,15,100.0
261360,2016,14,0,0,14,100.0
261360,2017,4,0,0,4,100.0
261360,2018,7,0,0,7,100.0
261360,2019,7,0,0,7,100.0
261360,2020,9,0,0,9,100.0
261370,2012,22,0,10,32,68.75
261370,2013,36,3,9,48,81.25
261370,2014,26,1,7,34,79.41176470588235
261370,2015,24,4,2,30,93.33333333333333
261370,2016,35,1,5,41,87.8048780487805
261370,2017,44,0,0,44,100.0
261370,2018,34,0,0,34,100.0
261370,2019,37,0,0,37,100.0
261370,2020,51,1,3,55,94.54545454545455
261380,2012,4,0,0,4,100.0
261380,2013,4,0,0,4,100.0
261380,2014,2,0,0,2,100.0
261380,2015,2,0,0,2,100.0
261380,2016,4,0,0,4,100.0
261380,2017,2,0,0,2,100.0
261380,2018,6,0,0,6,100.0
261380,2019,11,0,1,12,91.66666666666666
261380,2020,4,0,0,4,100.0
261390,2012,16,1,1,18,94.44444444444444
261390,2013,26,3,6,35,82.85714285714286
261390,2014,23,1,2,26,92.3076923076923
261390,2015,22,1,4,27,85.18518518518519
261390,2016,28,3,7,38,81.57894736842105
261390,2017,26,0,0,26,100.0
261390,2018,33,0,0,33,100.0
261390,2019,29,0,0,29,100.0
261390,2020,38,0,0,38,100.0
261400,2012,6,0,0,6,100.0
261400,2013,7,0,0,7,100.0
261400,2014,4,0,0,4,100.0
261400,2015,3,0,1,4,75.0
261400,2016,4,0,0,4,100.0
261400,2017,5,0,0,5,100.0
261400,2018,3,0,0,3,100.0
261400,2019,9,0,0,9,100.0
261400,2020,6,1,1,8,87.5
261410,2012,17,1,0,18,100.0
261410,2013,10,0,0,10,100.0
261410,2014,9,0,0,9,100.0
261410,2015,9,0,0,9,100.0
261410,2016,11,0,0,11,100.0
261410,2017,10,0,0,10,100.0
261410,2018,12,1,0,13,100.0
261410,2019,9,0,1,10,90.0
261410,2020,13,0,0,13,100.0
261420,2012,15,0,1,16,93.75
261420,2013,17,0,2,19,89.47368421052632
261420,2014,17,0,0,17,100.0
261420,2015,15,0,0,15,100.0
261420,2016,21,0,0,21,100.0
261420,2017,11,1,0,12,100.0
261420,2018,12,0,0,12,100.0
261420,2019,12,0,1,13,92.3076923076923
261420,2020,16,0,0,16,100.0
261430,2012,1,0,0,1,100.0
261430,2013,3,0,0,3,100.0
261430,2014,2,0,0,2,100.0
261430,2016,1,0,0,1,100.0
261430,2017,1,0,0,1,100.0
261430,2018,3,0,0,3,100.0
261430,2020,4,0,0,4,100.0
261440,2013,3,0,0,3,100.0
261440,2014,2,0,0,2,100.0
261440,2015,2,0,0,2,100.0
261440,2016,3,0,0,3,100.0
261440,2017,2,0,0,2,100.0
261440,2018,2,0,0,2,100.0
261440,2019,4,0,0,4,100.0
261440,2020,2,0,0,2,100.0
261450,2012,14,0,0,14,100.0
261450,2013,16,0,0,16,100.0
261450,2014,22,0,0,22,100.0
261450,2015,15,0,0,15,100.0
261450,2016,16,0,0,16,100.0
261450,2017,23,1,1,25,96.0
261450,2018,9,0,0,9,100.0
261450,2019,21,0,0,21,100.0
261450,2020,28,0,0,28,100.0
261460,2012,18,0,1,19,94.73684210526315
261460,2013,9,0,1,10,90.0
261460,2014,8,0,0,8,100.0
261460,2015,6,0,2,8,75.0
261460,2016,9,0,0,9,100.0
261460,2017,7,0,0,7,100.0
261460,2018,12,0,0,12,100.0
261460,2019,12,0,0,12,100.0
261460,2020,4,0,0,4,100.0
261470,2012,2,0,0,2,100.0
261470,2013,4,0,0,4,100.0
261470,2014,2,0,0,2,100.0
261470,2015,2,0,0,2,100.0
261470,2016,5,0,0,5,100.0
261470,2017,4,0,0,4,100.0
261470,2018,3,0,0,3,100.0
261470,2019,2,0,0,2,100.0
261470,2020,5,0,0,5,100.0
261480,2012,8,0,0,8,100.0
261480,2013,5,0,0,5,100.0
261480,2014,4,0,0,4,100.0
261480,2015,5,1,0,6,100.0
261480,2016,4,0,0,4,100.0
261480,2017,4,0,0,4,100.0
261480,2018,3,0,0,3,100.0
261480,2019,2,1,0,3,100.0
261480,2020,8,0,0,8,100.0
261485,2012,12,0,1,13,92.3076923076923
261485,2013,7,0,0,7,100.0
261485,2014,5,0,0,5,100.0
261485,2015,9,0,0,9,100.0
261485,2016,6,0,0,6,100.0
261485,2017,7,0,0,7,100.0
261485,2018,12,0,0,12,100.0
261485,2019,13,0,0,13,100.0
261485,2020,12,0,0,12,100.0
261500,2012,7,0,0,7,100.0
261500,2013,7,0,1,8,87.5
261500,2014,6,0,1,7,85.71428571428571
261500,2015,11,0,0,11,100.0
261500,2016,12,0,0,12,100.0
261500,2017,8,0,0,8,100.0
261500,2018,5,0,0,5,100.0
261500,2019,11,0,0,11,100.0
261500,2020,16,0,0,16,100.0
261510,2012,1,0,0,1,100.0
261510,2013,1,0,0,1,100.0
261510,2014,3,0,0,3,100.0
261510,2015,1,0,0,1,100.0
261510,2016,4,0,0,4,100.0
261510,2017,2,0,0,2,100.0
261510,2019,3,0,0,3,100.0
261520,2012,2,0,0,2,100.0
261520,2013,2,0,0,2,100.0
261520,2014,2,0,0,2,100.0
261520,2015,7,0,0,7,100.0
261520,2016,7,0,0,7,100.0
261520,2017,6,0,0,6,100.0
261520,2018,2,0,0,2,100.0
261520,2019,3,0,0,3,100.0
261520,2020,2,0,0,2,100.0
261530,2012,23,0,0,23,100.0
261530,2013,20,0,1,21,95.23809523809523
261530,2014,23,0,0,23,100.0
261530,2015,23,0,0,23,100.0
261530,2016,21,0,1,22,95.45454545454545
261530,2017,23,0,0,23,100.0
261530,2018,27,0,0,27,100.0
261530,2019,19,0,0,19,100.0
261530,2020,34,1,0,35,100.0
261540,2012,14,0,0,14,100.0
261540,2013,13,0,0,13,100.0
261540,2014,17,0,0,17,100.0
261540,2015,15,0,0,15,100.0
261540,2016,17,0,0,17,100.0
261540,2017,15,0,0,15,100.0
261540,2018,9,0,0,9,100.0
261540,2019,17,0,0,17,100.0
261540,2020,9,1,0,10,100.0
261550,2012,6,0,2,8,75.0
261550,2013,10,0,0,10,100.0
261550,2014,5,0,0,5,100.0
261550,2015,6,0,0,6,100.0
261550,2016,5,0,0,5,100.0
261550,2017,5,0,0,5,100.0
261550,2018,2,0,0,2,100.0
261550,2019,6,0,1,7,85.71428571428571
261550,2020,1,0,0,1,100.0
261560,2012,11,0,0,11,100.0
261560,2013,11,0,0,11,100.0
261560,2014,9,0,0,9,100.0
261560,2015,12,0,0,12,100.0
261560,2016,11,0,0,11,100.0
261560,2017,16,0,0,16,100.0
261560,2018,12,0,0,12,100.0
261560,2019,9,0,0,9,100.0
261560,2020,10,0,0,10,100.0
261570,2012,10,0,0,10,100.0
261570,2013,5,0,0,5,100.0
261570,2014,3,0,0,3,100.0
261570,2015,6,0,0,6,100.0
261570,2016,2,0,0,2,100.0
261570,2017,5,0,0,5,100.0
261570,2018,3,0,1,4,75.0
261570,2019,5,0,0,5,100.0
261570,2020,8,1,0,9,100.0
261580,2012,6,0,0,6,100.0
261580,2013,7,0,0,7,100.0
261580,2014,8,0,0,8,100.0
261580,2015,5,0,0,5,100.0
261580,2016,6,0,0,6,100.0
261580,2017,8,0,0,8,100.0
261580,2018,7,0,0,7,100.0
261580,2019,6,0,0,6,100.0
261580,2020,1,0,0,1,100.0
261590,2012,3,0,0,3,100.0
261590,2013,3,0,0,3,100.0
261590,2014,1,0,0,1,100.0
261590,2015,4,0,0,4,100.0
261590,2016,3,0,0,3,100.0
261590,2017,3,0,0,3,100.0
261590,2018,4,0,0,4,100.0
261590,2019,5,0,0,5,100.0
261590,2020,3,0,0,3,100.0
261600,2012,8,0,0,8,100.0
261600,2013,7,0,0,7,100.0
261600,2014,6,0,0,6,100.0
261600,2015,2,0,0,2,100.0
261600,2016,7,0,0,7,100.0
261600,2017,5,0,0,5,100.0
261600,2018,4,0,0,4,100.0
261600,2019,4,0,0,4,100.0
261600,2020,9,0,3,12,75.0
261610,2012,3,0,0,3,100.0
261610,2013,5,0,0,5,100.0
261610,2014,2,0,1,3,66.66666666666666
261610,2015,3,0,0,3,100.0
261610,2016,2,0,0,2,100.0
261610,2017,0,1,3,4,25.0
261610,2018,1,0,0,1,100.0
261610,2019,1,0,1,2,50.0
261610,2020,2,0,0,2,100.0
261618,2012,2,0,0,2,100.0
261618,2013,4,0,0,4,100.0
261618,2014,3,0,0,3,100.0
261618,2015,2,0,0,2,100.0
261618,2016,4,0,0,4,100.0
261618,2017,1,0,0,1,100.0
261618,2019,3,0,0,3,100.0
261618,2020,3,0,0,3,100.0
261620,2012,5,0,0,5,100.0
261620,2013,2,0,0,2,100.0
261620,2014,6,0,0,6,100.0
261620,2015,3,0,0,3,100.0
261620,2016,4,0,0,4,100.0
261620,2017,11,0,0,11,100.0
261620,2018,8,0,0,8,100.0
261620,2019,11,0,1,12,91.66666666666666
261620,2020,6,0,0,6,100.0
261630,2012,7,0,0,7,100.0
261630,2013,10,0,0,10,100.0
261630,2014,13,0,0,13,100.0
261630,2015,9,0,0,9,100.0
261630,2016,6,0,0,6,100.0
261630,2017,11,0,0,11,100.0
261630,2018,8,0,1,9,88.88888888888889
261630,2019,7,0,0,7,100.0
261630,2020,6,0,0,6,100.0
261640,2012,38,2,9,49,81.63265306122449
261640,2013,23,3,17,43,60.46511627906976
261640,2014,40,0,8,48,83.33333333333334
261640,2015,41,0,0,41,100.0
261640,2016,45,2,1,48,97.91666666666666
261640,2017,39,1,1,41,97.5609756097561
261640,2018,36,1,3,40,92.5
261640,2019,23,0,3,26,88.46153846153845
261640,2020,45,0,5,50,90.0
261650,2012,6,0,0,6,100.0
261650,2013,6,0,0,6,100.0
261650,2014,6,0,0,6,100.0
261650,2015,7,0,0,7,100.0
261650,2016,10,0,0,10,100.0
261650,2017,6,0,0,6,100.0
261650,2018,9,0,0,9,100.0
261650,2019,6,0,0,6,100.0
261650,2020,14,0,1,15,93.33333333333333
270000,2012,0,0,1,1,0.0
270010,2012,1,0,1,2,50.0
270010,2013,4,0,2,6,66.66666666666666
270010,2014,3,0,1,4,75.0
270010,2015,6,0,1,7,85.71428571428571
270010,2016,7,0,1,8,87.5
270010,2017,5,0,1,6,83.33333333333334
270010,2018,5,0,0,5,100.0
270010,2019,6,0,0,6,100.0
270010,2020,8,0,0,8,100.0
270020,2012,7,0,0,7,100.0
270020,2013,4,0,2,6,66.66666666666666
270020,2014,8,0,0,8,100.0
270020,2015,11,0,0,11,100.0
270020,2016,4,0,0,4,100.0
270020,2017,8,0,0,8,100.0
270020,2018,6,0,0,6,100.0
270020,2019,5,0,0,5,100.0
270020,2020,8,0,0,8,100.0
270030,2012,32,4,38,74,48.64864864864865
270030,2013,48,2,34,84,59.523809523809526
270030,2014,75,1,14,90,84.44444444444444
270030,2015,51,4,19,74,74.32432432432432
270030,2016,55,3,32,90,64.44444444444444
270030,2017,81,4,22,107,79.43925233644859
270030,2018,80,0,1,81,98.76543209876543
270030,2019,70,2,8,80,90.0
270030,2020,84,5,21,110,80.9090909090909
270040,2012,4,1,6,11,45.45454545454545
270040,2013,10,1,9,20,55.00000000000001
270040,2014,10,1,6,17,64.70588235294117
270040,2015,10,0,4,14,71.42857142857143
270040,2016,14,0,1,15,93.33333333333333
270040,2017,14,0,0,14,100.0
270040,2018,15,0,0,15,100.0
270040,2019,12,0,0,12,100.0
270040,2020,16,0,2,18,88.88888888888889
270050,2012,4,0,0,4,100.0
270050,2013,8,0,0,8,100.0
270050,2014,6,0,8,14,42.857142857142854
270050,2015,8,0,0,8,100.0
270050,2016,10,0,0,10,100.0
270050,2017,6,0,0,6,100.0
270050,2018,7,0,1,8,87.5
270050,2019,2,0,1,3,66.66666666666666
270050,2020,3,1,5,9,44.44444444444444
270060,2012,2,0,1,3,66.66666666666666
270060,2013,1,0,3,4,25.0
270060,2014,4,0,1,5,80.0
270060,2015,1,0,0,1,100.0
270060,2016,2,0,0,2,100.0
270060,2017,5,0,0,5,100.0
270060,2018,8,0,0,8,100.0
270060,2019,7,0,0,7,100.0
270070,2012,0,0,5,5,0.0
270070,2013,3,0,1,4,75.0
270070,2014,6,0,0,6,100.0
270070,2015,11,0,0,11,100.0
270070,2016,6,0,0,6,100.0
270070,2017,9,0,0,9,100.0
270070,2018,9,0,0,9,100.0
270070,2019,2,0,0,2,100.0
270070,2020,9,0,0,9,100.0
270080,2012,0,0,1,1,0.0
270080,2015,2,0,0,2,100.0
270080,2017,2,0,0,2,100.0
270080,2018,2,0,0,2,100.0
270080,2019,4,0,0,4,100.0
270080,2020,4,0,0,4,100.0
270090,2012,1,0,2,3,33.33333333333333
270090,2013,1,0,1,2,50.0
270090,2014,2,0,0,2,100.0
270090,2015,1,0,0,1,100.0
270090,2016,1,0,0,1,100.0
270090,2017,2,0,0,2,100.0
270090,2019,3,0,0,3,100.0
270090,2020,2,0,0,2,100.0
270100,2012,12,0,0,12,100.0
270100,2013,8,0,0,8,100.0
270100,2014,11,0,0,11,100.0
270100,2015,7,0,0,7,100.0
270100,2016,9,0,0,9,100.0
270100,2017,9,1,0,10,100.0
270100,2018,6,0,0,6,100.0
270100,2019,14,0,0,14,100.0
270100,2020,5,0,0,5,100.0
270110,2012,3,0,0,3,100.0
270110,2013,5,0,0,5,100.0
270110,2014,4,0,0,4,100.0
270110,2015,4,0,0,4,100.0
270110,2016,4,0,0,4,100.0
270110,2017,3,1,3,7,57.14285714285714
270110,2018,2,0,0,2,100.0
270110,2019,3,0,1,4,75.0
270110,2020,5,0,1,6,83.33333333333334
270120,2012,2,0,0,2,100.0
270120,2013,2,0,0,2,100.0
270120,2014,1,0,0,1,100.0
270120,2015,1,0,0,1,100.0
270120,2016,6,0,0,6,100.0
270120,2017,3,1,1,5,80.0
270120,2018,2,0,0,2,100.0
270120,2019,3,0,2,5,60.0
270120,2020,4,0,0,4,100.0
270130,2012,16,0,0,16,100.0
270130,2013,7,0,1,8,87.5
270130,2014,11,0,0,11,100.0
270130,2015,9,0,0,9,100.0
270130,2016,11,0,0,11,100.0
270130,2017,10,0,0,10,100.0
270130,2018,10,0,0,10,100.0
270130,2019,9,0,0,9,100.0
270130,2020,8,0,0,8,100.0
270135,2012,2,0,0,2,100.0
270135,2013,2,0,0,2,100.0
270135,2014,2,0,0,2,100.0
270135,2015,5,0,0,5,100.0
270135,2016,3,0,0,3,100.0
270135,2017,2,0,0,2,100.0
270135,2018,4,0,0,4,100.0
270135,2019,2,0,0,2,100.0
270135,2020,4,0,0,4,100.0
270140,2012,8,0,0,8,100.0
270140,2013,12,0,1,13,92.3076923076923
270140,2014,19,0,0,19,100.0
270140,2015,8,0,0,8,100.0
270140,2016,21,0,1,22,95.45454545454545
270140,2017,17,0,0,17,100.0
270140,2018,9,0,0,9,100.0
270140,2019,10,0,1,11,90.9090909090909
270140,2020,10,0,0,10,100.0
270150,2012,0,0,1,1,0.0
270150,2013,2,0,1,3,66.66666666666666
270150,2014,2,0,0,2,100.0
270150,2015,4,0,0,4,100.0
270150,2016,3,1,1,5,80.0
270150,2017,5,0,0,5,100.0
270150,2018,1,0,0,1,100.0
270150,2019,2,0,0,2,100.0
270150,2020,3,0,0,3,100.0
270160,2012,1,0,1,2,50.0
270160,2013,2,0,0,2,100.0
270160,2014,10,0,0,10,100.0
270160,2015,9,0,0,9,100.0
270160,2016,2,0,1,3,66.66666666666666
270160,2017,2,0,0,2,100.0
270160,2018,7,0,0,7,100.0
270160,2019,3,0,2,5,60.0
270160,2020,10,0,0,10,100.0
270170,2012,8,0,2,10,80.0
270170,2013,5,0,3,8,62.5
270170,2014,11,0,0,11,100.0
270170,2015,4,0,0,4,100.0
270170,2016,5,0,2,7,71.42857142857143
270170,2017,7,0,1,8,87.5
270170,2018,6,0,0,6,100.0
270170,2019,6,0,0,6,100.0
270170,2020,7,0,0,7,100.0
270180,2012,0,0,2,2,0.0
270180,2014,2,0,0,2,100.0
270180,2015,1,0,0,1,100.0
270180,2016,6,0,0,6,100.0
270180,2017,3,0,0,3,100.0
270180,2018,3,0,0,3,100.0
270180,2019,2,0,0,2,100.0
270180,2020,1,0,0,1,100.0
270190,2012,4,0,1,5,80.0
270190,2013,4,0,0,4,100.0
270190,2014,1,0,0,1,100.0
270190,2015,3,0,1,4,75.0
270190,2017,1,0,0,1,100.0
270190,2018,3,0,0,3,100.0
270190,2020,2,0,0,2,100.0
270200,2012,4,0,0,4,100.0
270200,2013,5,0,0,5,100.0
270200,2014,4,0,0,4,100.0
270200,2015,3,0,0,3,100.0
270200,2016,4,0,0,4,100.0
270200,2017,4,0,0,4,100.0
270200,2018,3,0,0,3,100.0
270200,2019,4,0,0,4,100.0
270200,2020,3,0,0,3,100.0
270210,2012,5,1,1,7,85.71428571428571
270210,2013,5,0,2,7,71.42857142857143
270210,2014,6,0,0,6,100.0
270210,2015,6,0,0,6,100.0
270210,2016,9,0,0,9,100.0
270210,2017,9,0,0,9,100.0
270210,2018,9,0,0,9,100.0
270210,2019,5,0,0,5,100.0
270210,2020,7,0,0,7,100.0
270220,2012,1,0,0,1,100.0
270220,2013,4,0,0,4,100.0
270220,2015,4,0,0,4,100.0
270220,2017,1,0,0,1,100.0
270220,2018,5,0,1,6,83.33333333333334
270220,2019,1,0,0,1,100.0
270220,2020,1,0,1,2,50.0
270230,2012,6,0,8,14,42.857142857142854
270230,2013,11,0,6,17,64.70588235294117
270230,2014,12,0,5,17,70.58823529411765
270230,2015,13,0,3,16,81.25
270230,2016,22,0,2,24,91.66666666666666
270230,2017,29,0,0,29,100.0
270230,2018,27,0,0,27,100.0
270230,2019,15,0,0,15,100.0
270230,2020,26,0,0,26,100.0
270235,2012,0,1,7,8,12.5
270235,2013,6,0,0,6,100.0
270235,2014,7,0,2,9,77.77777777777779
270235,2015,4,0,0,4,100.0
270235,2016,4,0,3,7,57.14285714285714
270235,2017,11,0,0,11,100.0
270235,2018,8,0,0,8,100.0
270235,2019,7,0,0,7,100.0
270235,2020,5,3,2,10,80.0
270240,2012,20,0,2,22,90.9090909090909
270240,2013,21,0,1,22,95.45454545454545
270240,2014,19,0,0,19,100.0
270240,2015,20,0,0,20,100.0
270240,2016,10,0,2,12,83.33333333333334
270240,2017,19,0,0,19,100.0
270240,2018,19,0,0,19,100.0
270240,2019,23,0,0,23,100.0
270240,2020,26,0,0,26,100.0
270250,2012,3,0,1,4,75.0
270250,2013,5,0,0,5,100.0
270250,2014,4,0,0,4,100.0
270250,2015,3,0,0,3,100.0
270250,2016,2,0,0,2,100.0
270250,2017,4,0,0,4,100.0
270250,2018,4,0,0,4,100.0
270250,2019,4,0,0,4,100.0
270250,2020,1,0,0,1,100.0
270255,2012,5,0,1,6,83.33333333333334
270255,2013,5,0,0,5,100.0
270255,2014,4,0,1,5,80.0
270255,2015,10,0,2,12,83.33333333333334
270255,2016,9,0,0,9,100.0
270255,2017,9,0,0,9,100.0
270255,2018,1,0,2,3,33.33333333333333
270255,2019,8,0,0,8,100.0
270255,2020,10,0,0,10,100.0
270260,2012,2,0,0,2,100.0
270260,2013,4,0,0,4,100.0
270260,2014,8,0,1,9,88.88888888888889
270260,2015,4,0,0,4,100.0
270260,2016,5,2,2,9,77.77777777777779
270260,2017,7,0,0,7,100.0
270260,2018,5,0,0,5,100.0
270260,2019,2,0,0,2,100.0
270260,2020,9,0,0,9,100.0
270270,2012,0,0,1,1,0.0
270270,2014,0,1,3,4,25.0
270270,2015,0,0,2,2,0.0
270270,2016,0,0,3,3,0.0
270270,2017,0,0,4,4,0.0
270270,2019,0,0,1,1,0.0
270270,2020,0,1,1,2,50.0
270280,2012,5,0,0,5,100.0
270280,2013,1,0,0,1,100.0
270280,2014,2,0,1,3,66.66666666666666
270280,2015,5,0,0,5,100.0
270280,2016,4,0,1,5,80.0
270280,2017,2,0,0,2,100.0
270280,2018,9,0,0,9,100.0
270280,2019,5,0,0,5,100.0
270280,2020,4,0,0,4,100.0
270290,2012,14,0,0,14,100.0
270290,2013,7,0,0,7,100.0
270290,2014,8,0,0,8,100.0
270290,2015,5,0,0,5,100.0
270290,2016,14,1,0,15,100.0
270290,2017,13,0,0,13,100.0
270290,2018,16,0,0,16,100.0
270290,2019,14,0,0,14,100.0
270290,2020,10,0,0,10,100.0
270300,2012,1,0,3,4,25.0
270300,2013,6,0,0,6,100.0
270300,2014,7,0,0,7,100.0
270300,2015,3,0,1,4,75.0
270300,2016,6,0,0,6,100.0
270300,2017,6,0,0,6,100.0
270300,2018,1,0,2,3,33.33333333333333
270300,2019,9,0,0,9,100.0
270300,2020,6,0,0,6,100.0
270310,2012,18,0,2,20,90.0
270310,2013,6,0,0,6,100.0
270310,2014,8,0,0,8,100.0
270310,2015,7,0,1,8,87.5
270310,2016,12,0,0,12,100.0
270310,2017,9,0,0,9,100.0
270310,2018,14,0,0,14,100.0
270310,2019,8,0,0,8,100.0
270310,2020,13,0,0,13,100.0
270320,2012,1,1,1,3,66.66666666666666
270320,2013,5,0,0,5,100.0
270320,2014,7,0,0,7,100.0
270320,2015,5,0,0,5,100.0
270320,2016,5,0,0,5,100.0
270320,2017,7,0,0,7,100.0
270320,2018,9,0,0,9,100.0
270320,2019,5,0,0,5,100.0
270320,2020,4,0,0,4,100.0
270330,2012,6,0,0,6,100.0
270330,2013,2,0,0,2,100.0
270330,2014,4,0,2,6,66.66666666666666
270330,2015,4,0,2,6,66.66666666666666
270330,2016,8,0,2,10,80.0
270330,2017,5,0,1,6,83.33333333333334
270330,2018,4,1,0,5,100.0
270330,2019,6,0,2,8,75.0
270330,2020,5,0,0,5,100.0
270340,2012,1,0,0,1,100.0
270340,2013,5,0,0,5,100.0
270340,2014,2,0,0,2,100.0
270340,2015,2,0,0,2,100.0
270340,2016,1,0,0,1,100.0
270340,2018,1,0,0,1,100.0
270340,2019,2,0,0,2,100.0
270340,2020,1,0,0,1,100.0
270350,2012,0,0,2,2,0.0
270350,2013,2,0,0,2,100.0
270350,2014,0,0,3,3,0.0
270350,2016,0,0,1,1,0.0
270350,2017,1,0,1,2,50.0
270350,2019,2,0,0,2,100.0
270350,2020,1,0,0,1,100.0
270360,2012,2,0,0,2,100.0
270360,2013,2,0,0,2,100.0
270360,2014,4,0,0,4,100.0
270360,2015,1,1,2,4,50.0
270360,2016,0,0,1,1,0.0
270360,2017,0,0,1,1,0.0
270360,2018,0,0,2,2,0.0
270360,2019,0,0,6,6,0.0
270360,2020,0,2,2,4,50.0
270370,2012,4,0,0,4,100.0
270370,2014,1,0,0,1,100.0
270370,2015,3,0,0,3,100.0
270370,2016,1,0,0,1,100.0
270370,2017,3,0,0,3,100.0
270370,2018,4,0,0,4,100.0
270370,2020,1,0,1,2,50.0
270375,2012,4,0,0,4,100.0
270375,2013,4,0,0,4,100.0
270375,2014,1,0,0,1,100.0
270375,2015,2,0,0,2,100.0
270375,2016,2,0,0,2,100.0
270375,2017,3,0,0,3,100.0
270375,2018,2,0,0,2,100.0
270375,2019,1,0,0,1,100.0
270375,2020,4,0,0,4,100.0
270380,2012,3,0,5,8,37.5
270380,2013,4,0,2,6,66.66666666666666
270380,2014,9,0,0,9,100.0
270380,2015,4,0,2,6,66.66666666666666
270380,2016,0,0,6,6,0.0
270380,2017,8,0,0,8,100.0
270380,2018,6,0,0,6,100.0
270380,2019,10,0,0,10,100.0
270380,2020,7,0,0,7,100.0
270390,2012,3,0,1,4,75.0
270390,2013,3,0,1,4,75.0
270390,2014,1,0,0,1,100.0
270390,2015,2,0,0,2,100.0
270390,2016,3,0,0,3,100.0
270390,2017,2,0,2,4,50.0
270390,2018,1,0,1,2,50.0
270390,2020,2,0,0,2,100.0
270400,2012,9,0,0,9,100.0
270400,2013,9,0,1,10,90.0
270400,2014,7,0,0,7,100.0
270400,2015,6,0,0,6,100.0
270400,2016,6,0,0,6,100.0
270400,2017,9,0,0,9,100.0
270400,2018,8,0,0,8,100.0
270400,2019,8,0,0,8,100.0
270400,2020,10,0,0,10,100.0
270410,2012,5,1,1,7,85.71428571428571
270410,2013,12,0,0,12,100.0
270410,2014,5,0,0,5,100.0
270410,2015,3,0,0,3,100.0
270410,2016,5,0,0,5,100.0
270410,2017,7,0,1,8,87.5
270410,2018,3,0,0,3,100.0
270410,2019,11,0,0,11,100.0
270410,2020,9,0,0,9,100.0
270420,2012,6,0,0,6,100.0
270420,2013,3,0,0,3,100.0
270420,2014,10,0,0,10,100.0
270420,2015,8,0,1,9,88.88888888888889
270420,2016,8,0,0,8,100.0
270420,2017,5,0,0,5,100.0
270420,2018,4,0,0,4,100.0
270420,2019,11,0,0,11,100.0
270420,2020,9,0,0,9,100.0
270430,2012,247,5,160,412,61.165048543689316
270430,2013,328,6,66,400,83.5
270430,2014,323,4,94,421,77.67220902612827
270430,2015,272,8,115,395,70.88607594936708
270430,2016,330,5,79,414,80.91787439613528
270430,2017,351,4,35,390,91.02564102564102
270430,2018,306,3,50,359,86.0724233983287
270430,2019,294,1,35,330,89.39393939393939
270430,2020,354,26,44,424,89.62264150943396
270440,2012,2,0,4,6,33.33333333333333
270440,2013,11,0,0,11,100.0
270440,2014,7,0,1,8,87.5
270440,2015,4,0,0,4,100.0
270440,2016,6,0,0,6,100.0
270440,2017,6,0,0,6,100.0
270440,2018,13,0,0,13,100.0
270440,2019,7,0,0,7,100.0
270440,2020,5,0,0,5,100.0
270450,2012,9,0,1,10,90.0
270450,2013,7,0,3,10,70.0
270450,2014,9,0,7,16,56.25
270450,2015,7,0,3,10,70.0
270450,2016,14,0,1,15,93.33333333333333
270450,2017,6,0,2,8,75.0
270450,2018,16,0,0,16,100.0
270450,2019,13,0,0,13,100.0
270450,2020,10,0,0,10,100.0
270460,2012,9,0,0,9,100.0
270460,2013,2,0,0,2,100.0
270460,2014,2,0,0,2,100.0
270460,2015,3,0,0,3,100.0
270460,2016,2,0,2,4,50.0
270460,2017,4,0,0,4,100.0
270460,2018,4,0,0,4,100.0
270460,2019,1,0,0,1,100.0
270460,2020,3,1,0,4,100.0
270470,2012,17,0,0,17,100.0
270470,2013,21,0,0,21,100.0
270470,2014,26,0,0,26,100.0
270470,2015,15,0,0,15,100.0
270470,2016,29,0,0,29,100.0
270470,2017,17,0,5,22,77.27272727272727
270470,2018,14,0,0,14,100.0
270470,2019,17,0,0,17,100.0
270470,2020,23,0,0,23,100.0
270480,2012,4,0,2,6,66.66666666666666
270480,2013,5,0,3,8,62.5
270480,2014,0,0,5,5,0.0
270480,2015,2,0,0,2,100.0
270480,2016,3,0,1,4,75.0
270480,2017,10,0,0,10,100.0
270480,2018,3,1,3,7,57.14285714285714
270480,2019,1,0,0,1,100.0
270480,2020,4,0,0,4,100.0
270490,2013,2,0,0,2,100.0
270490,2014,2,0,0,2,100.0
270490,2015,1,0,1,2,50.0
270490,2016,1,0,0,1,100.0
270490,2017,2,0,0,2,100.0
270490,2018,0,0,2,2,0.0
270490,2020,1,2,0,3,100.0
270500,2012,3,0,2,5,60.0
270500,2013,5,0,2,7,71.42857142857143
270500,2014,4,0,0,4,100.0
270500,2015,3,0,0,3,100.0
270500,2016,5,0,1,6,83.33333333333334
270500,2017,8,0,0,8,100.0
270500,2018,5,0,1,6,83.33333333333334
270500,2019,7,0,2,9,77.77777777777779
270500,2020,2,0,1,3,66.66666666666666
270510,2012,7,0,4,11,63.63636363636363
270510,2013,13,0,0,13,100.0
270510,2014,11,0,3,14,78.57142857142857
270510,2015,4,0,2,6,66.66666666666666
270510,2016,12,0,2,14,85.71428571428571
270510,2017,10,0,3,13,76.92307692307693
270510,2018,10,0,2,12,83.33333333333334
270510,2019,12,0,1,13,92.3076923076923
270510,2020,4,0,1,5,80.0
270520,2012,5,0,0,5,100.0
270520,2013,6,0,1,7,85.71428571428571
270520,2014,7,0,0,7,100.0
270520,2015,5,0,0,5,100.0
270520,2016,7,0,0,7,100.0
270520,2017,7,0,0,7,100.0
270520,2018,10,0,0,10,100.0
270520,2019,6,0,0,6,100.0
270520,2020,13,0,0,13,100.0
270530,2012,2,0,1,3,66.66666666666666
270530,2013,0,0,2,2,0.0
270530,2014,0,0,2,2,0.0
270530,2015,0,0,1,1,0.0
270530,2016,1,0,0,1,100.0
270530,2018,3,0,0,3,100.0
270530,2019,0,0,2,2,0.0
270530,2020,0,0,1,1,0.0
270540,2012,4,0,0,4,100.0
270540,2013,4,0,0,4,100.0
270540,2014,5,0,0,5,100.0
270540,2015,1,0,0,1,100.0
270540,2016,4,0,1,5,80.0
270540,2017,1,0,0,1,100.0
270540,2018,3,0,0,3,100.0
270540,2019,2,0,0,2,100.0
270540,2020,2,0,0,2,100.0
270550,2012,7,0,9,16,43.75
270550,2013,6,0,1,7,85.71428571428571
270550,2014,7,0,2,9,77.77777777777779
270550,2015,11,0,5,16,68.75
270550,2016,7,0,0,7,100.0
270550,2017,13,0,0,13,100.0
270550,2018,8,0,0,8,100.0
270550,2019,5,0,0,5,100.0
270550,2020,12,1,1,14,92.85714285714286
270560,2012,2,0,0,2,100.0
270560,2013,7,0,1,8,87.5
270560,2014,3,0,0,3,100.0
270560,2015,4,0,0,4,100.0
270560,2016,7,0,0,7,100.0
270560,2017,4,0,2,6,66.66666666666666
270560,2018,4,0,3,7,57.14285714285714
270560,2019,3,0,0,3,100.0
270560,2020,2,0,1,3,66.66666666666666
270570,2012,4,0,3,7,57.14285714285714
270570,2013,10,0,0,10,100.0
270570,2014,5,0,1,6,83.33333333333334
270570,2015,5,0,0,5,100.0
270570,2016,2,0,4,6,33.33333333333333
270570,2017,6,0,0,6,100.0
270570,2018,4,0,0,4,100.0
270570,2019,6,0,0,6,100.0
270570,2020,7,0,2,9,77.77777777777779
270580,2012,0,0,2,2,0.0
270580,2013,0,0,2,2,0.0
270580,2014,1,0,1,2,50.0
270580,2015,3,0,0,3,100.0
270580,2016,2,0,0,2,100.0
270580,2017,2,0,0,2,100.0
270580,2018,2,0,0,2,100.0
270580,2019,4,0,1,5,80.0
270580,2020,2,0,1,3,66.66666666666666
270590,2012,0,1,1,2,50.0
270590,2013,2,0,0,2,100.0
270590,2014,1,0,0,1,100.0
270590,2015,1,0,0,1,100.0
270590,2016,0,0,1,1,0.0
270590,2017,2,1,0,3,100.0
270590,2019,4,1,0,5,100.0
270590,2020,4,0,0,4,100.0
270600,2012,5,0,0,5,100.0
270600,2013,2,0,0,2,100.0
270600,2014,4,0,0,4,100.0
270600,2015,6,0,0,6,100.0
270600,2016,4,0,0,4,100.0
270600,2017,3,0,0,3,100.0
270600,2018,1,0,0,1,100.0
270600,2019,6,0,1,7,85.71428571428571
270600,2020,3,0,0,3,100.0
270610,2013,1,0,0,1,100.0
270610,2014,1,0,1,2,50.0
270610,2015,0,0,2,2,0.0
270610,2016,1,0,0,1,100.0
270610,2017,5,0,0,5,100.0
270610,2018,5,0,0,5,100.0
270610,2019,4,0,0,4,100.0
270610,2020,5,0,0,5,100.0
270620,2012,2,0,0,2,100.0
270620,2013,3,0,0,3,100.0
270620,2014,2,0,0,2,100.0
270620,2018,0,1,2,3,33.33333333333333
270620,2019,0,0,2,2,0.0
270630,2012,28,0,3,31,90.32258064516128
270630,2013,31,0,2,33,93.93939393939394
270630,2014,33,0,0,33,100.0
270630,2015,34,0,1,35,97.14285714285714
270630,2016,25,0,0,25,100.0
270630,2017,25,0,0,25,100.0
270630,2018,29,0,0,29,100.0
270630,2019,26,0,0,26,100.0
270630,2020,24,0,0,24,100.0
270640,2012,9,0,0,9,100.0
270640,2013,6,0,0,6,100.0
270640,2014,4,0,0,4,100.0
270640,2015,8,0,0,8,100.0
270640,2016,3,0,0,3,100.0
270640,2017,11,0,0,11,100.0
270640,2018,1,0,0,1,100.0
270640,2019,6,0,0,6,100.0
270640,2020,8,0,0,8,100.0
270642,2012,1,0,0,1,100.0
270642,2013,2,0,0,2,100.0
270642,2014,4,0,0,4,100.0
270642,2015,3,0,0,3,100.0
270642,2016,3,0,0,3,100.0
270642,2017,2,0,0,2,100.0
270642,2018,3,0,0,3,100.0
270642,2019,5,0,0,5,100.0
270642,2020,3,0,0,3,100.0
270644,2012,9,0,0,9,100.0
270644,2013,4,0,0,4,100.0
270644,2014,3,0,0,3,100.0
270644,2015,2,0,0,2,100.0
270644,2016,7,0,0,7,100.0
270644,2017,7,0,0,7,100.0
270644,2018,8,0,1,9,88.88888888888889
270644,2019,5,0,1,6,83.33333333333334
270644,2020,4,0,0,4,100.0
270650,2012,3,0,0,3,100.0
270650,2013,3,0,1,4,75.0
270650,2014,6,0,0,6,100.0
270650,2015,6,0,0,6,100.0
270650,2016,3,0,0,3,100.0
270650,2017,5,0,0,5,100.0
270650,2018,3,0,0,3,100.0
270650,2019,5,0,0,5,100.0
270650,2020,5,0,0,5,100.0
270660,2012,3,0,0,3,100.0
270660,2013,4,0,0,4,100.0
270660,2014,1,0,0,1,100.0
270660,2015,3,0,1,4,75.0
270660,2016,3,0,0,3,100.0
270660,2017,4,0,0,4,100.0
270660,2018,3,0,0,3,100.0
270660,2019,2,0,0,2,100.0
270660,2020,4,0,0,4,100.0
270670,2012,17,0,7,24,70.83333333333334
270670,2013,26,0,1,27,96.29629629629629
270670,2014,25,0,0,25,100.0
270670,2015,18,0,2,20,90.0
270670,2016,22,0,0,22,100.0
270670,2017,23,0,0,23,100.0
270670,2018,15,0,0,15,100.0
270670,2019,21,0,1,22,95.45454545454545
270670,2020,22,0,0,22,100.0
270680,2012,5,0,0,5,100.0
270680,2013,6,0,0,6,100.0
270680,2014,3,0,0,3,100.0
270680,2015,4,0,0,4,100.0
270680,2016,7,0,0,7,100.0
270680,2017,3,0,0,3,100.0
270680,2018,3,0,1,4,75.0
270680,2019,7,0,0,7,100.0
270680,2020,9,0,0,9,100.0
270690,2012,16,0,3,19,84.21052631578947
270690,2013,18,0,2,20,90.0
270690,2014,16,0,0,16,100.0
270690,2015,11,0,0,11,100.0
270690,2016,20,0,0,20,100.0
270690,2017,14,0,0,14,100.0
270690,2018,14,0,0,14,100.0
270690,2019,15,0,0,15,100.0
270690,2020,15,0,1,16,93.75
270700,2013,1,0,0,1,100.0
270700,2014,3,0,0,3,100.0
270700,2015,1,0,0,1,100.0
270700,2019,2,0,0,2,100.0
270710,2012,4,0,2,6,66.66666666666666
270710,2013,10,0,0,10,100.0
270710,2014,8,0,0,8,100.0
270710,2015,10,0,0,10,100.0
270710,2016,1,0,1,2,50.0
270710,2017,11,0,1,12,91.66666666666666
270710,2018,4,0,0,4,100.0
270710,2019,6,0,0,6,100.0
270710,2020,6,0,0,6,100.0
270720,2012,2,0,0,2,100.0
270720,2013,1,0,0,1,100.0
270720,2014,3,0,0,3,100.0
270720,2015,2,0,0,2,100.0
270720,2016,2,0,0,2,100.0
270720,2017,5,0,0,5,100.0
270720,2018,2,0,0,2,100.0
270720,2019,3,0,0,3,100.0
270720,2020,4,1,0,5,100.0
270730,2012,7,0,0,7,100.0
270730,2013,7,0,0,7,100.0
270730,2014,11,0,0,11,100.0
270730,2015,6,0,0,6,100.0
270730,2016,9,0,0,9,100.0
270730,2017,9,0,0,9,100.0
270730,2018,7,0,0,7,100.0
270730,2019,10,0,1,11,90.9090909090909
270730,2020,15,0,5,20,75.0
270740,2012,3,0,0,3,100.0
270740,2013,1,0,0,1,100.0
270740,2014,2,0,1,3,66.66666666666666
270740,2015,1,0,2,3,33.33333333333333
270740,2016,2,0,2,4,50.0
270740,2017,1,0,0,1,100.0
270740,2018,2,0,0,2,100.0
270740,2019,1,0,0,1,100.0
270740,2020,1,0,1,2,50.0
270750,2012,1,0,5,6,16.666666666666664
270750,2013,8,0,0,8,100.0
270750,2014,5,0,1,6,83.33333333333334
270750,2015,2,0,2,4,50.0
270750,2016,7,0,2,9,77.77777777777779
270750,2017,7,0,0,7,100.0
270750,2018,3,0,0,3,100.0
270750,2019,10,0,0,10,100.0
270750,2020,3,0,0,3,100.0
270760,2012,4,0,0,4,100.0
270760,2013,12,0,0,12,100.0
270760,2014,4,0,0,4,100.0
270760,2015,4,0,0,4,100.0
270760,2016,8,0,0,8,100.0
270760,2017,5,0,0,5,100.0
270760,2018,3,0,0,3,100.0
270760,2020,3,0,0,3,100.0
270770,2012,12,3,19,34,44.11764705882353
270770,2013,34,0,1,35,97.14285714285714
270770,2014,27,0,2,29,93.10344827586206
270770,2015,28,0,0,28,100.0
270770,2016,27,0,1,28,96.42857142857143
270770,2017,13,1,24,38,36.84210526315789
270770,2018,22,0,7,29,75.86206896551724
270770,2019,10,3,15,28,46.42857142857143
270770,2020,0,14,22,36,38.88888888888889
270780,2012,3,0,0,3,100.0
270780,2013,6,0,0,6,100.0
270780,2014,4,0,0,4,100.0
270780,2015,1,0,0,1,100.0
270780,2016,3,0,0,3,100.0
270780,2017,3,0,0,3,100.0
270780,2019,4,0,0,4,100.0
270780,2020,4,0,0,4,100.0
270790,2012,1,0,0,1,100.0
270790,2013,6,0,0,6,100.0
270790,2014,3,0,0,3,100.0
270790,2015,1,0,0,1,100.0
270790,2016,3,0,0,3,100.0
270790,2017,5,0,0,5,100.0
270790,2018,2,0,0,2,100.0
270790,2019,2,0,0,2,100.0
270800,2012,20,0,0,20,100.0
270800,2013,10,0,0,10,100.0
270800,2014,11,0,0,11,100.0
270800,2015,15,0,1,16,93.75
270800,2016,10,0,0,10,100.0
270800,2017,17,0,0,17,100.0
270800,2018,13,0,0,13,100.0
270800,2019,19,0,0,19,100.0
270800,2020,12,1,0,13,100.0
270810,2012,6,0,0,6,100.0
270810,2013,4,0,0,4,100.0
270810,2014,2,0,0,2,100.0
270810,2015,3,0,0,3,100.0
270810,2016,3,0,0,3,100.0
270810,2017,4,0,0,4,100.0
270810,2018,4,0,0,4,100.0
270810,2019,3,0,0,3,100.0
270810,2020,5,0,0,5,100.0
270820,2012,4,0,0,4,100.0
270820,2014,2,0,0,2,100.0
270820,2015,2,0,0,2,100.0
270820,2016,2,0,0,2,100.0
270820,2017,1,0,0,1,100.0
270820,2019,1,0,0,1,100.0
270820,2020,2,0,0,2,100.0
270830,2012,17,0,0,17,100.0
270830,2013,13,0,3,16,81.25
270830,2014,11,0,0,11,100.0
270830,2015,8,0,0,8,100.0
270830,2016,8,0,0,8,100.0
270830,2017,8,0,0,8,100.0
270830,2018,5,0,0,5,100.0
270830,2019,7,0,0,7,100.0
270830,2020,11,0,0,11,100.0
270840,2012,8,0,1,9,88.88888888888889
270840,2013,8,0,0,8,100.0
270840,2014,15,0,0,15,100.0
270840,2015,11,0,0,11,100.0
270840,2016,11,0,0,11,100.0
270840,2017,11,0,0,11,100.0
270840,2018,10,0,0,10,100.0
270840,2019,14,0,0,14,100.0
270840,2020,11,0,0,11,100.0
270850,2012,12,0,0,12,100.0
270850,2013,13,0,0,13,100.0
270850,2014,13,0,1,14,92.85714285714286
270850,2015,12,0,0,12,100.0
270850,2016,15,0,0,15,100.0
270850,2017,16,0,0,16,100.0
270850,2018,13,0,0,13,100.0
270850,2019,13,0,0,13,100.0
270850,2020,8,0,0,8,100.0
270860,2012,20,0,7,27,74.07407407407408
270860,2013,18,0,11,29,62.06896551724138
270860,2014,24,0,0,24,100.0
270860,2015,14,1,0,15,100.0
270860,2016,16,0,0,16,100.0
270860,2017,23,0,0,23,100.0
270860,2018,13,0,0,13,100.0
270860,2019,17,1,0,18,100.0
270860,2020,18,0,0,18,100.0
270870,2013,3,0,0,3,100.0
270870,2014,3,0,0,3,100.0
270870,2015,3,0,0,3,100.0
270870,2019,2,0,0,2,100.0
270870,2020,3,0,1,4,75.0
270880,2012,20,0,0,20,100.0
270880,2013,9,0,0,9,100.0
270880,2014,16,0,0,16,100.0
270880,2015,10,0,0,10,100.0
270880,2016,14,0,0,14,100.0
270880,2017,16,0,0,16,100.0
270880,2018,6,0,0,6,100.0
270880,2019,5,0,0,5,100.0
270880,2020,13,0,0,13,100.0
270890,2012,7,0,0,7,100.0
270890,2013,4,0,0,4,100.0
270890,2014,4,0,1,5,80.0
270890,2015,6,0,0,6,100.0
270890,2016,9,0,0,9,100.0
270890,2017,5,0,0,5,100.0
270890,2018,6,0,0,6,100.0
270890,2019,7,0,0,7,100.0
270890,2020,8,0,0,8,100.0
270895,2012,2,0,0,2,100.0
270895,2013,9,0,0,9,100.0
270895,2014,3,0,0,3,100.0
270895,2015,2,0,0,2,100.0
270895,2016,6,0,1,7,85.71428571428571
270895,2017,6,0,0,6,100.0
270895,2018,3,0,0,3,100.0
270895,2019,4,0,0,4,100.0
270895,2020,4,0,0,4,100.0
270900,2012,2,0,1,3,66.66666666666666
270900,2013,3,0,0,3,100.0
270900,2014,1,0,0,1,100.0
270900,2015,3,0,0,3,100.0
270900,2016,0,0,2,2,0.0
270900,2017,2,0,0,2,100.0
270900,2018,1,0,2,3,33.33333333333333
270900,2019,3,1,0,4,100.0
270900,2020,2,0,0,2,100.0
270910,2012,5,0,0,5,100.0
270910,2013,7,0,0,7,100.0
270910,2014,5,0,0,5,100.0
270910,2015,3,0,0,3,100.0
270910,2016,6,0,0,6,100.0
270910,2017,7,0,0,7,100.0
270910,2018,5,0,0,5,100.0
270910,2019,7,0,0,7,100.0
270910,2020,5,0,0,5,100.0
270915,2012,16,0,1,17,94.11764705882352
270915,2013,19,0,1,20,95.0
270915,2014,19,0,2,21,90.47619047619048
270915,2015,15,0,1,16,93.75
270915,2016,13,0,0,13,100.0
270915,2017,22,0,0,22,100.0
270915,2018,17,0,0,17,100.0
270915,2019,19,0,0,19,100.0
270915,2020,22,0,0,22,100.0
270920,2012,0,1,4,5,20.0
270920,2013,8,0,0,8,100.0
270920,2014,2,0,0,2,100.0
270920,2015,9,0,0,9,100.0
270920,2016,3,2,0,5,100.0
270920,2017,4,0,0,4,100.0
270920,2018,9,0,0,9,100.0
270920,2019,6,0,0,6,100.0
270920,2020,5,0,0,5,100.0
270930,2012,25,0,0,25,100.0
270930,2013,32,0,1,33,96.96969696969697
270930,2014,20,0,5,25,80.0
270930,2015,18,0,0,18,100.0
270930,2016,18,0,2,20,90.0
270930,2017,14,0,3,17,82.35294117647058
270930,2018,23,0,0,23,100.0
270930,2019,28,0,0,28,100.0
270930,2020,30,0,0,30,100.0
270940,2012,10,0,0,10,100.0
270940,2013,4,1,5,10,50.0
270940,2014,3,0,0,3,100.0
270940,2015,5,0,1,6,83.33333333333334
270940,2016,11,0,0,11,100.0
270940,2017,17,0,0,17,100.0
270940,2018,6,0,0,6,100.0
270940,2019,7,0,0,7,100.0
270940,2020,10,0,0,10,100.0
280000,2012,0,1,1,2,50.0
280000,2013,0,0,5,5,0.0
280000,2014,0,0,2,2,0.0
280000,2015,0,0,1,1,0.0
280000,2016,0,0,6,6,0.0
280000,2018,0,0,1,1,0.0
280000,2019,0,0,1,1,0.0
280010,2013,1,0,0,1,100.0
280010,2018,1,0,0,1,100.0
280010,2019,1,0,0,1,100.0
280020,2012,12,0,0,12,100.0
280020,2013,10,0,0,10,100.0
280020,2014,9,0,0,9,100.0
280020,2015,11,1,0,12,100.0
280020,2016,4,1,0,5,100.0
280020,2017,9,0,1,10,90.0
280020,2018,12,0,0,12,100.0
280020,2019,4,0,0,4,100.0
280020,2020,8,0,0,8,100.0
280030,2012,160,3,24,187,87.16577540106952
280030,2013,180,5,13,198,93.43434343434343
280030,2014,153,3,21,177,88.13559322033898
280030,2015,183,3,31,217,85.71428571428571
280030,2016,162,1,18,181,90.05524861878453
280030,2017,162,0,10,172,94.18604651162791
280030,2018,147,0,12,159,92.45283018867924
280030,2019,127,1,41,169,75.7396449704142
280030,2020,144,4,43,191,77.4869109947644
280040,2012,3,0,0,3,100.0
280040,2013,5,0,0,5,100.0
280040,2014,4,0,0,4,100.0
280040,2015,6,0,0,6,100.0
280040,2016,6,0,1,7,85.71428571428571
280040,2017,6,0,0,6,100.0
280040,2018,1,0,0,1,100.0
280040,2019,3,0,0,3,100.0
280040,2020,2,0,0,2,100.0
280050,2012,11,0,0,11,100.0
280050,2013,7,0,0,7,100.0
280050,2014,3,0,0,3,100.0
280050,2016,7,0,0,7,100.0
280050,2017,7,0,0,7,100.0
280050,2018,6,0,0,6,100.0
280050,2019,5,0,0,5,100.0
280050,2020,9,0,0,9,100.0
280060,2012,11,0,0,11,100.0
280060,2013,9,0,0,9,100.0
280060,2014,13,0,0,13,100.0
280060,2015,16,0,0,16,100.0
280060,2016,7,0,0,7,100.0
280060,2017,14,0,0,14,100.0
280060,2018,15,0,0,15,100.0
280060,2019,4,0,0,4,100.0
280060,2020,13,0,0,13,100.0
280067,2012,5,0,0,5,100.0
280067,2013,7,0,0,7,100.0
280067,2014,9,0,0,9,100.0
280067,2015,7,0,0,7,100.0
280067,2016,14,0,0,14,100.0
280067,2017,6,0,0,6,100.0
280067,2018,9,0,0,9,100.0
280067,2019,2,0,0,2,100.0
280067,2020,7,0,0,7,100.0
280070,2012,4,0,0,4,100.0
280070,2013,4,0,0,4,100.0
280070,2015,2,0,0,2,100.0
280070,2016,7,0,0,7,100.0
280070,2017,1,0,0,1,100.0
280070,2019,3,0,0,3,100.0
280070,2020,6,0,0,6,100.0
280100,2012,2,0,0,2,100.0
280100,2013,3,0,0,3,100.0
280100,2014,2,0,0,2,100.0
280100,2015,5,0,1,6,83.33333333333334
280100,2016,3,0,0,3,100.0
280100,2017,6,0,0,6,100.0
280100,2018,6,0,0,6,100.0
280100,2019,4,0,0,4,100.0
280100,2020,5,0,0,5,100.0
280110,2012,2,0,0,2,100.0
280110,2013,2,0,0,2,100.0
280110,2014,1,0,0,1,100.0
280110,2015,2,0,0,2,100.0
280110,2016,2,0,0,2,100.0
280110,2017,1,0,0,1,100.0
280110,2018,1,0,0,1,100.0
280110,2019,1,0,0,1,100.0
280110,2020,1,0,0,1,100.0
280120,2012,11,0,2,13,84.61538461538461
280120,2013,11,0,0,11,100.0
280120,2014,12,0,0,12,100.0
280120,2015,9,0,0,9,100.0
280120,2016,8,0,0,8,100.0
280120,2017,7,1,0,8,100.0
280120,2018,11,0,0,11,100.0
280120,2019,11,0,0,11,100.0
280120,2020,12,0,0,12,100.0
280130,2012,12,0,0,12,100.0
280130,2013,11,0,0,11,100.0
280130,2014,17,0,0,17,100.0
280130,2015,6,0,0,6,100.0
280130,2016,9,0,1,10,90.0
280130,2017,8,0,0,8,100.0
280130,2018,15,0,0,15,100.0
280130,2019,13,0,1,14,92.85714285714286
280130,2020,15,0,0,15,100.0
280140,2012,7,0,0,7,100.0
280140,2013,12,0,0,12,100.0
280140,2014,11,0,0,11,100.0
280140,2015,9,0,0,9,100.0
280140,2016,3,1,4,8,50.0
280140,2017,3,0,0,3,100.0
280140,2018,2,0,1,3,66.66666666666666
280140,2019,3,1,3,7,57.14285714285714
280140,2020,4,0,0,4,100.0
280150,2012,5,0,0,5,100.0
280150,2013,6,0,0,6,100.0
280150,2014,8,0,0,8,100.0
280150,2015,9,0,0,9,100.0
280150,2016,6,0,0,6,100.0
280150,2017,8,0,0,8,100.0
280150,2018,7,0,0,7,100.0
280150,2019,15,0,0,15,100.0
280150,2020,2,0,0,2,100.0
280160,2012,1,0,0,1,100.0
280160,2014,3,0,0,3,100.0
280160,2015,2,0,0,2,100.0
280160,2016,5,0,0,5,100.0
280160,2017,1,0,0,1,100.0
280160,2018,2,0,0,2,100.0
280160,2019,2,0,0,2,100.0
280160,2020,1,0,0,1,100.0
280170,2012,4,0,0,4,100.0
280170,2013,6,0,0,6,100.0
280170,2014,4,0,0,4,100.0
280170,2015,7,0,0,7,100.0
280170,2016,12,0,0,12,100.0
280170,2017,8,0,0,8,100.0
280170,2018,10,0,0,10,100.0
280170,2019,6,0,0,6,100.0
280170,2020,6,0,0,6,100.0
280190,2013,1,0,0,1,100.0
280190,2014,1,0,0,1,100.0
280190,2015,1,0,0,1,100.0
280190,2016,0,0,1,1,0.0
280190,2018,0,0,1,1,0.0
280190,2019,1,0,0,1,100.0
280190,2020,1,0,0,1,100.0
280200,2012,1,0,0,1,100.0
280200,2013,2,0,0,2,100.0
280200,2014,1,0,0,1,100.0
280200,2015,1,0,0,1,100.0
280200,2017,2,0,0,2,100.0
280200,2018,1,0,0,1,100.0
280200,2019,3,0,0,3,100.0
280200,2020,2,0,0,2,100.0
280210,2012,25,0,0,25,100.0
280210,2013,23,0,0,23,100.0
280210,2014,24,0,0,24,100.0
280210,2015,20,0,0,20,100.0
280210,2016,24,0,0,24,100.0
280210,2017,29,0,0,29,100.0
280210,2018,28,0,0,28,100.0
280210,2019,19,0,0,19,100.0
280210,2020,32,0,0,32,100.0
280220,2012,2,0,0,2,100.0
280220,2013,3,0,0,3,100.0
280220,2014,4,0,0,4,100.0
280220,2015,1,0,0,1,100.0
280220,2016,3,0,0,3,100.0
280220,2017,1,0,0,1,100.0
280220,2018,2,0,0,2,100.0
280220,2019,2,0,0,2,100.0
280220,2020,1,0,0,1,100.0
280230,2012,5,0,0,5,100.0
280230,2013,3,0,0,3,100.0
280230,2014,5,0,0,5,100.0
280230,2015,8,0,0,8,100.0
280230,2017,6,0,0,6,100.0
280230,2018,2,0,0,2,100.0
280230,2019,3,0,0,3,100.0
280230,2020,8,0,1,9,88.88888888888889
280240,2012,5,0,0,5,100.0
280240,2013,2,0,0,2,100.0
280240,2014,2,0,0,2,100.0
280240,2015,4,0,0,4,100.0
280240,2016,4,0,0,4,100.0
280240,2017,2,0,0,2,100.0
280240,2018,3,0,0,3,100.0
280240,2019,3,0,0,3,100.0
280240,2020,1,0,0,1,100.0
280250,2012,1,0,0,1,100.0
280250,2013,3,0,0,3,100.0
280250,2014,1,0,0,1,100.0
280250,2016,1,0,0,1,100.0
280250,2018,1,0,0,1,100.0
280250,2019,1,0,0,1,100.0
280260,2012,1,0,0,1,100.0
280260,2013,2,0,0,2,100.0
280260,2014,1,0,0,1,100.0
280260,2016,2,0,0,2,100.0
280260,2017,2,0,0,2,100.0
280260,2019,1,0,1,2,50.0
280260,2020,0,0,3,3,0.0
280270,2014,3,0,0,3,100.0
280270,2015,2,0,0,2,100.0
280270,2016,1,0,0,1,100.0
280270,2017,4,0,0,4,100.0
280270,2018,6,0,0,6,100.0
280270,2019,1,0,0,1,100.0
280270,2020,5,0,0,5,100.0
280280,2012,2,0,0,2,100.0
280280,2013,6,0,0,6,100.0
280280,2014,3,0,0,3,100.0
280280,2015,4,0,0,4,100.0
280280,2016,6,0,1,7,85.71428571428571
280280,2017,2,0,0,2,100.0
280280,2018,3,0,0,3,100.0
280280,2019,7,0,0,7,100.0
280280,2020,6,0,1,7,85.71428571428571
280290,2012,33,0,0,33,100.0
280290,2013,37,0,0,37,100.0
280290,2014,39,1,0,40,100.0
280290,2015,38,0,2,40,95.0
280290,2016,39,0,1,40,97.5
280290,2017,34,1,4,39,89.74358974358975
280290,2018,41,0,0,41,100.0
280290,2019,19,0,1,20,95.0
280290,2020,35,0,1,36,97.22222222222221
280300,2012,12,0,0,12,100.0
280300,2013,18,0,0,18,100.0
280300,2014,10,0,0,10,100.0
280300,2015,17,0,0,17,100.0
280300,2016,9,0,0,9,100.0
280300,2017,15,0,0,15,100.0
280300,2018,12,0,0,12,100.0
280300,2019,20,0,0,20,100.0
280300,2020,15,0,0,15,100.0
280310,2012,2,0,0,2,100.0
280310,2013,1,0,1,2,50.0
280310,2016,0,0,1,1,0.0
280310,2017,2,0,1,3,66.66666666666666
280310,2020,1,0,0,1,100.0
280320,2012,8,0,1,9,88.88888888888889
280320,2013,15,0,0,15,100.0
280320,2014,14,0,1,15,93.33333333333333
280320,2015,10,0,1,11,90.9090909090909
280320,2016,16,0,0,16,100.0
280320,2017,10,0,1,11,90.9090909090909
280320,2018,14,0,2,16,87.5
280320,2019,8,1,1,10,90.0
280320,2020,11,0,4,15,73.33333333333333
280330,2012,5,0,0,5,100.0
280330,2013,10,0,0,10,100.0
280330,2014,3,0,0,3,100.0
280330,2015,4,0,0,4,100.0
280330,2016,1,0,0,1,100.0
280330,2017,4,0,0,4,100.0
280330,2018,2,0,1,3,66.66666666666666
280330,2019,5,0,0,5,100.0
280330,2020,7,0,0,7,100.0
280340,2012,5,1,1,7,85.71428571428571
280340,2013,8,0,0,8,100.0
280340,2014,2,0,1,3,66.66666666666666
280340,2015,1,0,0,1,100.0
280340,2016,1,0,4,5,20.0
280340,2017,5,0,0,5,100.0
280340,2018,5,0,0,5,100.0
280340,2019,3,0,0,3,100.0
280340,2020,4,0,0,4,100.0
280350,2012,25,0,0,25,100.0
280350,2013,37,0,0,37,100.0
280350,2014,42,0,0,42,100.0
280350,2015,43,0,0,43,100.0
280350,2016,41,0,0,41,100.0
280350,2017,25,0,5,30,83.33333333333334
280350,2018,22,0,2,24,91.66666666666666
280350,2019,20,1,7,28,75.0
280350,2020,24,1,6,31,80.64516129032258
280360,2012,5,0,0,5,100.0
280360,2013,9,0,0,9,100.0
280360,2014,14,0,0,14,100.0
280360,2015,15,0,1,16,93.75
280360,2016,8,0,0,8,100.0
280360,2017,8,0,0,8,100.0
280360,2018,10,0,0,10,100.0
280360,2019,12,0,0,12,100.0
280360,2020,16,0,0,16,100.0
280370,2012,3,0,0,3,100.0
280370,2013,1,0,0,1,100.0
280370,2014,3,0,0,3,100.0
280370,2015,1,0,0,1,100.0
280370,2016,1,0,0,1,100.0
280370,2017,4,0,0,4,100.0
280370,2018,4,0,0,4,100.0
280370,2020,1,0,0,1,100.0
280380,2013,2,0,0,2,100.0
280380,2014,4,0,0,4,100.0
280380,2015,1,0,0,1,100.0
280380,2016,1,0,0,1,100.0
280380,2017,2,0,0,2,100.0
280380,2018,2,0,0,2,100.0
280380,2019,2,0,0,2,100.0
280380,2020,3,0,0,3,100.0
280390,2012,5,0,0,5,100.0
280390,2013,1,0,0,1,100.0
280390,2014,1,0,0,1,100.0
280390,2015,3,0,0,3,100.0
280390,2016,2,0,0,2,100.0
280390,2017,6,0,0,6,100.0
280390,2018,3,0,0,3,100.0
280390,2019,3,0,0,3,100.0
280390,2020,2,0,2,4,50.0
280400,2012,7,0,0,7,100.0
280400,2013,14,0,1,15,93.33333333333333
280400,2014,8,0,0,8,100.0
280400,2015,5,0,0,5,100.0
280400,2016,2,0,0,2,100.0
280400,2017,8,0,0,8,100.0
280400,2018,9,0,0,9,100.0
280400,2019,6,0,0,6,100.0
280400,2020,9,0,2,11,81.81818181818183
280410,2012,4,0,0,4,100.0
280410,2013,6,0,0,6,100.0
280410,2014,4,0,0,4,100.0
280410,2015,2,0,0,2,100.0
280410,2016,6,0,0,6,100.0
280410,2017,4,0,0,4,100.0
280410,2018,4,0,0,4,100.0
280410,2019,4,0,0,4,100.0
280410,2020,4,0,0,4,100.0
280420,2012,2,0,0,2,100.0
280420,2013,4,0,0,4,100.0
280420,2014,5,0,0,5,100.0
280420,2015,3,0,0,3,100.0
280420,2016,8,0,0,8,100.0
280420,2017,5,0,0,5,100.0
280420,2019,6,0,0,6,100.0
280420,2020,6,0,0,6,100.0
280430,2012,5,0,0,5,100.0
280430,2013,5,0,0,5,100.0
280430,2014,9,0,0,9,100.0
280430,2015,5,0,0,5,100.0
280430,2016,2,0,0,2,100.0
280430,2017,3,0,0,3,100.0
280430,2018,1,0,0,1,100.0
280430,2020,2,0,0,2,100.0
280440,2012,4,0,0,4,100.0
280440,2013,2,0,0,2,100.0
280440,2014,7,0,0,7,100.0
280440,2015,7,0,0,7,100.0
280440,2016,11,0,0,11,100.0
280440,2017,9,0,0,9,100.0
280440,2018,3,1,0,4,100.0
280440,2019,6,0,0,6,100.0
280440,2020,2,0,0,2,100.0
280445,2013,4,0,0,4,100.0
280445,2014,3,0,0,3,100.0
280445,2015,1,0,0,1,100.0
280445,2016,1,0,0,1,100.0
280445,2018,3,0,0,3,100.0
280445,2019,1,0,0,1,100.0
280445,2020,0,0,2,2,0.0
280450,2012,8,0,0,8,100.0
280450,2013,10,0,0,10,100.0
280450,2014,13,0,0,13,100.0
280450,2015,10,0,0,10,100.0
280450,2016,12,0,0,12,100.0
280450,2017,14,0,1,15,93.33333333333333
280450,2018,14,0,0,14,100.0
280450,2019,10,0,1,11,90.9090909090909
280450,2020,12,0,3,15,80.0
280460,2012,10,0,0,10,100.0
280460,2013,7,0,0,7,100.0
280460,2014,9,0,0,9,100.0
280460,2015,11,0,0,11,100.0
280460,2016,9,0,0,9,100.0
280460,2017,6,0,1,7,85.71428571428571
280460,2018,7,1,1,9,88.88888888888889
280460,2019,8,0,0,8,100.0
280460,2020,7,0,0,7,100.0
280470,2012,2,0,0,2,100.0
280470,2013,2,0,0,2,100.0
280470,2015,1,0,0,1,100.0
280470,2016,1,0,0,1,100.0
280470,2017,5,0,0,5,100.0
280470,2018,4,0,0,4,100.0
280470,2019,4,0,0,4,100.0
280470,2020,2,0,0,2,100.0
280480,2012,75,1,1,77,98.7012987012987
280480,2013,53,0,0,53,100.0
280480,2014,59,1,0,60,100.0
280480,2015,60,0,0,60,100.0
280480,2016,70,1,0,71,100.0
280480,2017,71,0,0,71,100.0
280480,2018,49,0,0,49,100.0
280480,2019,58,0,0,58,100.0
280480,2020,61,0,0,61,100.0
280490,2012,4,0,0,4,100.0
280490,2013,5,0,0,5,100.0
280490,2014,6,0,0,6,100.0
280490,2015,1,0,0,1,100.0
280490,2016,3,0,0,3,100.0
280490,2017,5,0,0,5,100.0
280490,2018,4,0,0,4,100.0
280490,2019,4,0,0,4,100.0
280490,2020,2,0,0,2,100.0
280500,2012,1,0,0,1,100.0
280500,2013,2,0,1,3,66.66666666666666
280500,2014,1,0,0,1,100.0
280500,2016,2,0,0,2,100.0
280500,2017,2,0,0,2,100.0
280500,2019,2,0,0,2,100.0
280500,2020,2,0,0,2,100.0
280510,2012,4,0,0,4,100.0
280510,2013,2,0,0,2,100.0
280510,2014,5,0,0,5,100.0
280510,2015,4,0,0,4,100.0
280510,2016,2,0,0,2,100.0
280510,2017,4,0,0,4,100.0
280510,2018,6,0,2,8,75.0
280510,2019,2,0,2,4,50.0
280510,2020,2,1,1,4,75.0
280520,2012,4,0,0,4,100.0
280520,2013,3,0,0,3,100.0
280520,2014,5,0,0,5,100.0
280520,2015,1,0,0,1,100.0
280520,2016,4,0,0,4,100.0
280520,2018,3,0,0,3,100.0
280520,2019,4,0,0,4,100.0
280520,2020,3,0,0,3,100.0
280530,2012,2,0,0,2,100.0
280530,2013,9,0,0,9,100.0
280530,2014,3,0,0,3,100.0
280530,2015,3,0,0,3,100.0
280530,2016,1,0,0,1,100.0
280530,2017,2,0,1,3,66.66666666666666
280530,2018,2,0,0,2,100.0
280530,2019,1,0,0,1,100.0
280530,2020,3,0,0,3,100.0
280540,2012,8,0,0,8,100.0
280540,2013,7,0,0,7,100.0
280540,2014,7,0,0,7,100.0
280540,2015,11,0,0,11,100.0
280540,2016,4,0,0,4,100.0
280540,2017,16,0,6,22,72.72727272727273
280540,2018,10,0,0,10,100.0
280540,2019,10,0,0,10,100.0
280540,2020,9,0,0,9,100.0
280550,2012,3,0,0,3,100.0
280550,2013,5,0,0,5,100.0
280550,2014,6,0,0,6,100.0
280550,2015,5,0,2,7,71.42857142857143
280550,2016,7,0,1,8,87.5
280550,2017,7,0,0,7,100.0
280550,2018,4,0,0,4,100.0
280550,2019,6,0,2,8,75.0
280550,2020,8,0,0,8,100.0
280560,2012,11,0,0,11,100.0
280560,2013,3,0,0,3,100.0
280560,2014,13,0,1,14,92.85714285714286
280560,2015,7,0,0,7,100.0
280560,2016,3,0,0,3,100.0
280560,2017,9,0,0,9,100.0
280560,2018,6,0,0,6,100.0
280560,2019,9,0,0,9,100.0
280560,2020,8,0,0,8,100.0
280570,2012,11,0,0,11,100.0
280570,2013,14,0,0,14,100.0
280570,2014,5,0,0,5,100.0
280570,2015,10,0,0,10,100.0
280570,2016,18,0,1,19,94.73684210526315
280570,2017,11,0,1,12,91.66666666666666
280570,2018,11,0,0,11,100.0
280570,2019,9,0,4,13,69.23076923076923
280570,2020,2,0,15,17,11.76470588235294
280580,2012,10,0,0,10,100.0
280580,2013,4,0,0,4,100.0
280580,2014,3,0,2,5,60.0
280580,2015,5,0,0,5,100.0
280580,2016,7,0,0,7,100.0
280580,2017,1,3,2,6,66.66666666666666
280580,2018,6,1,0,7,100.0
280580,2019,11,0,0,11,100.0
280580,2020,7,0,0,7,100.0
280590,2012,2,0,0,2,100.0
280590,2013,4,0,1,5,80.0
280590,2014,2,0,0,2,100.0
280590,2015,3,0,0,3,100.0
280590,2016,4,0,0,4,100.0
280590,2017,4,0,0,4,100.0
280590,2018,3,0,0,3,100.0
280590,2019,3,0,0,3,100.0
280590,2020,4,0,0,4,100.0
280600,2012,5,0,0,5,100.0
280600,2013,5,0,0,5,100.0
280600,2014,10,0,2,12,83.33333333333334
280600,2015,5,0,0,5,100.0
280600,2016,3,0,0,3,100.0
280600,2017,5,0,1,6,83.33333333333334
280600,2018,4,0,0,4,100.0
280600,2019,4,0,0,4,100.0
280600,2020,6,0,0,6,100.0
280610,2012,4,0,0,4,100.0
280610,2013,5,0,0,5,100.0
280610,2014,5,0,0,5,100.0
280610,2015,3,0,0,3,100.0
280610,2016,8,0,0,8,100.0
280610,2017,6,0,0,6,100.0
280610,2018,3,0,2,5,60.0
280610,2019,1,1,0,2,100.0
280610,2020,1,0,0,1,100.0
280620,2012,5,0,0,5,100.0
280620,2013,4,0,4,8,50.0
280620,2014,6,0,0,6,100.0
280620,2015,5,0,1,6,83.33333333333334
280620,2016,3,0,3,6,50.0
280620,2017,3,1,5,9,44.44444444444444
280620,2018,5,0,0,5,100.0
280620,2019,10,0,1,11,90.9090909090909
280620,2020,2,1,2,5,60.0
280630,2012,3,0,0,3,100.0
280630,2013,5,0,0,5,100.0
280630,2014,2,0,0,2,100.0
280630,2015,2,1,0,3,100.0
280630,2016,6,0,0,6,100.0
280630,2017,5,0,0,5,100.0
280630,2018,2,0,0,2,100.0
280630,2019,3,0,1,4,75.0
280630,2020,5,0,0,5,100.0
280640,2012,2,0,0,2,100.0
280640,2013,1,0,0,1,100.0
280640,2014,2,0,0,2,100.0
280640,2015,1,0,0,1,100.0
280640,2016,2,0,0,2,100.0
280640,2017,1,0,1,2,50.0
280640,2018,2,0,0,2,100.0
280640,2019,4,1,0,5,100.0
280640,2020,3,0,0,3,100.0
280650,2012,1,0,0,1,100.0
280650,2013,2,0,0,2,100.0
280650,2015,2,0,0,2,100.0
280650,2017,2,0,0,2,100.0
280650,2018,1,0,0,1,100.0
280650,2019,2,0,0,2,100.0
280650,2020,0,0,1,1,0.0
280660,2012,3,0,0,3,100.0
280660,2013,3,0,0,3,100.0
280660,2014,3,0,0,3,100.0
280660,2015,1,0,0,1,100.0
280660,2016,3,0,0,3,100.0
280660,2017,3,0,0,3,100.0
280660,2018,5,0,0,5,100.0
280660,2019,4,0,0,4,100.0
280660,2020,1,0,2,3,33.33333333333333
280670,2012,25,0,2,27,92.5925925925926
280670,2013,34,0,2,36,94.44444444444444
280670,2014,33,0,6,39,84.61538461538461
280670,2015,36,0,4,40,90.0
280670,2016,24,1,2,27,92.5925925925926
280670,2017,33,1,2,36,94.44444444444444
280670,2018,28,0,2,30,93.33333333333333
280670,2019,25,0,1,26,96.15384615384616
280670,2020,32,0,0,32,100.0
280680,2013,1,0,0,1,100.0
280680,2014,4,0,0,4,100.0
280680,2015,2,0,0,2,100.0
280680,2016,2,0,0,2,100.0
280680,2017,4,0,0,4,100.0
280680,2019,2,0,0,2,100.0
280680,2020,2,0,0,2,100.0
280690,2013,1,0,0,1,100.0
280690,2014,2,0,0,2,100.0
280690,2015,1,0,0,1,100.0
280690,2016,1,0,0,1,100.0
280690,2017,1,0,0,1,100.0
280690,2018,2,0,0,2,100.0
280690,2019,2,0,0,2,100.0
280690,2020,1,0,0,1,100.0
280700,2012,1,0,0,1,100.0
280700,2013,1,0,0,1,100.0
280700,2014,1,0,0,1,100.0
280700,2015,3,2,0,5,100.0
280700,2016,1,0,0,1,100.0
280700,2017,1,0,0,1,100.0
280700,2018,3,0,0,3,100.0
280700,2019,2,0,0,2,100.0
280700,2020,1,0,1,2,50.0
280710,2012,20,0,1,21,95.23809523809523
280710,2013,11,0,0,11,100.0
280710,2014,10,0,0,10,100.0
280710,2015,15,0,0,15,100.0
280710,2016,18,0,0,18,100.0
280710,2017,13,0,0,13,100.0
280710,2018,8,0,0,8,100.0
280710,2019,18,0,0,18,100.0
280710,2020,17,0,0,17,100.0
280720,2014,2,0,0,2,100.0
280720,2016,2,0,0,2,100.0
280720,2017,2,0,0,2,100.0
280720,2018,6,0,0,6,100.0
280720,2019,6,0,0,6,100.0
280720,2020,3,0,0,3,100.0
280730,2018,1,0,0,1,100.0
280730,2019,1,0,0,1,100.0
280740,2012,18,0,2,20,90.0
280740,2013,15,0,0,15,100.0
280740,2014,24,0,0,24,100.0
280740,2015,20,0,0,20,100.0
280740,2016,16,0,0,16,100.0
280740,2017,13,0,0,13,100.0
280740,2018,18,0,0,18,100.0
280740,2019,14,0,0,14,100.0
280740,2020,10,0,1,11,90.9090909090909
280750,2012,5,0,0,5,100.0
280750,2013,5,0,0,5,100.0
280750,2014,7,0,0,7,100.0
280750,2015,7,0,0,7,100.0
280750,2016,6,0,0,6,100.0
280750,2017,4,0,0,4,100.0
280750,2018,2,0,0,2,100.0
280750,2019,3,0,0,3,100.0
280750,2020,11,0,0,11,100.0
280760,2012,12,0,0,12,100.0
280760,2013,14,0,0,14,100.0
280760,2014,12,0,0,12,100.0
280760,2015,12,0,0,12,100.0
280760,2016,13,0,3,16,81.25
280760,2017,2,0,7,9,22.22222222222222
280760,2018,12,0,0,12,100.0
280760,2019,5,0,0,5,100.0
280760,2020,5,0,4,9,55.55555555555556
290000,2012,0,3,11,14,21.428571428571427
290000,2013,13,5,14,32,56.25
290000,2014,1,3,13,17,23.52941176470588
290000,2015,2,3,11,16,31.25
290000,2016,0,3,15,18,16.666666666666664
290000,2017,1,1,8,10,20.0
290000,2018,0,1,7,8,12.5
290000,2019,0,1,11,12,8.333333333333332
290000,2020,3,3,10,16,37.5
290010,2013,3,0,0,3,100.0
290010,2014,1,0,3,4,25.0
290010,2015,1,0,0,1,100.0
290010,2016,5,0,0,5,100.0
290010,2017,1,0,0,1,100.0
290010,2019,0,0,1,1,0.0
290010,2020,2,0,0,2,100.0
290020,2012,5,0,0,5,100.0
290020,2013,5,0,0,5,100.0
290020,2014,5,0,0,5,100.0
290020,2015,8,0,0,8,100.0
290020,2016,8,0,0,8,100.0
290020,2017,6,0,0,6,100.0
290020,2018,7,0,0,7,100.0
290020,2019,4,0,0,4,100.0
290020,2020,7,0,0,7,100.0
290030,2012,5,0,1,6,83.33333333333334
290030,2013,2,0,0,2,100.0
290030,2014,6,0,0,6,100.0
290030,2015,0,1,4,5,20.0
290030,2016,1,0,8,9,11.11111111111111
290030,2017,4,0,0,4,100.0
290030,2018,4,0,0,4,100.0
290030,2019,6,0,0,6,100.0
290030,2020,8,0,0,8,100.0
290035,2012,6,0,0,6,100.0
290035,2013,2,0,0,2,100.0
290035,2014,4,0,0,4,100.0
290035,2015,2,0,0,2,100.0
290035,2016,7,0,0,7,100.0
290035,2017,5,0,0,5,100.0
290035,2018,3,0,0,3,100.0
290035,2019,1,0,2,3,33.33333333333333
290035,2020,8,0,0,8,100.0
290040,2012,2,0,0,2,100.0
290040,2013,6,0,1,7,85.71428571428571
290040,2014,0,0,6,6,0.0
290040,2015,0,0,3,3,0.0
290040,2016,3,0,0,3,100.0
290040,2017,5,0,0,5,100.0
290040,2018,2,0,0,2,100.0
290040,2019,1,0,6,7,14.285714285714285
290040,2020,4,0,0,4,100.0
290050,2012,2,0,0,2,100.0
290050,2013,5,0,0,5,100.0
290050,2015,1,0,0,1,100.0
290050,2016,2,0,0,2,100.0
290050,2017,3,0,0,3,100.0
290050,2018,3,0,0,3,100.0
290050,2019,2,0,0,2,100.0
290050,2020,3,0,0,3,100.0
290060,2012,1,0,0,1,100.0
290060,2013,1,0,0,1,100.0
290060,2014,2,0,0,2,100.0
290060,2016,2,0,0,2,100.0
290060,2017,2,0,0,2,100.0
290060,2019,0,0,1,1,0.0
290070,2012,47,0,9,56,83.92857142857143
290070,2013,61,0,2,63,96.82539682539682
290070,2014,54,0,0,54,100.0
290070,2015,65,0,0,65,100.0
290070,2016,60,2,0,62,100.0
290070,2017,52,0,0,52,100.0
290070,2018,63,0,0,63,100.0
290070,2019,65,0,0,65,100.0
290070,2020,68,0,1,69,98.55072463768117
290080,2012,3,1,1,5,80.0
290080,2013,4,0,2,6,66.66666666666666
290080,2014,7,0,0,7,100.0
290080,2015,14,0,0,14,100.0
290080,2016,7,0,0,7,100.0
290080,2017,0,0,11,11,0.0
290080,2018,0,0,10,10,0.0
290080,2019,1,0,10,11,9.090909090909092
290080,2020,0,0,3,3,0.0
290090,2012,1,0,1,2,50.0
290090,2014,0,0,2,2,0.0
290090,2015,2,1,0,3,100.0
290090,2016,5,0,0,5,100.0
290090,2017,1,0,0,1,100.0
290090,2018,0,0,3,3,0.0
290090,2019,1,0,2,3,33.33333333333333
290090,2020,2,0,3,5,40.0
290100,2012,12,0,6,18,66.66666666666666
290100,2013,9,0,1,10,90.0
290100,2014,13,2,0,15,100.0
290100,2015,7,0,0,7,100.0
290100,2016,14,0,1,15,93.33333333333333
290100,2017,12,0,0,12,100.0
290100,2018,12,0,0,12,100.0
290100,2019,15,0,3,18,83.33333333333334
290100,2020,11,0,0,11,100.0
290110,2012,11,0,1,12,91.66666666666666
290110,2013,4,0,2,6,66.66666666666666
290110,2014,4,0,5,9,44.44444444444444
290110,2015,0,0,5,5,0.0
290110,2016,0,1,5,6,16.666666666666664
290110,2017,6,0,1,7,85.71428571428571
290110,2018,10,0,1,11,90.9090909090909
290110,2019,3,0,1,4,75.0
290110,2020,7,1,1,9,88.88888888888889
290115,2012,4,0,1,5,80.0
290115,2013,4,0,1,5,80.0
290115,2014,5,0,0,5,100.0
290115,2015,1,0,0,1,100.0
290115,2016,5,0,1,6,83.33333333333334
290115,2017,3,0,0,3,100.0
290115,2018,5,0,0,5,100.0
290115,2019,1,0,0,1,100.0
290115,2020,4,0,0,4,100.0
290120,2012,1,0,2,3,33.33333333333333
290120,2013,5,0,1,6,83.33333333333334
290120,2014,3,0,0,3,100.0
290120,2015,6,0,0,6,100.0
290120,2016,1,0,2,3,33.33333333333333
290120,2017,2,0,2,4,50.0
290120,2018,5,0,1,6,83.33333333333334
290120,2019,2,0,2,4,50.0
290120,2020,4,0,4,8,50.0
290130,2012,6,0,0,6,100.0
290130,2013,2,0,0,2,100.0
290130,2014,3,0,0,3,100.0
290130,2015,3,0,0,3,100.0
290130,2016,4,0,0,4,100.0
290130,2017,5,0,0,5,100.0
290130,2018,3,0,0,3,100.0
290130,2019,5,0,0,5,100.0
290130,2020,6,0,0,6,100.0
290135,2012,0,1,5,6,16.666666666666664
290135,2013,0,0,2,2,0.0
290135,2014,0,1,1,2,50.0
290135,2015,2,0,2,4,50.0
290135,2016,0,1,0,1,100.0
290135,2017,0,1,1,2,50.0
290135,2018,0,0,2,2,0.0
290135,2019,0,0,7,7,0.0
290135,2020,0,1,8,9,11.11111111111111
290140,2012,4,0,0,4,100.0
290140,2013,5,0,0,5,100.0
290140,2014,3,0,0,3,100.0
290140,2015,6,0,0,6,100.0
290140,2016,3,0,1,4,75.0
290140,2017,4,0,0,4,100.0
290140,2018,9,0,0,9,100.0
290140,2019,2,0,0,2,100.0
290140,2020,1,0,0,1,100.0
290150,2012,3,0,0,3,100.0
290150,2013,1,0,0,1,100.0
290150,2014,7,0,0,7,100.0
290150,2015,2,0,0,2,100.0
290150,2016,2,0,0,2,100.0
290150,2017,5,0,0,5,100.0
290150,2018,1,0,0,1,100.0
290150,2019,1,0,0,1,100.0
290150,2020,1,0,0,1,100.0
290160,2012,2,0,0,2,100.0
290160,2013,3,0,0,3,100.0
290160,2014,5,0,0,5,100.0
290160,2015,1,0,0,1,100.0
290160,2016,4,0,0,4,100.0
290160,2017,4,0,0,4,100.0
290160,2018,4,0,0,4,100.0
290160,2019,3,0,0,3,100.0
290160,2020,4,0,0,4,100.0
290170,2012,6,0,0,6,100.0
290170,2013,5,0,0,5,100.0
290170,2014,2,0,2,4,50.0
290170,2015,2,0,4,6,33.33333333333333
290170,2016,4,0,0,4,100.0
290170,2017,1,0,1,2,50.0
290170,2018,1,0,0,1,100.0
290170,2019,1,0,1,2,50.0
290170,2020,1,0,1,2,50.0
290180,2012,4,0,0,4,100.0
290180,2013,2,0,0,2,100.0
290180,2014,4,0,0,4,100.0
290180,2015,3,0,0,3,100.0
290180,2016,6,0,0,6,100.0
290180,2017,2,0,0,2,100.0
290180,2019,3,0,0,3,100.0
290180,2020,4,0,0,4,100.0
290190,2012,7,0,2,9,77.77777777777779
290190,2013,8,0,0,8,100.0
290190,2014,6,0,1,7,85.71428571428571
290190,2015,1,0,2,3,33.33333333333333
290190,2016,3,0,0,3,100.0
290190,2017,3,0,1,4,75.0
290190,2018,3,0,0,3,100.0
290190,2019,7,0,0,7,100.0
290190,2020,4,0,0,4,100.0
290195,2012,3,1,1,5,80.0
290195,2014,0,0,1,1,0.0
290195,2016,0,1,2,3,33.33333333333333
290195,2017,2,0,0,2,100.0
290195,2018,2,0,0,2,100.0
290195,2020,0,0,2,2,0.0
290200,2012,6,0,0,6,100.0
290200,2013,4,0,0,4,100.0
290200,2014,3,0,0,3,100.0
290200,2015,6,0,1,7,85.71428571428571
290200,2016,3,0,0,3,100.0
290200,2017,5,0,0,5,100.0
290200,2018,6,0,0,6,100.0
290200,2019,5,0,0,5,100.0
290200,2020,6,0,0,6,100.0
290205,2012,1,0,1,2,50.0
290205,2013,1,0,3,4,25.0
290205,2014,2,0,1,3,66.66666666666666
290205,2015,6,0,1,7,85.71428571428571
290205,2016,2,0,2,4,50.0
290205,2017,3,0,1,4,75.0
290205,2018,4,0,1,5,80.0
290205,2019,8,0,0,8,100.0
290205,2020,0,1,4,5,20.0
290210,2012,7,0,4,11,63.63636363636363
290210,2013,9,1,6,16,62.5
290210,2014,7,0,4,11,63.63636363636363
290210,2015,3,1,15,19,21.052631578947366
290210,2016,6,1,4,11,63.63636363636363
290210,2017,17,0,0,17,100.0
290210,2018,13,0,0,13,100.0
290210,2019,11,0,1,12,91.66666666666666
290210,2020,15,1,2,18,88.88888888888889
290220,2012,4,0,0,4,100.0
290220,2013,3,0,0,3,100.0
290220,2014,3,0,0,3,100.0
290220,2015,4,0,0,4,100.0
290220,2016,4,0,0,4,100.0
290220,2017,0,0,4,4,0.0
290220,2018,1,0,4,5,20.0
290220,2019,0,2,1,3,66.66666666666666
290220,2020,0,4,4,8,50.0
290225,2012,3,0,1,4,75.0
290225,2013,0,0,3,3,0.0
290225,2014,1,0,1,2,50.0
290225,2015,5,0,0,5,100.0
290225,2016,4,0,2,6,66.66666666666666
290225,2017,1,0,5,6,16.666666666666664
290225,2018,0,0,6,6,0.0
290225,2019,2,0,1,3,66.66666666666666
290225,2020,0,0,2,2,0.0
290230,2012,1,0,1,2,50.0
290230,2014,6,0,0,6,100.0
290230,2015,5,0,0,5,100.0
290230,2016,1,0,0,1,100.0
290230,2017,1,0,0,1,100.0
290230,2018,1,0,1,2,50.0
290230,2019,3,0,0,3,100.0
290230,2020,4,0,0,4,100.0
290240,2012,2,0,1,3,66.66666666666666
290240,2013,3,2,2,7,71.42857142857143
290240,2014,6,0,0,6,100.0
290240,2015,4,0,0,4,100.0
290240,2016,5,0,0,5,100.0
290240,2017,0,0,3,3,0.0
290240,2018,1,1,2,4,50.0
290240,2019,6,0,2,8,75.0
290240,2020,2,0,3,5,40.0
290250,2012,2,0,0,2,100.0
290250,2013,2,0,5,7,28.57142857142857
290250,2014,1,0,5,6,16.666666666666664
290250,2015,0,0,5,5,0.0
290250,2016,1,0,5,6,16.666666666666664
290250,2017,0,0,3,3,0.0
290250,2018,1,0,4,5,20.0
290250,2019,0,0,1,1,0.0
290250,2020,2,0,0,2,100.0
290260,2012,10,0,0,10,100.0
290260,2013,7,0,0,7,100.0
290260,2014,7,0,1,8,87.5
290260,2015,4,0,0,4,100.0
290260,2016,5,0,1,6,83.33333333333334
290260,2017,4,0,0,4,100.0
290260,2018,6,0,0,6,100.0
290260,2019,11,0,0,11,100.0
290260,2020,0,1,9,10,10.0
290265,2012,4,0,0,4,100.0
290265,2013,2,0,0,2,100.0
290265,2014,2,0,0,2,100.0
290265,2015,0,0,1,1,0.0
290265,2016,0,1,2,3,33.33333333333333
290265,2017,0,0,3,3,0.0
290265,2018,0,0,1,1,0.0
290265,2019,0,0,1,1,0.0
290265,2020,0,0,3,3,0.0
290270,2012,10,0,2,12,83.33333333333334
290270,2013,14,0,1,15,93.33333333333333
290270,2014,10,0,1,11,90.9090909090909
290270,2015,16,1,2,19,89.47368421052632
290270,2016,9,1,2,12,83.33333333333334
290270,2017,10,0,1,11,90.9090909090909
290270,2018,11,0,3,14,78.57142857142857
290270,2019,1,0,12,13,7.6923076923076925
290270,2020,4,0,10,14,28.57142857142857
290280,2012,10,0,0,10,100.0
290280,2013,8,0,0,8,100.0
290280,2014,10,0,0,10,100.0
290280,2015,12,0,0,12,100.0
290280,2016,6,0,0,6,100.0
290280,2017,3,0,0,3,100.0
290280,2018,9,0,0,9,100.0
290280,2019,0,0,9,9,0.0
290280,2020,8,0,1,9,88.88888888888889
290290,2012,14,1,2,17,88.23529411764706
290290,2013,10,0,1,11,90.9090909090909
290290,2014,4,0,5,9,44.44444444444444
290290,2015,13,0,0,13,100.0
290290,2016,11,0,4,15,73.33333333333333
290290,2017,11,0,1,12,91.66666666666666
290290,2018,6,0,11,17,35.294117647058826
290290,2019,4,0,13,17,23.52941176470588
290290,2020,0,0,11,11,0.0
290300,2012,3,0,0,3,100.0
290300,2013,8,0,0,8,100.0
290300,2014,2,0,0,2,100.0
290300,2015,8,0,0,8,100.0
290300,2016,3,0,0,3,100.0
290300,2017,4,0,0,4,100.0
290300,2018,6,0,0,6,100.0
290300,2019,3,0,0,3,100.0
290300,2020,4,0,0,4,100.0
290310,2013,1,0,0,1,100.0
290310,2014,2,0,0,2,100.0
290310,2015,1,0,0,1,100.0
290310,2016,4,0,0,4,100.0
290310,2017,1,1,0,2,100.0
290310,2018,1,0,1,2,50.0
290310,2019,0,0,1,1,0.0
290310,2020,2,0,0,2,100.0
290320,2012,58,0,0,58,100.0
290320,2013,49,0,1,50,98.0
290320,2014,56,0,0,56,100.0
290320,2015,52,0,0,52,100.0
290320,2016,52,1,0,53,100.0
290320,2017,52,0,0,52,100.0
290320,2018,45,1,4,50,92.0
290320,2019,62,0,0,62,100.0
290320,2020,53,0,0,53,100.0
290323,2012,5,0,0,5,100.0
290323,2013,7,0,0,7,100.0
290323,2014,1,0,0,1,100.0
290323,2015,2,0,0,2,100.0
290323,2016,4,0,0,4,100.0
290323,2017,10,0,0,10,100.0
290323,2018,9,0,0,9,100.0
290323,2019,6,0,0,6,100.0
290323,2020,6,0,0,6,100.0
290327,2012,3,0,1,4,75.0
290327,2013,6,0,0,6,100.0
290327,2014,2,0,0,2,100.0
290327,2015,7,0,0,7,100.0
290327,2016,3,0,1,4,75.0
290327,2017,4,0,0,4,100.0
290327,2018,2,0,0,2,100.0
290327,2019,4,0,0,4,100.0
290327,2020,1,0,0,1,100.0
290330,2012,5,0,0,5,100.0
290330,2013,3,0,0,3,100.0
290330,2014,4,0,0,4,100.0
290330,2015,5,0,0,5,100.0
290330,2016,4,0,0,4,100.0
290330,2017,2,0,0,2,100.0
290330,2018,4,0,0,4,100.0
290330,2019,3,0,0,3,100.0
290330,2020,6,0,0,6,100.0
290340,2012,11,0,0,11,100.0
290340,2013,16,0,0,16,100.0
290340,2014,7,0,0,7,100.0
290340,2015,14,0,0,14,100.0
290340,2016,5,0,0,5,100.0
290340,2017,14,0,0,14,100.0
290340,2018,6,0,0,6,100.0
290340,2019,9,0,0,9,100.0
290340,2020,11,0,0,11,100.0
290350,2012,3,1,1,5,80.0
290350,2013,8,0,4,12,66.66666666666666
290350,2014,4,0,1,5,80.0
290350,2015,10,0,2,12,83.33333333333334
290350,2016,6,0,4,10,60.0
290350,2017,9,0,0,9,100.0
290350,2018,5,0,2,7,71.42857142857143
290350,2019,8,0,2,10,80.0
290350,2020,1,0,6,7,14.285714285714285
290360,2012,3,0,5,8,37.5
290360,2013,5,0,0,5,100.0
290360,2014,7,0,0,7,100.0
290360,2015,7,0,0,7,100.0
290360,2016,6,0,0,6,100.0
290360,2017,3,0,0,3,100.0
290360,2018,4,0,0,4,100.0
290360,2019,1,0,3,4,25.0
290360,2020,3,1,2,6,66.66666666666666
290370,2012,4,0,0,4,100.0
290370,2013,4,0,0,4,100.0
290370,2014,3,0,0,3,100.0
290370,2015,5,0,0,5,100.0
290370,2016,2,0,0,2,100.0
290370,2017,5,0,2,7,71.42857142857143
290370,2018,2,0,0,2,100.0
290370,2019,2,0,5,7,28.57142857142857
290370,2020,1,0,4,5,20.0
290380,2012,4,0,0,4,100.0
290380,2013,8,0,1,9,88.88888888888889
290380,2014,4,0,0,4,100.0
290380,2015,1,1,1,3,66.66666666666666
290380,2016,0,0,5,5,0.0
290380,2017,10,0,1,11,90.9090909090909
290380,2018,6,0,0,6,100.0
290380,2019,2,0,0,2,100.0
290380,2020,0,0,7,7,0.0
290390,2012,13,0,0,13,100.0
290390,2013,23,0,0,23,100.0
290390,2014,25,0,0,25,100.0
290390,2015,30,0,0,30,100.0
290390,2016,29,0,0,29,100.0
290390,2017,23,0,0,23,100.0
290390,2018,25,0,0,25,100.0
290390,2019,16,0,0,16,100.0
290390,2020,25,0,0,25,100.0
290395,2012,1,0,2,3,33.33333333333333
290395,2013,3,0,0,3,100.0
290395,2014,1,0,0,1,100.0
290395,2015,1,1,0,2,100.0
290395,2016,2,0,0,2,100.0
290395,2017,0,0,2,2,0.0
290395,2018,6,0,2,8,75.0
290395,2019,2,0,0,2,100.0
290395,2020,0,1,1,2,50.0
290400,2012,2,0,0,2,100.0
290400,2013,3,0,0,3,100.0
290400,2014,5,0,0,5,100.0
290400,2015,6,0,0,6,100.0
290400,2016,1,0,0,1,100.0
290400,2017,4,0,0,4,100.0
290400,2018,5,0,0,5,100.0
290400,2019,4,0,0,4,100.0
290400,2020,3,0,0,3,100.0
290405,2012,0,1,3,4,25.0
290405,2013,0,1,7,8,12.5
290405,2014,2,0,2,4,50.0
290405,2015,2,0,1,3,66.66666666666666
290405,2016,5,0,1,6,83.33333333333334
290405,2017,5,0,0,5,100.0
290405,2018,5,0,0,5,100.0
290405,2019,1,0,0,1,100.0
290405,2020,6,0,0,6,100.0
290410,2012,10,0,0,10,100.0
290410,2013,9,0,1,10,90.0
290410,2014,4,0,1,5,80.0
290410,2015,5,1,4,10,60.0
290410,2016,4,0,0,4,100.0
290410,2017,4,0,0,4,100.0
290410,2018,10,0,0,10,100.0
290410,2019,0,0,3,3,0.0
290410,2020,4,0,0,4,100.0
290420,2012,1,0,0,1,100.0
290420,2013,3,0,2,5,60.0
290420,2014,2,0,0,2,100.0
290420,2015,0,0,3,3,0.0
290420,2016,0,0,2,2,0.0
290420,2017,0,0,3,3,0.0
290420,2018,1,0,0,1,100.0
290420,2019,0,0,1,1,0.0
290420,2020,0,0,1,1,0.0
290430,2012,3,0,0,3,100.0
290430,2013,5,0,0,5,100.0
290430,2014,4,0,0,4,100.0
290430,2015,3,0,0,3,100.0
290430,2016,6,0,0,6,100.0
290430,2017,6,0,0,6,100.0
290430,2018,5,0,0,5,100.0
290430,2019,2,0,0,2,100.0
290430,2020,3,0,1,4,75.0
290440,2012,2,0,0,2,100.0
290440,2013,3,0,0,3,100.0
290440,2014,3,0,0,3,100.0
290440,2016,1,0,2,3,33.33333333333333
290440,2017,0,0,1,1,0.0
290440,2018,1,0,1,2,50.0
290440,2019,0,0,2,2,0.0
290440,2020,3,0,0,3,100.0
290450,2012,4,0,0,4,100.0
290450,2013,3,0,0,3,100.0
290450,2014,3,0,0,3,100.0
290450,2015,4,0,0,4,100.0
290450,2016,3,0,0,3,100.0
290450,2017,4,0,1,5,80.0
290450,2018,3,0,0,3,100.0
290450,2020,4,0,2,6,66.66666666666666
290460,2012,14,1,5,20,75.0
290460,2013,23,0,1,24,95.83333333333334
290460,2014,15,0,0,15,100.0
290460,2015,18,0,0,18,100.0
290460,2016,28,0,0,28,100.0
290460,2017,23,0,1,24,95.83333333333334
290460,2018,19,0,0,19,100.0
290460,2019,14,0,0,14,100.0
290460,2020,22,0,0,22,100.0
290470,2012,5,0,0,5,100.0
290470,2013,6,0,0,6,100.0
290470,2014,7,0,0,7,100.0
290470,2015,8,0,0,8,100.0
290470,2016,10,0,0,10,100.0
290470,2017,11,0,0,11,100.0
290470,2018,10,1,1,12,91.66666666666666
290470,2019,8,0,1,9,88.88888888888889
290470,2020,3,0,3,6,50.0
290475,2012,3,0,0,3,100.0
290475,2013,5,0,0,5,100.0
290475,2014,6,0,0,6,100.0
290475,2015,5,0,0,5,100.0
290475,2016,5,0,0,5,100.0
290475,2017,11,0,0,11,100.0
290475,2018,10,0,0,10,100.0
290475,2019,3,0,0,3,100.0
290475,2020,6,0,2,8,75.0
290480,2012,2,0,1,3,66.66666666666666
290480,2013,3,0,1,4,75.0
290480,2015,2,0,0,2,100.0
290480,2016,0,0,1,1,0.0
290480,2017,5,0,0,5,100.0
290480,2019,1,0,0,1,100.0
290480,2020,0,0,1,1,0.0
290485,2012,4,0,0,4,100.0
290485,2013,8,0,0,8,100.0
290485,2014,6,0,0,6,100.0
290485,2015,6,0,0,6,100.0
290485,2016,4,0,0,4,100.0
290485,2017,6,0,0,6,100.0
290485,2018,4,0,0,4,100.0
290485,2019,6,0,0,6,100.0
290485,2020,2,0,2,4,50.0
290490,2012,9,1,3,13,76.92307692307693
290490,2013,16,0,2,18,88.88888888888889
290490,2014,10,0,1,11,90.9090909090909
290490,2015,18,0,0,18,100.0
290490,2016,10,0,1,11,90.9090909090909
290490,2017,12,0,0,12,100.0
290490,2018,7,0,4,11,63.63636363636363
290490,2019,1,0,15,16,6.25
290490,2020,0,1,16,17,5.88235294117647
290500,2012,4,0,2,6,66.66666666666666
290500,2013,8,0,2,10,80.0
290500,2014,4,0,2,6,66.66666666666666
290500,2015,0,0,3,3,0.0
290500,2016,0,0,3,3,0.0
290500,2017,0,0,1,1,0.0
290500,2018,0,0,3,3,0.0
290500,2019,0,1,1,2,50.0
290500,2020,1,0,7,8,12.5
290510,2012,1,0,0,1,100.0
290510,2014,3,0,0,3,100.0
290510,2016,2,0,0,2,100.0
290510,2017,2,0,0,2,100.0
290510,2018,3,0,0,3,100.0
290510,2019,1,0,1,2,50.0
290510,2020,10,0,0,10,100.0
290515,2012,0,1,0,1,100.0
290515,2014,0,0,3,3,0.0
290515,2015,1,1,1,3,66.66666666666666
290515,2016,0,1,1,2,50.0
290515,2017,3,0,1,4,75.0
290515,2018,1,0,1,2,50.0
290515,2019,0,1,5,6,16.666666666666664
290515,2020,1,1,4,6,33.33333333333333
290520,2012,15,0,0,15,100.0
290520,2013,16,0,0,16,100.0
290520,2014,10,0,1,11,90.9090909090909
290520,2015,12,2,0,14,100.0
290520,2016,2,0,9,11,18.181818181818183
290520,2017,0,0,13,13,0.0
290520,2018,7,0,6,13,53.84615384615385
290520,2019,6,0,4,10,60.0
290520,2020,4,1,13,18,27.77777777777778
290530,2012,0,0,4,4,0.0
290530,2013,4,0,3,7,57.14285714285714
290530,2014,7,0,0,7,100.0
290530,2015,3,0,0,3,100.0
290530,2016,10,0,0,10,100.0
290530,2017,8,0,0,8,100.0
290530,2018,5,0,0,5,100.0
290530,2019,1,0,6,7,14.285714285714285
290530,2020,1,0,3,4,25.0
290540,2012,8,0,0,8,100.0
290540,2013,5,0,0,5,100.0
290540,2014,4,0,1,5,80.0
290540,2015,6,0,0,6,100.0
290540,2016,9,0,0,9,100.0
290540,2017,3,0,0,3,100.0
290540,2018,3,0,0,3,100.0
290540,2019,7,0,2,9,77.77777777777779
290540,2020,6,0,1,7,85.71428571428571
290550,2012,3,0,0,3,100.0
290550,2013,6,0,1,7,85.71428571428571
290550,2014,3,0,0,3,100.0
290550,2015,5,0,0,5,100.0
290550,2016,3,0,0,3,100.0
290550,2017,3,0,0,3,100.0
290550,2018,2,0,0,2,100.0
290550,2019,3,0,0,3,100.0
290550,2020,2,0,0,2,100.0
290560,2012,11,0,0,11,100.0
290560,2013,11,0,0,11,100.0
290560,2014,8,0,0,8,100.0
290560,2015,12,0,0,12,100.0
290560,2016,16,0,3,19,84.21052631578947
290560,2017,9,0,5,14,64.28571428571429
290560,2018,13,0,3,16,81.25
290560,2019,11,0,0,11,100.0
290560,2020,7,1,2,10,80.0
290570,2012,34,10,52,96,45.83333333333333
290570,2013,40,8,41,89,53.93258426966292
290570,2014,83,11,19,113,83.1858407079646
290570,2015,75,8,26,109,76.14678899082568
290570,2016,116,0,0,116,100.0
290570,2017,80,11,15,106,85.84905660377359
290570,2018,99,0,7,106,93.39622641509435
290570,2019,69,0,11,80,86.25
290570,2020,89,2,20,111,81.98198198198197
290580,2012,8,0,0,8,100.0
290580,2013,10,0,0,10,100.0
290580,2014,9,0,0,9,100.0
290580,2015,10,0,0,10,100.0
290580,2016,15,0,2,17,88.23529411764706
290580,2017,9,0,2,11,81.81818181818183
290580,2018,9,0,1,10,90.0
290580,2019,15,0,1,16,93.75
290580,2020,15,0,0,15,100.0
290590,2012,8,0,1,9,88.88888888888889
290590,2013,2,0,2,4,50.0
290590,2014,5,0,2,7,71.42857142857143
290590,2015,1,1,7,9,22.22222222222222
290590,2016,6,3,3,12,75.0
290590,2017,4,0,0,4,100.0
290590,2018,6,0,1,7,85.71428571428571
290590,2019,4,0,4,8,50.0
290590,2020,1,0,3,4,25.0
290600,2012,16,1,0,17,100.0
290600,2013,18,1,2,21,90.47619047619048
290600,2014,19,0,0,19,100.0
290600,2015,21,0,0,21,100.0
290600,2016,19,0,0,19,100.0
290600,2017,18,0,0,18,100.0
290600,2018,14,2,0,16,100.0
290600,2019,30,0,1,31,96.7741935483871
290600,2020,19,0,0,19,100.0
290610,2012,0,1,1,2,50.0
290610,2013,1,0,0,1,100.0
290610,2015,2,0,0,2,100.0
290610,2016,1,0,0,1,100.0
290610,2017,3,0,0,3,100.0
290610,2020,4,0,0,4,100.0
290620,2012,0,1,6,7,14.285714285714285
290620,2013,7,2,8,17,52.94117647058824
290620,2014,9,0,3,12,75.0
290620,2015,5,0,4,9,55.55555555555556
290620,2016,3,0,0,3,100.0
290620,2017,5,0,0,5,100.0
290620,2018,5,0,0,5,100.0
290620,2019,9,0,0,9,100.0
290620,2020,7,0,0,7,100.0
290630,2012,1,0,11,12,8.333333333333332
290630,2013,3,0,7,10,30.0
290630,2014,1,3,6,10,40.0
290630,2015,1,0,3,4,25.0
290630,2016,3,0,8,11,27.27272727272727
290630,2017,2,1,9,12,25.0
290630,2018,1,0,13,14,7.142857142857142
290630,2019,1,0,12,13,7.6923076923076925
290630,2020,1,3,7,11,36.36363636363637
290640,2012,2,0,0,2,100.0
290640,2013,4,0,0,4,100.0
290640,2015,0,0,1,1,0.0
290640,2016,0,0,3,3,0.0
290640,2017,2,0,1,3,66.66666666666666
290640,2018,3,0,0,3,100.0
290640,2019,2,0,1,3,66.66666666666666
290640,2020,0,0,3,3,0.0
290650,2012,14,9,17,40,57.49999999999999
290650,2013,3,5,27,35,22.857142857142858
290650,2014,5,4,20,29,31.03448275862069
290650,2015,0,9,30,39,23.076923076923077
290650,2016,1,9,23,33,30.303030303030305
290650,2017,4,13,18,35,48.57142857142857
290650,2018,0,1,26,27,3.7037037037037033
290650,2019,0,0,43,43,0.0
290650,2020,37,1,5,43,88.37209302325581
290660,2012,3,0,1,4,75.0
290660,2013,2,1,0,3,100.0
290660,2014,3,0,0,3,100.0
290660,2015,3,0,0,3,100.0
290660,2016,0,0,2,2,0.0
290660,2017,3,0,1,4,75.0
290660,2018,3,0,0,3,100.0
290660,2019,1,0,3,4,25.0
290660,2020,6,0,0,6,100.0
290670,2012,3,0,8,11,27.27272727272727
290670,2013,2,0,6,8,25.0
290670,2014,0,0,8,8,0.0
290670,2015,0,0,9,9,0.0
290670,2016,0,1,7,8,12.5
290670,2017,0,0,13,13,0.0
290670,2018,6,0,2,8,75.0
290670,2019,4,0,11,15,26.666666666666668
290670,2020,0,1,10,11,9.090909090909092
290680,2012,7,0,2,9,77.77777777777779
290680,2013,3,0,0,3,100.0
290680,2014,12,0,0,12,100.0
290680,2015,11,0,0,11,100.0
290680,2016,16,0,1,17,94.11764705882352
290680,2017,14,1,0,15,100.0
290680,2018,0,0,13,13,0.0
290680,2019,0,2,9,11,18.181818181818183
290680,2020,1,3,14,18,22.22222222222222
290682,2012,0,0,4,4,0.0
290682,2013,2,1,2,5,60.0
290682,2014,1,0,3,4,25.0
290682,2015,1,0,3,4,25.0
290682,2016,0,2,5,7,28.57142857142857
290682,2017,2,0,2,4,50.0
290682,2018,1,0,5,6,16.666666666666664
290682,2019,0,0,3,3,0.0
290682,2020,2,2,5,9,44.44444444444444
290685,2012,2,0,1,3,66.66666666666666
290685,2013,3,0,1,4,75.0
290685,2014,1,0,0,1,100.0
290685,2015,0,0,1,1,0.0
290685,2016,0,0,3,3,0.0
290685,2017,0,0,1,1,0.0
290685,2018,0,0,3,3,0.0
290685,2019,0,1,2,3,33.33333333333333
290685,2020,0,0,2,2,0.0
290687,2012,2,2,3,7,57.14285714285714
290687,2013,0,2,7,9,22.22222222222222
290687,2014,0,0,8,8,0.0
290687,2015,11,0,3,14,78.57142857142857
290687,2016,7,1,6,14,57.14285714285714
290687,2017,9,0,0,9,100.0
290687,2018,11,0,0,11,100.0
290687,2019,11,0,0,11,100.0
290687,2020,13,0,0,13,100.0
290689,2012,2,2,0,4,100.0
290689,2013,4,0,0,4,100.0
290689,2014,2,0,0,2,100.0
290689,2015,3,0,2,5,60.0
290689,2016,1,0,1,2,50.0
290689,2017,0,0,2,2,0.0
290689,2018,0,0,3,3,0.0
290689,2019,0,1,0,1,100.0
290689,2020,3,0,1,4,75.0
290690,2012,3,0,0,3,100.0
290690,2013,4,0,0,4,100.0
290690,2014,6,0,0,6,100.0
290690,2015,0,0,3,3,0.0
290690,2016,1,0,2,3,33.33333333333333
290690,2017,3,1,2,6,66.66666666666666
290690,2018,11,0,0,11,100.0
290690,2019,4,0,2,6,66.66666666666666
290690,2020,1,1,10,12,16.666666666666664
290700,2012,1,0,0,1,100.0
290700,2013,5,0,0,5,100.0
290700,2014,2,0,1,3,66.66666666666666
290700,2015,3,0,0,3,100.0
290700,2016,2,0,1,3,66.66666666666666
290700,2017,2,0,1,3,66.66666666666666
290700,2018,0,0,3,3,0.0
290700,2020,3,0,1,4,75.0
290710,2012,10,0,0,10,100.0
290710,2013,2,0,11,13,15.384615384615385
290710,2014,5,0,8,13,38.46153846153847
290710,2015,1,0,8,9,11.11111111111111
290710,2016,3,0,8,11,27.27272727272727
290710,2017,9,0,0,9,100.0
290710,2018,11,0,0,11,100.0
290710,2019,11,0,0,11,100.0
290710,2020,11,0,0,11,100.0
290720,2012,21,1,2,24,91.66666666666666
290720,2013,5,5,6,16,62.5
290720,2014,6,6,4,16,75.0
290720,2015,6,9,8,23,65.21739130434783
290720,2016,20,2,3,25,88.0
290720,2017,25,2,2,29,93.10344827586206
290720,2018,14,1,2,17,88.23529411764706
290720,2019,13,0,6,19,68.42105263157895
290720,2020,7,3,16,26,38.46153846153847
290730,2012,0,1,10,11,9.090909090909092
290730,2013,0,0,7,7,0.0
290730,2014,1,0,4,5,20.0
290730,2015,4,0,10,14,28.57142857142857
290730,2016,1,0,7,8,12.5
290730,2017,1,0,10,11,9.090909090909092
290730,2018,2,0,14,16,12.5
290730,2019,1,0,12,13,7.6923076923076925
290730,2020,2,0,8,10,20.0
290740,2012,1,0,0,1,100.0
290740,2013,2,0,0,2,100.0
290740,2014,2,0,0,2,100.0
290740,2015,1,0,0,1,100.0
290740,2019,1,0,0,1,100.0
290740,2020,0,0,1,1,0.0
290750,2012,21,0,0,21,100.0
290750,2013,24,0,0,24,100.0
290750,2014,16,0,0,16,100.0
290750,2015,19,0,1,20,95.0
290750,2016,18,0,0,18,100.0
290750,2017,9,0,3,12,75.0
290750,2018,11,0,6,17,64.70588235294117
290750,2019,4,0,4,8,50.0
290750,2020,13,2,7,22,68.18181818181817
290755,2012,1,0,0,1,100.0
290755,2014,0,0,1,1,0.0
290755,2015,0,0,1,1,0.0
290755,2016,0,0,3,3,0.0
290755,2018,1,0,0,1,100.0
290755,2019,2,0,1,3,66.66666666666666
290755,2020,4,0,0,4,100.0
290760,2012,0,0,5,5,0.0
290760,2013,0,1,5,6,16.666666666666664
290760,2014,6,1,1,8,87.5
290760,2015,2,0,0,2,100.0
290760,2016,5,0,3,8,62.5
290760,2017,3,0,1,4,75.0
290760,2018,1,0,1,2,50.0
290760,2019,4,0,0,4,100.0
290760,2020,5,0,1,6,83.33333333333334
290770,2012,5,0,0,5,100.0
290770,2013,1,0,0,1,100.0
290770,2014,4,0,0,4,100.0
290770,2015,5,0,0,5,100.0
290770,2016,2,0,0,2,100.0
290770,2017,3,0,0,3,100.0
290770,2018,3,0,0,3,100.0
290770,2019,3,0,0,3,100.0
290770,2020,1,0,3,4,25.0
290780,2012,12,0,0,12,100.0
290780,2013,11,0,0,11,100.0
290780,2014,16,0,0,16,100.0
290780,2015,12,0,0,12,100.0
290780,2016,9,2,1,12,91.66666666666666
290780,2017,3,0,1,4,75.0
290780,2018,8,0,0,8,100.0
290780,2019,7,0,1,8,87.5
290780,2020,10,1,2,13,84.61538461538461
290790,2012,5,0,1,6,83.33333333333334
290790,2013,8,0,0,8,100.0
290790,2014,0,0,6,6,0.0
290790,2015,0,1,5,6,16.666666666666664
290790,2016,2,0,3,5,40.0
290790,2017,4,0,1,5,80.0
290790,2018,3,0,1,4,75.0
290790,2019,2,0,3,5,40.0
290790,2020,0,0,4,4,0.0
290800,2012,9,0,0,9,100.0
290800,2013,5,0,0,5,100.0
290800,2014,11,0,0,11,100.0
290800,2015,5,0,2,7,71.42857142857143
290800,2016,8,0,1,9,88.88888888888889
290800,2017,9,0,2,11,81.81818181818183
290800,2018,8,0,1,9,88.88888888888889
290800,2019,1,0,3,4,25.0
290800,2020,8,0,0,8,100.0
290810,2012,1,0,3,4,25.0
290810,2013,0,1,4,5,20.0
290810,2014,0,0,3,3,0.0
290810,2015,1,0,3,4,25.0
290810,2017,0,0,3,3,0.0
290810,2018,0,0,5,5,0.0
290810,2019,1,0,4,5,20.0
290810,2020,1,0,4,5,20.0
290820,2012,3,1,1,5,80.0
290820,2013,11,0,0,11,100.0
290820,2014,5,0,0,5,100.0
290820,2015,5,0,0,5,100.0
290820,2016,11,1,0,12,100.0
290820,2017,5,0,2,7,71.42857142857143
290820,2018,5,0,0,5,100.0
290820,2019,6,0,0,6,100.0
290820,2020,7,1,1,9,88.88888888888889
290830,2012,8,0,0,8,100.0
290830,2013,3,0,0,3,100.0
290830,2014,5,0,0,5,100.0
290830,2015,7,0,0,7,100.0
290830,2016,10,0,0,10,100.0
290830,2017,5,0,0,5,100.0
290830,2018,5,0,0,5,100.0
290830,2019,6,0,0,6,100.0
290830,2020,7,0,0,7,100.0
290840,2012,19,0,1,20,95.0
290840,2013,19,0,0,19,100.0
290840,2014,14,0,1,15,93.33333333333333
290840,2015,13,0,1,14,92.85714285714286
290840,2016,17,1,2,20,90.0
290840,2017,22,0,1,23,95.65217391304348
290840,2018,32,0,0,32,100.0
290840,2019,18,0,1,19,94.73684210526315
290840,2020,24,0,0,24,100.0
290850,2012,8,0,1,9,88.88888888888889
290850,2013,7,0,3,10,70.0
290850,2014,9,0,3,12,75.0
290850,2015,12,0,4,16,75.0
290850,2016,1,1,8,10,20.0
290850,2017,1,0,13,14,7.142857142857142
290850,2018,12,0,1,13,92.3076923076923
290850,2019,4,0,7,11,36.36363636363637
290850,2020,10,0,2,12,83.33333333333334
290860,2012,3,0,1,4,75.0
290860,2013,1,0,5,6,16.666666666666664
290860,2014,7,0,1,8,87.5
290860,2015,0,0,7,7,0.0
290860,2016,5,1,1,7,85.71428571428571
290860,2017,8,0,0,8,100.0
290860,2018,4,0,0,4,100.0
290860,2019,2,0,4,6,33.33333333333333
290860,2020,5,0,3,8,62.5
290870,2012,2,0,0,2,100.0
290870,2013,8,0,0,8,100.0
290870,2014,4,0,0,4,100.0
290870,2015,8,1,0,9,100.0
290870,2016,3,0,0,3,100.0
290870,2017,4,0,0,4,100.0
290870,2018,2,0,0,2,100.0
290870,2019,5,0,0,5,100.0
290870,2020,7,0,0,7,100.0
290880,2012,3,0,0,3,100.0
290880,2013,1,0,0,1,100.0
290880,2014,3,0,0,3,100.0
290880,2018,2,0,0,2,100.0
290880,2019,1,0,0,1,100.0
290880,2020,2,0,0,2,100.0
290890,2012,9,0,0,9,100.0
290890,2013,6,0,2,8,75.0
290890,2014,9,0,0,9,100.0
290890,2015,7,0,0,7,100.0
290890,2016,10,0,0,10,100.0
290890,2017,6,0,3,9,66.66666666666666
290890,2018,9,0,2,11,81.81818181818183
290890,2019,5,0,2,7,71.42857142857143
290890,2020,5,3,3,11,72.72727272727273
290900,2012,0,1,0,1,100.0
290900,2013,0,0,2,2,0.0
290900,2014,1,0,0,1,100.0
290900,2015,2,0,0,2,100.0
290900,2016,0,0,3,3,0.0
290900,2017,1,0,0,1,100.0
290900,2018,0,0,1,1,0.0
290910,2012,0,1,2,3,33.33333333333333
290910,2013,0,1,1,2,50.0
290910,2014,0,2,2,4,50.0
290910,2015,2,0,0,2,100.0
290910,2016,3,0,0,3,100.0
290910,2017,3,0,0,3,100.0
290910,2018,3,0,0,3,100.0
290910,2019,0,2,2,4,50.0
290910,2020,0,2,1,3,66.66666666666666
290920,2012,7,0,0,7,100.0
290920,2013,5,0,0,5,100.0
290920,2014,3,0,0,3,100.0
290920,2015,3,0,0,3,100.0
290920,2016,3,0,2,5,60.0
290920,2018,2,0,0,2,100.0
290920,2019,4,0,0,4,100.0
290920,2020,5,0,0,5,100.0
290930,2012,7,0,3,10,70.0
290930,2013,5,1,2,8,75.0
290930,2014,8,0,0,8,100.0
290930,2015,6,0,0,6,100.0
290930,2016,2,0,0,2,100.0
290930,2017,20,0,0,20,100.0
290930,2018,9,0,1,10,90.0
290930,2019,8,0,2,10,80.0
290930,2020,7,0,0,7,100.0
290940,2012,2,0,3,5,40.0
290940,2013,0,0,1,1,0.0
290940,2014,2,0,0,2,100.0
290940,2015,4,0,5,9,44.44444444444444
290940,2016,0,0,1,1,0.0
290940,2017,0,0,4,4,0.0
290940,2018,0,0,2,2,0.0
290940,2019,0,0,2,2,0.0
290940,2020,0,0,3,3,0.0
290950,2012,0,0,1,1,0.0
290950,2013,3,0,0,3,100.0
290950,2014,2,0,1,3,66.66666666666666
290950,2016,0,0,1,1,0.0
290950,2017,0,0,4,4,0.0
290950,2018,0,0,1,1,0.0
290950,2019,0,0,2,2,0.0
290960,2012,4,0,4,8,50.0
290960,2013,1,0,4,5,20.0
290960,2014,1,1,6,8,25.0
290960,2015,4,0,1,5,80.0
290960,2016,4,0,1,5,80.0
290960,2017,7,0,1,8,87.5
290960,2018,1,1,3,5,40.0
290960,2019,4,0,4,8,50.0
290960,2020,0,1,6,7,14.285714285714285
290970,2012,1,0,0,1,100.0
290970,2013,3,0,0,3,100.0
290970,2014,1,0,0,1,100.0
290970,2015,5,0,0,5,100.0
290970,2016,4,0,1,5,80.0
290970,2017,0,0,6,6,0.0
290970,2018,0,0,3,3,0.0
290970,2019,1,0,0,1,100.0
290970,2020,7,0,0,7,100.0
290980,2012,10,0,0,10,100.0
290980,2013,23,0,0,23,100.0
290980,2014,22,0,0,22,100.0
290980,2015,22,0,0,22,100.0
290980,2016,23,2,0,25,100.0
290980,2017,22,0,1,23,95.65217391304348
290980,2018,22,0,1,23,95.65217391304348
290980,2019,15,0,0,15,100.0
290980,2020,9,0,5,14,64.28571428571429
290990,2012,10,0,0,10,100.0
290990,2013,15,0,0,15,100.0
290990,2014,13,0,0,13,100.0
290990,2015,7,0,0,7,100.0
290990,2016,8,0,0,8,100.0
290990,2017,11,0,1,12,91.66666666666666
290990,2018,11,0,0,11,100.0
290990,2019,6,0,2,8,75.0
290990,2020,2,5,8,15,46.666666666666664
291000,2013,3,0,0,3,100.0
291000,2014,1,0,0,1,100.0
291000,2015,1,0,1,2,50.0
291000,2016,4,0,0,4,100.0
291000,2017,5,0,0,5,100.0
291000,2018,4,0,0,4,100.0
291000,2019,4,0,0,4,100.0
291000,2020,1,0,0,1,100.0
291005,2012,14,7,13,34,61.76470588235294
291005,2013,21,0,5,26,80.76923076923077
291005,2014,20,3,5,28,82.14285714285714
291005,2015,13,1,1,15,93.33333333333333
291005,2016,15,1,6,22,72.72727272727273
291005,2017,22,2,8,32,75.0
291005,2018,30,0,0,30,100.0
291005,2019,26,0,2,28,92.85714285714286
291005,2020,30,0,4,34,88.23529411764706
291010,2015,1,0,0,1,100.0
291010,2016,3,0,0,3,100.0
291010,2017,3,0,0,3,100.0
291010,2018,1,0,0,1,100.0
291010,2019,6,0,0,6,100.0
291010,2020,3,0,0,3,100.0
291020,2012,4,0,0,4,100.0
291020,2013,3,0,0,3,100.0
291020,2014,1,0,0,1,100.0
291020,2015,2,0,0,2,100.0
291020,2019,0,0,2,2,0.0
291020,2020,0,0,2,2,0.0
291030,2012,4,0,0,4,100.0
291030,2013,1,0,0,1,100.0
291030,2014,1,0,0,1,100.0
291030,2015,3,0,0,3,100.0
291030,2016,4,0,0,4,100.0
291030,2017,3,0,0,3,100.0
291030,2018,2,0,0,2,100.0
291030,2020,0,0,3,3,0.0
291040,2012,0,0,19,19,0.0
291040,2013,4,2,3,9,66.66666666666666
291040,2014,3,1,7,11,36.36363636363637
291040,2015,2,1,3,6,50.0
291040,2016,1,0,5,6,16.666666666666664
291040,2017,7,0,0,7,100.0
291040,2018,7,0,2,9,77.77777777777779
291040,2019,2,0,5,7,28.57142857142857
291040,2020,1,0,5,6,16.666666666666664
291050,2012,12,0,1,13,92.3076923076923
291050,2013,19,0,0,19,100.0
291050,2014,10,1,2,13,84.61538461538461
291050,2015,9,0,2,11,81.81818181818183
291050,2016,23,0,0,23,100.0
291050,2017,19,0,2,21,90.47619047619048
291050,2018,13,0,4,17,76.47058823529412
291050,2019,17,0,4,21,80.95238095238095
291050,2020,8,1,2,11,81.81818181818183
291060,2012,13,0,2,15,86.66666666666667
291060,2013,9,0,0,9,100.0
291060,2014,6,0,3,9,66.66666666666666
291060,2015,5,1,6,12,50.0
291060,2016,3,1,12,16,25.0
291060,2017,8,0,5,13,61.53846153846154
291060,2018,5,0,6,11,45.45454545454545
291060,2019,6,0,4,10,60.0
291060,2020,3,1,8,12,33.33333333333333
291070,2012,14,1,0,15,100.0
291070,2013,16,0,0,16,100.0
291070,2014,18,0,0,18,100.0
291070,2015,16,0,3,19,84.21052631578947
291070,2016,13,0,5,18,72.22222222222221
291070,2017,13,0,3,16,81.25
291070,2018,11,1,3,15,80.0
291070,2019,12,0,7,19,63.1578947368421
291070,2020,11,0,5,16,68.75
291072,2012,46,0,0,46,100.0
291072,2013,49,0,0,49,100.0
291072,2014,42,0,0,42,100.0
291072,2015,56,0,0,56,100.0
291072,2016,51,0,0,51,100.0
291072,2017,38,0,0,38,100.0
291072,2018,32,2,0,34,100.0
291072,2019,35,0,5,40,87.5
291072,2020,50,0,1,51,98.0392156862745
291075,2012,5,0,0,5,100.0
291075,2013,5,0,0,5,100.0
291075,2014,5,0,0,5,100.0
291075,2015,2,0,0,2,100.0
291075,2016,6,0,0,6,100.0
291075,2017,0,0,7,7,0.0
291075,2018,2,2,5,9,44.44444444444444
291075,2019,4,0,0,4,100.0
291075,2020,6,0,0,6,100.0
291077,2012,0,0,1,1,0.0
291077,2013,1,0,1,2,50.0
291077,2016,0,1,1,2,50.0
291077,2017,0,0,1,1,0.0
291077,2018,2,0,1,3,66.66666666666666
291077,2019,0,0,2,2,0.0
291080,2012,171,9,50,230,78.26086956521739
291080,2013,176,14,29,219,86.7579908675799
291080,2014,212,2,27,241,88.79668049792531
291080,2015,206,2,33,241,86.30705394190872
291080,2016,191,3,32,226,85.84070796460178
291080,2017,232,0,10,242,95.86776859504133
291080,2018,212,0,14,226,93.80530973451327
291080,2019,192,6,46,244,81.14754098360656
291080,2020,83,47,148,278,46.76258992805755
291085,2012,1,0,2,3,33.33333333333333
291085,2013,4,0,0,4,100.0
291085,2014,6,0,2,8,75.0
291085,2015,3,0,0,3,100.0
291085,2016,4,0,0,4,100.0
291085,2017,2,0,0,2,100.0
291085,2018,7,0,0,7,100.0
291085,2019,3,0,0,3,100.0
291085,2020,2,0,0,2,100.0
291090,2012,3,0,0,3,100.0
291090,2013,5,0,0,5,100.0
291090,2015,4,0,0,4,100.0
291090,2016,1,0,0,1,100.0
291090,2017,1,0,1,2,50.0
291090,2018,3,0,0,3,100.0
291090,2019,4,0,1,5,80.0
291090,2020,1,0,1,2,50.0
291100,2012,5,0,0,5,100.0
291100,2013,3,0,1,4,75.0
291100,2014,0,0,4,4,0.0
291100,2015,5,0,0,5,100.0
291100,2016,6,0,0,6,100.0
291100,2017,3,0,0,3,100.0
291100,2018,2,0,0,2,100.0
291100,2019,5,0,0,5,100.0
291100,2020,5,0,0,5,100.0
291110,2012,1,1,7,9,22.22222222222222
291110,2013,0,2,2,4,50.0
291110,2014,6,0,1,7,85.71428571428571
291110,2015,8,0,0,8,100.0
291110,2016,3,0,6,9,33.33333333333333
291110,2017,1,0,8,9,11.11111111111111
291110,2018,2,0,3,5,40.0
291110,2019,1,1,5,7,28.57142857142857
291110,2020,7,0,0,7,100.0
291120,2012,10,0,7,17,58.82352941176471
291120,2013,6,0,3,9,66.66666666666666
291120,2014,8,0,0,8,100.0
291120,2015,12,0,0,12,100.0
291120,2016,5,0,4,9,55.55555555555556
291120,2017,7,2,4,13,69.23076923076923
291120,2018,3,0,6,9,33.33333333333333
291120,2019,4,0,9,13,30.76923076923077
291120,2020,1,2,11,14,21.428571428571427
291125,2012,1,0,0,1,100.0
291125,2013,1,0,0,1,100.0
291125,2014,2,0,0,2,100.0
291125,2015,0,0,1,1,0.0
291125,2018,1,0,0,1,100.0
291125,2020,0,0,1,1,0.0
291130,2012,0,2,0,2,100.0
291130,2013,0,1,4,5,20.0
291130,2014,0,3,3,6,50.0
291130,2015,2,0,1,3,66.66666666666666
291130,2017,2,0,0,2,100.0
291130,2018,1,0,0,1,100.0
291130,2020,4,0,0,4,100.0
291140,2012,7,0,0,7,100.0
291140,2013,3,0,1,4,75.0
291140,2014,7,0,0,7,100.0
291140,2015,6,0,0,6,100.0
291140,2016,3,0,0,3,100.0
291140,2017,7,0,0,7,100.0
291140,2018,10,0,0,10,100.0
291140,2019,7,0,0,7,100.0
291140,2020,3,0,0,3,100.0
291150,2013,2,0,2,4,50.0
291150,2014,1,0,1,2,50.0
291150,2015,2,0,1,3,66.66666666666666
291150,2016,2,0,0,2,100.0
291150,2017,1,0,1,2,50.0
291150,2018,1,0,0,1,100.0
291150,2019,1,0,2,3,33.33333333333333
291150,2020,2,0,1,3,66.66666666666666
291160,2012,5,0,1,6,83.33333333333334
291160,2013,8,0,0,8,100.0
291160,2014,8,0,1,9,88.88888888888889
291160,2015,9,0,0,9,100.0
291160,2016,6,0,4,10,60.0
291160,2017,5,0,4,9,55.55555555555556
291160,2018,6,0,0,6,100.0
291160,2019,4,0,2,6,66.66666666666666
291160,2020,6,0,1,7,85.71428571428571
291165,2012,0,0,2,2,0.0
291165,2014,3,0,0,3,100.0
291165,2015,1,0,0,1,100.0
291165,2016,7,0,0,7,100.0
291165,2017,1,0,0,1,100.0
291165,2018,4,0,0,4,100.0
291165,2019,1,0,0,1,100.0
291165,2020,1,0,0,1,100.0
291170,2012,21,0,0,21,100.0
291170,2013,41,1,1,43,97.67441860465115
291170,2014,20,0,0,20,100.0
291170,2015,27,0,0,27,100.0
291170,2016,34,0,0,34,100.0
291170,2017,34,0,1,35,97.14285714285714
291170,2018,31,0,0,31,100.0
291170,2019,27,1,2,30,93.33333333333333
291170,2020,25,0,0,25,100.0
291180,2012,4,0,0,4,100.0
291180,2013,8,0,0,8,100.0
291180,2014,3,0,0,3,100.0
291180,2015,3,0,0,3,100.0
291180,2016,6,0,0,6,100.0
291180,2017,4,0,2,6,66.66666666666666
291180,2018,8,0,0,8,100.0
291180,2019,10,0,0,10,100.0
291180,2020,8,1,0,9,100.0
291185,2012,4,0,1,5,80.0
291185,2013,4,1,0,5,100.0
291185,2014,6,0,0,6,100.0
291185,2015,1,0,3,4,25.0
291185,2016,0,1,1,2,50.0
291185,2018,3,0,0,3,100.0
291185,2019,0,0,3,3,0.0
291185,2020,0,0,1,1,0.0
291190,2012,6,0,0,6,100.0
291190,2013,5,0,2,7,71.42857142857143
291190,2014,2,0,4,6,33.33333333333333
291190,2015,5,0,4,9,55.55555555555556
291190,2016,0,0,9,9,0.0
291190,2017,1,0,8,9,11.11111111111111
291190,2018,0,0,9,9,0.0
291190,2019,1,0,10,11,9.090909090909092
291190,2020,0,0,12,12,0.0
291200,2012,4,0,0,4,100.0
291200,2013,0,0,5,5,0.0
291200,2014,3,0,0,3,100.0
291200,2015,4,0,0,4,100.0
291200,2016,3,0,1,4,75.0
291200,2017,4,0,0,4,100.0
291200,2019,2,1,0,3,100.0
291200,2020,0,0,3,3,0.0
291210,2012,7,0,0,7,100.0
291210,2013,12,0,0,12,100.0
291210,2014,9,0,0,9,100.0
291210,2015,13,0,0,13,100.0
291210,2016,14,0,0,14,100.0
291210,2017,6,0,0,6,100.0
291210,2018,10,0,0,10,100.0
291210,2019,8,0,0,8,100.0
291210,2020,16,0,0,16,100.0
291220,2012,6,0,0,6,100.0
291220,2013,3,0,0,3,100.0
291220,2014,7,0,1,8,87.5
291220,2015,5,0,0,5,100.0
291220,2016,8,0,0,8,100.0
291220,2017,9,0,0,9,100.0
291220,2018,8,0,0,8,100.0
291220,2019,3,0,0,3,100.0
291220,2020,6,0,0,6,100.0
291230,2012,1,0,2,3,33.33333333333333
291230,2013,1,0,2,3,33.33333333333333
291230,2014,0,1,5,6,16.666666666666664
291230,2015,0,0,2,2,0.0
291230,2016,0,0,5,5,0.0
291230,2017,5,0,0,5,100.0
291230,2018,6,0,0,6,100.0
291230,2020,1,0,2,3,33.33333333333333
291240,2012,11,0,0,11,100.0
291240,2013,6,0,0,6,100.0
291240,2014,6,0,0,6,100.0
291240,2015,3,0,0,3,100.0
291240,2016,6,0,0,6,100.0
291240,2017,6,0,0,6,100.0
291240,2018,3,0,0,3,100.0
291240,2019,7,0,0,7,100.0
291240,2020,7,0,0,7,100.0
291250,2012,3,0,0,3,100.0
291250,2013,1,0,0,1,100.0
291250,2014,5,0,0,5,100.0
291250,2015,2,0,0,2,100.0
291250,2016,5,0,0,5,100.0
291250,2017,3,0,0,3,100.0
291250,2018,2,0,0,2,100.0
291250,2019,2,0,0,2,100.0
291250,2020,4,1,0,5,100.0
291260,2012,1,0,0,1,100.0
291260,2013,1,0,0,1,100.0
291260,2015,1,0,0,1,100.0
291260,2019,0,1,2,3,33.33333333333333
291260,2020,0,0,2,2,0.0
291270,2012,10,1,4,15,73.33333333333333
291270,2013,2,1,3,6,50.0
291270,2014,8,0,1,9,88.88888888888889
291270,2015,5,0,0,5,100.0
291270,2016,8,0,1,9,88.88888888888889
291270,2017,12,0,1,13,92.3076923076923
291270,2018,8,0,0,8,100.0
291270,2019,6,0,0,6,100.0
291270,2020,6,0,0,6,100.0
291280,2012,2,0,0,2,100.0
291280,2013,4,0,0,4,100.0
291280,2014,2,0,0,2,100.0
291280,2015,5,0,0,5,100.0
291280,2017,4,0,0,4,100.0
291280,2018,1,0,0,1,100.0
291280,2019,1,0,0,1,100.0
291280,2020,4,0,0,4,100.0
291290,2012,7,0,0,7,100.0
291290,2013,4,0,1,5,80.0
291290,2014,2,0,0,2,100.0
291290,2015,4,0,2,6,66.66666666666666
291290,2016,4,0,1,5,80.0
291290,2017,0,0,6,6,0.0
291290,2018,0,0,4,4,0.0
291290,2019,11,0,1,12,91.66666666666666
291290,2020,6,0,0,6,100.0
291300,2012,3,0,0,3,100.0
291300,2013,6,0,0,6,100.0
291300,2014,1,0,0,1,100.0
291300,2015,7,0,0,7,100.0
291300,2016,3,0,1,4,75.0
291300,2017,0,1,6,7,14.285714285714285
291300,2018,5,0,0,5,100.0
291300,2019,1,0,0,1,100.0
291300,2020,7,0,0,7,100.0
291310,2012,0,0,4,4,0.0
291310,2013,0,1,9,10,10.0
291310,2014,0,0,4,4,0.0
291310,2015,0,0,3,3,0.0
291310,2016,3,0,0,3,100.0
291310,2017,8,0,0,8,100.0
291310,2018,4,0,0,4,100.0
291310,2019,5,0,0,5,100.0
291310,2020,6,0,0,6,100.0
291320,2012,6,0,1,7,85.71428571428571
291320,2013,9,0,3,12,75.0
291320,2014,8,0,3,11,72.72727272727273
291320,2015,7,0,1,8,87.5
291320,2016,9,0,1,10,90.0
291320,2017,14,0,0,14,100.0
291320,2018,11,0,0,11,100.0
291320,2019,16,0,0,16,100.0
291320,2020,7,0,1,8,87.5
291330,2012,1,0,0,1,100.0
291330,2013,2,0,0,2,100.0
291330,2014,2,0,0,2,100.0
291330,2015,1,0,0,1,100.0
291330,2016,2,0,0,2,100.0
291330,2019,5,0,0,5,100.0
291330,2020,0,0,1,1,0.0
291340,2012,2,0,0,2,100.0
291340,2013,0,0,3,3,0.0
291340,2014,0,0,4,4,0.0
291340,2015,0,0,4,4,0.0
291340,2016,0,0,5,5,0.0
291340,2017,0,1,11,12,8.333333333333332
291340,2018,7,0,0,7,100.0
291340,2019,2,0,1,3,66.66666666666666
291340,2020,3,1,4,8,50.0
291345,2012,2,0,0,2,100.0
291345,2013,2,0,0,2,100.0
291345,2014,2,0,0,2,100.0
291345,2015,1,0,0,1,100.0
291345,2016,4,0,0,4,100.0
291345,2017,4,0,0,4,100.0
291345,2018,1,0,1,2,50.0
291345,2019,4,0,0,4,100.0
291345,2020,7,1,2,10,80.0
291350,2012,10,0,0,10,100.0
291350,2013,3,0,4,7,42.857142857142854
291350,2014,3,0,0,3,100.0
291350,2015,3,0,3,6,50.0
291350,2016,6,0,0,6,100.0
291350,2017,5,0,0,5,100.0
291350,2018,0,0,11,11,0.0
291350,2019,1,0,5,6,16.666666666666664
291350,2020,7,0,0,7,100.0
291360,2012,43,1,25,69,63.76811594202898
291360,2013,54,1,18,73,75.34246575342466
291360,2014,65,1,18,84,78.57142857142857
291360,2015,62,0,7,69,89.85507246376811
291360,2016,78,0,21,99,78.78787878787878
291360,2017,52,1,23,76,69.73684210526315
291360,2018,28,0,49,77,36.36363636363637
291360,2019,28,1,48,77,37.66233766233766
291360,2020,26,3,52,81,35.80246913580247
291370,2012,4,1,2,7,71.42857142857143
291370,2013,9,1,6,16,62.5
291370,2014,1,0,13,14,7.142857142857142
291370,2015,4,0,9,13,30.76923076923077
291370,2016,4,0,2,6,66.66666666666666
291370,2017,14,0,2,16,87.5
291370,2018,10,1,0,11,100.0
291370,2019,12,0,1,13,92.3076923076923
291370,2020,10,0,0,10,100.0
291380,2012,2,0,1,3,66.66666666666666
291380,2013,2,0,4,6,33.33333333333333
291380,2014,3,0,0,3,100.0
291380,2015,3,0,0,3,100.0
291380,2016,3,0,0,3,100.0
291380,2017,3,0,0,3,100.0
291380,2018,4,0,0,4,100.0
291380,2019,4,0,0,4,100.0
291380,2020,2,1,1,4,75.0
291390,2012,11,2,5,18,72.22222222222221
291390,2013,15,0,3,18,83.33333333333334
291390,2014,18,0,1,19,94.73684210526315
291390,2015,8,1,13,22,40.909090909090914
291390,2016,0,0,19,19,0.0
291390,2017,17,0,0,17,100.0
291390,2018,15,0,7,22,68.18181818181817
291390,2019,6,1,8,15,46.666666666666664
291390,2020,23,0,0,23,100.0
291400,2012,15,0,0,15,100.0
291400,2013,23,0,0,23,100.0
291400,2014,27,0,0,27,100.0
291400,2015,19,0,1,20,95.0
291400,2016,19,0,0,19,100.0
291400,2017,9,0,4,13,69.23076923076923
291400,2018,9,1,8,18,55.55555555555556
291400,2019,7,0,7,14,50.0
291400,2020,1,1,21,23,8.695652173913043
291410,2012,1,0,0,1,100.0
291410,2013,1,0,0,1,100.0
291410,2014,1,0,0,1,100.0
291410,2015,1,0,0,1,100.0
291410,2016,5,0,0,5,100.0
291410,2017,2,0,1,3,66.66666666666666
291410,2018,0,0,1,1,0.0
291410,2020,0,1,2,3,33.33333333333333
291420,2013,3,0,0,3,100.0
291420,2014,2,0,0,2,100.0
291420,2015,3,0,0,3,100.0
291420,2016,1,0,0,1,100.0
291420,2017,3,0,0,3,100.0
291420,2018,1,0,0,1,100.0
291420,2019,2,0,0,2,100.0
291420,2020,3,0,0,3,100.0
291430,2012,4,0,0,4,100.0
291430,2013,3,0,0,3,100.0
291430,2014,1,0,0,1,100.0
291430,2015,6,0,0,6,100.0
291430,2016,3,0,0,3,100.0
291430,2017,0,0,3,3,0.0
291430,2019,1,0,6,7,14.285714285714285
291430,2020,0,0,3,3,0.0
291440,2012,1,1,5,7,28.57142857142857
291440,2013,4,0,0,4,100.0
291440,2014,3,0,0,3,100.0
291440,2015,5,0,1,6,83.33333333333334
291440,2016,5,0,1,6,83.33333333333334
291440,2017,3,1,3,7,57.14285714285714
291440,2018,0,0,7,7,0.0
291440,2019,0,0,5,5,0.0
291440,2020,0,0,8,8,0.0
291450,2012,1,0,5,6,16.666666666666664
291450,2013,8,1,0,9,100.0
291450,2014,7,2,2,11,81.81818181818183
291450,2015,8,0,0,8,100.0
291450,2016,6,0,0,6,100.0
291450,2017,7,0,0,7,100.0
291450,2018,8,0,2,10,80.0
291450,2019,0,1,8,9,11.11111111111111
291450,2020,1,3,7,11,36.36363636363637
291460,2012,31,0,1,32,96.875
291460,2013,20,0,0,20,100.0
291460,2014,23,0,2,25,92.0
291460,2015,12,0,2,14,85.71428571428571
291460,2016,19,0,1,20,95.0
291460,2017,32,0,0,32,100.0
291460,2018,23,0,0,23,100.0
291460,2019,29,0,0,29,100.0
291460,2020,29,0,0,29,100.0
291465,2012,6,0,0,6,100.0
291465,2013,23,0,0,23,100.0
291465,2014,15,0,0,15,100.0
291465,2015,16,0,0,16,100.0
291465,2016,10,0,0,10,100.0
291465,2017,23,0,0,23,100.0
291465,2018,17,0,0,17,100.0
291465,2019,16,0,4,20,80.0
291465,2020,8,0,2,10,80.0
291470,2012,16,0,6,22,72.72727272727273
291470,2013,21,0,2,23,91.30434782608695
291470,2014,18,0,5,23,78.26086956521739
291470,2015,18,0,1,19,94.73684210526315
291470,2016,10,0,0,10,100.0
291470,2017,15,0,0,15,100.0
291470,2018,21,0,0,21,100.0
291470,2019,21,0,0,21,100.0
291470,2020,21,0,0,21,100.0
291480,2012,80,1,16,97,83.50515463917526
291480,2013,53,1,27,81,66.66666666666666
291480,2014,78,0,13,91,85.71428571428571
291480,2015,75,1,11,87,87.35632183908046
291480,2016,104,0,0,104,100.0
291480,2017,93,0,1,94,98.93617021276596
291480,2018,91,0,0,91,100.0
291480,2019,80,0,0,80,100.0
291480,2020,115,0,0,115,100.0
291490,2012,1,2,3,6,50.0
291490,2013,6,0,2,8,75.0
291490,2014,3,1,6,10,40.0
291490,2015,2,0,0,2,100.0
291490,2016,5,0,2,7,71.42857142857143
291490,2017,5,0,0,5,100.0
291490,2018,9,0,0,9,100.0
291490,2019,6,0,3,9,66.66666666666666
291490,2020,5,0,3,8,62.5
291500,2012,5,1,4,10,60.0
291500,2013,2,0,0,2,100.0
291500,2014,5,0,0,5,100.0
291500,2015,5,0,0,5,100.0
291500,2016,0,0,4,4,0.0
291500,2017,0,0,1,1,0.0
291500,2018,0,0,3,3,0.0
291500,2019,0,0,3,3,0.0
291500,2020,0,1,13,14,7.142857142857142
291510,2012,3,0,0,3,100.0
291510,2013,7,0,1,8,87.5
291510,2014,8,0,0,8,100.0
291510,2015,3,0,0,3,100.0
291510,2016,5,0,0,5,100.0
291510,2017,4,0,0,4,100.0
291510,2018,3,0,0,3,100.0
291510,2019,1,0,0,1,100.0
291510,2020,8,0,0,8,100.0
291520,2012,0,1,7,8,12.5
291520,2013,0,0,3,3,0.0
291520,2014,1,2,3,6,50.0
291520,2015,1,0,5,6,16.666666666666664
291520,2016,0,0,3,3,0.0
291520,2017,0,0,6,6,0.0
291520,2018,0,0,1,1,0.0
291520,2019,0,0,4,4,0.0
291520,2020,2,0,2,4,50.0
291530,2012,3,0,0,3,100.0
291530,2013,2,0,0,2,100.0
291530,2014,3,0,0,3,100.0
291530,2015,3,0,0,3,100.0
291530,2016,4,0,0,4,100.0
291530,2017,2,1,1,4,75.0
291530,2018,1,0,2,3,33.33333333333333
291530,2019,0,0,2,2,0.0
291530,2020,0,0,2,2,0.0
291535,2012,0,0,5,5,0.0
291535,2013,0,0,3,3,0.0
291535,2014,0,0,4,4,0.0
291535,2015,2,0,1,3,66.66666666666666
291535,2016,2,0,0,2,100.0
291535,2017,4,0,0,4,100.0
291535,2018,1,1,2,4,50.0
291535,2019,2,0,0,2,100.0
291535,2020,1,0,0,1,100.0
291540,2012,0,0,3,3,0.0
291540,2013,0,0,1,1,0.0
291540,2014,0,0,1,1,0.0
291540,2015,1,0,2,3,33.33333333333333
291540,2016,0,0,2,2,0.0
291540,2017,1,0,1,2,50.0
291540,2018,0,0,2,2,0.0
291540,2019,0,0,3,3,0.0
291540,2020,1,0,3,4,25.0
291550,2012,12,0,0,12,100.0
291550,2013,4,0,0,4,100.0
291550,2014,4,0,0,4,100.0
291550,2015,9,0,0,9,100.0
291550,2016,9,0,1,10,90.0
291550,2017,1,1,6,8,25.0
291550,2018,2,0,5,7,28.57142857142857
291550,2019,9,0,0,9,100.0
291550,2020,9,0,0,9,100.0
291560,2012,23,0,0,23,100.0
291560,2013,38,0,1,39,97.43589743589743
291560,2014,23,1,1,25,96.0
291560,2015,19,0,0,19,100.0
291560,2016,22,1,0,23,100.0
291560,2017,28,0,3,31,90.32258064516128
291560,2018,27,0,0,27,100.0
291560,2019,28,0,5,33,84.84848484848484
291560,2020,25,0,0,25,100.0
291570,2012,1,0,0,1,100.0
291570,2013,4,0,0,4,100.0
291570,2014,2,0,0,2,100.0
291570,2015,3,0,0,3,100.0
291570,2016,0,0,2,2,0.0
291570,2018,1,0,4,5,20.0
291570,2019,0,0,2,2,0.0
291570,2020,0,0,2,2,0.0
291580,2012,1,0,9,10,10.0
291580,2013,3,0,2,5,60.0
291580,2014,12,0,1,13,92.3076923076923
291580,2015,1,0,10,11,9.090909090909092
291580,2016,7,0,0,7,100.0
291580,2017,8,0,0,8,100.0
291580,2018,18,0,0,18,100.0
291580,2019,8,0,1,9,88.88888888888889
291580,2020,10,0,0,10,100.0
291590,2012,0,0,2,2,0.0
291590,2013,0,0,2,2,0.0
291590,2014,0,0,3,3,0.0
291590,2015,1,0,0,1,100.0
291590,2016,2,0,0,2,100.0
291590,2017,1,0,0,1,100.0
291590,2018,1,0,0,1,100.0
291590,2020,1,0,0,1,100.0
291600,2012,7,0,0,7,100.0
291600,2013,12,0,0,12,100.0
291600,2014,6,0,0,6,100.0
291600,2015,7,0,1,8,87.5
291600,2016,9,2,0,11,100.0
291600,2017,6,0,0,6,100.0
291600,2018,7,0,0,7,100.0
291600,2019,4,0,0,4,100.0
291600,2020,5,0,0,5,100.0
291610,2012,3,0,0,3,100.0
291610,2013,8,0,1,9,88.88888888888889
291610,2014,2,2,5,9,44.44444444444444
291610,2015,1,0,6,7,14.285714285714285
291610,2016,0,0,3,3,0.0
291610,2017,1,1,10,12,16.666666666666664
291610,2018,1,0,10,11,9.090909090909092
291610,2019,0,0,5,5,0.0
291610,2020,0,1,7,8,12.5
291620,2012,4,0,0,4,100.0
291620,2013,2,0,2,4,50.0
291620,2014,4,0,1,5,80.0
291620,2015,3,0,0,3,100.0
291620,2016,5,0,0,5,100.0
291620,2017,1,1,3,5,40.0
291620,2018,3,0,0,3,100.0
291620,2019,5,0,1,6,83.33333333333334
291620,2020,4,0,3,7,57.14285714285714
291630,2012,2,0,0,2,100.0
291630,2013,8,0,0,8,100.0
291630,2014,8,0,1,9,88.88888888888889
291630,2015,4,0,0,4,100.0
291630,2016,4,0,0,4,100.0
291630,2017,5,0,0,5,100.0
291630,2018,2,0,0,2,100.0
291630,2019,0,0,3,3,0.0
291630,2020,3,0,0,3,100.0
291640,2012,31,0,1,32,96.875
291640,2013,34,0,0,34,100.0
291640,2014,29,0,1,30,96.66666666666667
291640,2015,31,0,0,31,100.0
291640,2016,36,0,0,36,100.0
291640,2017,34,0,1,35,97.14285714285714
291640,2018,24,0,4,28,85.71428571428571
291640,2019,19,4,6,29,79.3103448275862
291640,2020,31,0,5,36,86.11111111111111
291650,2012,6,0,6,12,50.0
291650,2013,5,0,1,6,83.33333333333334
291650,2014,6,0,0,6,100.0
291650,2015,7,0,2,9,77.77777777777779
291650,2016,5,0,0,5,100.0
291650,2017,7,0,0,7,100.0
291650,2018,13,0,0,13,100.0
291650,2019,12,0,0,12,100.0
291650,2020,13,0,0,13,100.0
291660,2012,1,0,0,1,100.0
291660,2013,1,0,2,3,33.33333333333333
291660,2015,3,0,1,4,75.0
291660,2016,2,0,1,3,66.66666666666666
291660,2017,5,0,0,5,100.0
291660,2018,1,0,0,1,100.0
291660,2019,3,0,0,3,100.0
291660,2020,1,0,2,3,33.33333333333333
291670,2012,2,0,0,2,100.0
291670,2013,2,0,0,2,100.0
291670,2014,1,0,0,1,100.0
291670,2015,4,0,2,6,66.66666666666666
291670,2016,1,0,3,4,25.0
291670,2017,0,0,3,3,0.0
291670,2019,2,0,0,2,100.0
291680,2012,7,0,0,7,100.0
291680,2013,4,0,0,4,100.0
291680,2014,4,0,0,4,100.0
291680,2015,5,0,2,7,71.42857142857143
291680,2016,0,0,3,3,0.0
291680,2017,2,0,1,3,66.66666666666666
291680,2018,3,0,2,5,60.0
291680,2019,1,0,9,10,10.0
291680,2020,0,1,4,5,20.0
291685,2012,4,0,0,4,100.0
291685,2013,4,0,0,4,100.0
291685,2014,2,0,0,2,100.0
291685,2015,5,0,0,5,100.0
291685,2016,8,0,0,8,100.0
291685,2017,6,0,0,6,100.0
291685,2018,5,0,0,5,100.0
291685,2019,6,0,0,6,100.0
291685,2020,4,0,0,4,100.0
291690,2012,5,0,2,7,71.42857142857143
291690,2013,3,0,0,3,100.0
291690,2014,2,0,1,3,66.66666666666666
291690,2015,5,0,0,5,100.0
291690,2016,5,0,0,5,100.0
291690,2017,6,0,0,6,100.0
291690,2018,7,0,0,7,100.0
291690,2019,7,0,0,7,100.0
291690,2020,3,0,0,3,100.0
291700,2012,7,1,3,11,72.72727272727273
291700,2013,0,4,3,7,57.14285714285714
291700,2014,1,7,5,13,61.53846153846154
291700,2015,0,7,6,13,53.84615384615385
291700,2016,11,0,0,11,100.0
291700,2017,8,1,3,12,75.0
291700,2018,6,0,0,6,100.0
291700,2019,10,0,4,14,71.42857142857143
291700,2020,8,0,4,12,66.66666666666666
291710,2012,13,0,0,13,100.0
291710,2013,10,0,0,10,100.0
291710,2014,4,0,0,4,100.0
291710,2015,2,0,2,4,50.0
291710,2016,7,1,2,10,80.0
291710,2017,5,0,1,6,83.33333333333334
291710,2018,13,0,0,13,100.0
291710,2019,10,0,0,10,100.0
291710,2020,9,0,1,10,90.0
291720,2012,0,1,4,5,20.0
291720,2013,4,0,1,5,80.0
291720,2014,3,0,1,4,75.0
291720,2015,10,0,0,10,100.0
291720,2016,7,0,0,7,100.0
291720,2017,7,0,0,7,100.0
291720,2018,6,0,0,6,100.0
291720,2019,2,0,0,2,100.0
291720,2020,7,0,0,7,100.0
291730,2012,7,0,0,7,100.0
291730,2013,9,0,0,9,100.0
291730,2014,0,0,7,7,0.0
291730,2015,4,0,2,6,66.66666666666666
291730,2016,5,1,1,7,85.71428571428571
291730,2017,7,0,0,7,100.0
291730,2018,13,0,0,13,100.0
291730,2019,8,0,1,9,88.88888888888889
291730,2020,5,1,4,10,60.0
291733,2012,3,0,0,3,100.0
291733,2013,3,1,2,6,66.66666666666666
291733,2014,5,1,0,6,100.0
291733,2015,1,0,0,1,100.0
291733,2016,5,0,0,5,100.0
291733,2017,2,1,1,4,75.0
291733,2018,4,0,0,4,100.0
291733,2019,2,0,4,6,33.33333333333333
291733,2020,5,0,0,5,100.0
291735,2012,1,0,0,1,100.0
291735,2013,2,0,0,2,100.0
291735,2014,4,0,0,4,100.0
291735,2015,5,0,0,5,100.0
291735,2016,2,0,0,2,100.0
291735,2017,3,0,0,3,100.0
291735,2018,1,0,0,1,100.0
291735,2019,6,0,0,6,100.0
291735,2020,3,0,0,3,100.0
291740,2012,3,0,1,4,75.0
291740,2013,2,0,0,2,100.0
291740,2014,0,0,2,2,0.0
291740,2015,5,0,0,5,100.0
291740,2016,1,0,0,1,100.0
291740,2017,2,0,0,2,100.0
291740,2018,3,0,0,3,100.0
291740,2019,1,0,0,1,100.0
291740,2020,4,0,0,4,100.0
291750,2012,11,1,11,23,52.17391304347826
291750,2013,24,1,6,31,80.64516129032258
291750,2014,11,1,21,33,36.36363636363637
291750,2015,19,0,10,29,65.51724137931035
291750,2016,20,1,9,30,70.0
291750,2017,23,0,2,25,92.0
291750,2018,25,0,0,25,100.0
291750,2019,35,0,1,36,97.22222222222221
291750,2020,36,0,1,37,97.2972972972973
291760,2012,16,1,8,25,68.0
291760,2013,11,1,2,14,85.71428571428571
291760,2014,9,2,4,15,73.33333333333333
291760,2015,12,1,3,16,81.25
291760,2016,18,0,3,21,85.71428571428571
291760,2017,14,0,2,16,87.5
291760,2018,22,0,0,22,100.0
291760,2019,12,0,0,12,100.0
291760,2020,16,0,0,16,100.0
291770,2012,7,0,1,8,87.5
291770,2013,10,0,2,12,83.33333333333334
291770,2014,7,0,1,8,87.5
291770,2015,10,0,0,10,100.0
291770,2016,11,1,0,12,100.0
291770,2017,5,0,3,8,62.5
291770,2018,5,1,2,8,75.0
291770,2019,1,0,5,6,16.666666666666664
291770,2020,16,2,1,19,94.73684210526315
291780,2012,4,0,2,6,66.66666666666666
291780,2013,2,0,0,2,100.0
291780,2014,5,0,1,6,83.33333333333334
291780,2015,8,0,1,9,88.88888888888889
291780,2016,5,0,0,5,100.0
291780,2017,10,0,1,11,90.9090909090909
291780,2018,3,0,1,4,75.0
291780,2019,9,0,1,10,90.0
291780,2020,8,0,0,8,100.0
291790,2013,7,0,0,7,100.0
291790,2014,4,0,0,4,100.0
291790,2015,4,0,0,4,100.0
291790,2016,2,0,0,2,100.0
291790,2017,5,0,0,5,100.0
291790,2018,2,0,0,2,100.0
291790,2019,4,0,0,4,100.0
291790,2020,2,0,1,3,66.66666666666666
291800,2012,24,3,31,58,46.55172413793103
291800,2013,36,1,17,54,68.51851851851852
291800,2014,23,3,22,48,54.166666666666664
291800,2015,15,0,45,60,25.0
291800,2016,16,0,41,57,28.07017543859649
291800,2017,13,0,39,52,25.0
291800,2018,24,0,34,58,41.37931034482759
291800,2019,14,0,55,69,20.28985507246377
291800,2020,46,0,21,67,68.65671641791045
291810,2012,6,2,0,8,100.0
291810,2013,8,0,2,10,80.0
291810,2014,7,0,3,10,70.0
291810,2015,11,1,6,18,66.66666666666666
291810,2016,4,2,7,13,46.15384615384615
291810,2017,7,0,6,13,53.84615384615385
291810,2018,10,1,0,11,100.0
291810,2019,12,0,0,12,100.0
291810,2020,10,0,1,11,90.9090909090909
291820,2012,1,1,7,9,22.22222222222222
291820,2013,0,0,3,3,0.0
291820,2014,0,1,5,6,16.666666666666664
291820,2015,1,1,3,5,40.0
291820,2016,2,0,0,2,100.0
291820,2017,2,0,0,2,100.0
291820,2018,5,0,0,5,100.0
291820,2019,3,0,0,3,100.0
291820,2020,6,0,0,6,100.0
291830,2012,5,0,2,7,71.42857142857143
291830,2013,1,0,0,1,100.0
291830,2014,7,0,1,8,87.5
291830,2015,5,0,0,5,100.0
291830,2016,2,0,0,2,100.0
291830,2017,1,0,1,2,50.0
291830,2018,1,0,6,7,14.285714285714285
291830,2019,0,0,5,5,0.0
291830,2020,0,0,3,3,0.0
291835,2012,0,1,4,5,20.0
291835,2013,3,2,5,10,50.0
291835,2014,8,0,0,8,100.0
291835,2015,4,0,2,6,66.66666666666666
291835,2016,4,0,0,4,100.0
291835,2017,7,0,0,7,100.0
291835,2018,6,0,0,6,100.0
291835,2019,12,0,0,12,100.0
291835,2020,13,0,1,14,92.85714285714286
291840,2012,62,3,18,83,78.3132530120482
291840,2013,72,3,8,83,90.36144578313254
291840,2014,70,8,14,92,84.78260869565217
291840,2015,82,0,6,88,93.18181818181817
291840,2016,74,1,8,83,90.36144578313254
291840,2017,58,8,26,92,71.73913043478261
291840,2018,55,2,31,88,64.77272727272727
291840,2019,66,0,10,76,86.8421052631579
291840,2020,57,9,26,92,71.73913043478261
291845,2012,0,0,3,3,0.0
291845,2013,3,0,0,3,100.0
291845,2014,1,0,0,1,100.0
291845,2015,1,0,0,1,100.0
291845,2016,4,1,0,5,100.0
291845,2017,4,0,1,5,80.0
291845,2018,0,0,1,1,0.0
291845,2019,1,0,1,2,50.0
291845,2020,0,0,3,3,0.0
291850,2012,0,0,3,3,0.0
291850,2013,1,1,3,5,40.0
291850,2014,4,0,0,4,100.0
291850,2015,4,0,0,4,100.0
291850,2016,2,0,0,2,100.0
291850,2017,8,0,0,8,100.0
291850,2018,3,0,0,3,100.0
291850,2019,7,0,1,8,87.5
291850,2020,6,0,0,6,100.0
291855,2012,2,0,1,3,66.66666666666666
291855,2013,2,0,0,2,100.0
291855,2014,2,0,0,2,100.0
291855,2015,2,0,1,3,66.66666666666666
291855,2016,2,0,0,2,100.0
291855,2017,5,0,0,5,100.0
291855,2018,0,0,2,2,0.0
291855,2019,3,0,1,4,75.0
291855,2020,2,0,3,5,40.0
291860,2012,2,0,0,2,100.0
291860,2013,1,0,0,1,100.0
291860,2014,1,0,0,1,100.0
291860,2015,3,0,0,3,100.0
291860,2016,1,0,0,1,100.0
291860,2017,1,0,0,1,100.0
291860,2019,2,0,0,2,100.0
291860,2020,3,0,0,3,100.0
291870,2012,1,0,0,1,100.0
291870,2013,1,0,0,1,100.0
291870,2014,1,0,0,1,100.0
291870,2016,3,0,0,3,100.0
291870,2018,1,0,0,1,100.0
291870,2019,1,0,2,3,33.33333333333333
291875,2012,0,0,2,2,0.0
291875,2013,1,0,1,2,50.0
291875,2014,0,0,3,3,0.0
291875,2015,1,0,1,2,50.0
291875,2016,0,0,1,1,0.0
291875,2017,1,0,2,3,33.33333333333333
291875,2018,1,0,0,1,100.0
291875,2019,1,0,2,3,33.33333333333333
291875,2020,0,0,1,1,0.0
291880,2012,0,0,5,5,0.0
291880,2013,1,0,6,7,14.285714285714285
291880,2014,6,0,0,6,100.0
291880,2015,10,0,0,10,100.0
291880,2016,4,0,0,4,100.0
291880,2017,8,0,1,9,88.88888888888889
291880,2018,9,0,0,9,100.0
291880,2019,9,0,0,9,100.0
291880,2020,4,0,0,4,100.0
291890,2012,4,0,0,4,100.0
291890,2013,1,0,0,1,100.0
291890,2014,2,0,0,2,100.0
291890,2015,2,0,0,2,100.0
291890,2016,1,0,0,1,100.0
291890,2018,3,0,0,3,100.0
291890,2019,2,0,0,2,100.0
291890,2020,2,0,0,2,100.0
291900,2013,1,0,9,10,10.0
291900,2015,0,0,1,1,0.0
291900,2017,0,0,1,1,0.0
291900,2018,0,0,1,1,0.0
291900,2019,1,0,1,2,50.0
291905,2012,0,0,1,1,0.0
291905,2014,1,0,0,1,100.0
291905,2015,2,0,0,2,100.0
291905,2016,5,0,0,5,100.0
291905,2017,2,0,0,2,100.0
291905,2018,1,0,0,1,100.0
291905,2019,2,0,0,2,100.0
291905,2020,2,0,0,2,100.0
291910,2014,1,0,2,3,33.33333333333333
291910,2015,3,0,0,3,100.0
291910,2016,1,0,0,1,100.0
291910,2017,2,0,2,4,50.0
291910,2019,4,0,0,4,100.0
291910,2020,2,1,0,3,100.0
291915,2012,0,1,10,11,9.090909090909092
291915,2013,16,0,1,17,94.11764705882352
291915,2014,6,0,0,6,100.0
291915,2015,10,0,0,10,100.0
291915,2016,11,0,0,11,100.0
291915,2017,6,0,0,6,100.0
291915,2018,8,0,0,8,100.0
291915,2019,8,0,0,8,100.0
291915,2020,8,0,0,8,100.0
291920,2012,36,15,30,81,62.96296296296296
291920,2013,19,29,40,88,54.54545454545454
291920,2014,4,29,47,80,41.25
291920,2015,26,15,24,65,63.07692307692307
291920,2016,22,16,46,84,45.23809523809524
291920,2017,14,28,35,77,54.54545454545454
291920,2018,51,1,27,79,65.82278481012658
291920,2019,49,0,26,75,65.33333333333333
291920,2020,51,3,33,87,62.06896551724138
291930,2012,1,0,2,3,33.33333333333333
291930,2013,3,0,0,3,100.0
291930,2014,5,0,0,5,100.0
291930,2015,1,0,0,1,100.0
291930,2016,4,0,1,5,80.0
291930,2017,2,0,0,2,100.0
291930,2018,2,0,0,2,100.0
291930,2019,1,0,4,5,20.0
291930,2020,7,0,0,7,100.0
291940,2012,2,0,0,2,100.0
291940,2013,0,0,1,1,0.0
291940,2014,0,1,2,3,33.33333333333333
291940,2015,0,0,2,2,0.0
291940,2016,1,0,0,1,100.0
291940,2017,1,0,3,4,25.0
291940,2018,0,0,3,3,0.0
291940,2019,0,0,2,2,0.0
291940,2020,3,0,0,3,100.0
291950,2012,8,0,1,9,88.88888888888889
291950,2013,8,0,0,8,100.0
291950,2014,10,0,0,10,100.0
291950,2015,3,0,0,3,100.0
291950,2016,4,0,0,4,100.0
291950,2017,7,0,0,7,100.0
291950,2018,8,0,0,8,100.0
291950,2019,11,0,0,11,100.0
291950,2020,9,0,0,9,100.0
291955,2012,17,0,9,26,65.38461538461539
291955,2013,20,1,7,28,75.0
291955,2014,16,0,3,19,84.21052631578947
291955,2015,20,0,14,34,58.82352941176471
291955,2016,6,1,24,31,22.58064516129032
291955,2017,22,1,1,24,95.83333333333334
291955,2018,30,0,0,30,100.0
291955,2019,25,0,0,25,100.0
291955,2020,33,0,1,34,97.05882352941177
291960,2012,6,0,0,6,100.0
291960,2013,2,0,0,2,100.0
291960,2014,3,0,1,4,75.0
291960,2015,1,0,0,1,100.0
291960,2016,4,0,2,6,66.66666666666666
291960,2017,1,0,3,4,25.0
291960,2018,0,0,2,2,0.0
291960,2019,3,0,4,7,42.857142857142854
291960,2020,0,0,4,4,0.0
291970,2012,8,0,0,8,100.0
291970,2013,10,0,0,10,100.0
291970,2014,4,0,1,5,80.0
291970,2015,6,0,1,7,85.71428571428571
291970,2016,4,0,1,5,80.0
291970,2017,8,0,0,8,100.0
291970,2018,5,0,0,5,100.0
291970,2019,1,1,2,4,50.0
291970,2020,0,2,6,8,25.0
291980,2012,15,0,1,16,93.75
291980,2013,8,0,3,11,72.72727272727273
291980,2014,6,1,5,12,58.333333333333336
291980,2015,3,0,12,15,20.0
291980,2016,1,0,10,11,9.090909090909092
291980,2017,0,1,9,10,10.0
291980,2018,0,0,12,12,0.0
291980,2019,0,0,15,15,0.0
291980,2020,1,2,15,18,16.666666666666664
291990,2012,2,0,0,2,100.0
291990,2013,1,0,0,1,100.0
291990,2014,2,0,0,2,100.0
291990,2015,1,0,0,1,100.0
291990,2017,2,0,0,2,100.0
291990,2018,3,0,0,3,100.0
291990,2019,0,0,2,2,0.0
291990,2020,0,0,2,2,0.0
291992,2012,6,1,3,10,70.0
291992,2013,2,1,3,6,50.0
291992,2014,10,0,0,10,100.0
291992,2015,5,1,0,6,100.0
291992,2016,7,0,1,8,87.5
291992,2017,2,0,1,3,66.66666666666666
291992,2018,3,0,0,3,100.0
291992,2019,1,0,0,1,100.0
291992,2020,8,0,2,10,80.0
291995,2012,1,0,0,1,100.0
291995,2013,0,0,1,1,0.0
291995,2014,0,0,3,3,0.0
291995,2015,0,0,2,2,0.0
291995,2016,0,0,4,4,0.0
291995,2017,2,0,0,2,100.0
291995,2018,3,0,0,3,100.0
291995,2019,2,0,0,2,100.0
291995,2020,2,0,0,2,100.0
292000,2013,7,0,0,7,100.0
292000,2014,6,0,0,6,100.0
292000,2016,3,0,0,3,100.0
292000,2017,0,0,2,2,0.0
292000,2018,3,0,0,3,100.0
292000,2019,1,0,1,2,50.0
292000,2020,1,0,1,2,50.0
292010,2012,2,0,0,2,100.0
292010,2013,5,0,0,5,100.0
292010,2014,0,0,1,1,0.0
292010,2015,3,0,0,3,100.0
292010,2016,2,0,0,2,100.0
292010,2017,7,0,0,7,100.0
292010,2018,3,0,0,3,100.0
292010,2019,2,0,0,2,100.0
292010,2020,8,0,0,8,100.0
292020,2012,4,0,3,7,57.14285714285714
292020,2013,3,0,1,4,75.0
292020,2014,2,0,4,6,33.33333333333333
292020,2015,0,0,2,2,0.0
292020,2016,3,0,2,5,60.0
292020,2017,3,0,0,3,100.0
292020,2018,7,0,0,7,100.0
292020,2019,3,0,2,5,60.0
292020,2020,6,5,2,13,84.61538461538461
292030,2012,0,0,3,3,0.0
292030,2013,0,0,1,1,0.0
292030,2014,1,0,2,3,33.33333333333333
292030,2015,2,0,0,2,100.0
292030,2016,2,0,0,2,100.0
292030,2017,2,0,0,2,100.0
292030,2018,2,0,0,2,100.0
292030,2019,1,0,2,3,33.33333333333333
292030,2020,0,0,1,1,0.0
292040,2012,1,2,1,4,75.0
292040,2013,0,0,7,7,0.0
292040,2014,1,0,3,4,25.0
292040,2015,0,1,5,6,16.666666666666664
292040,2016,1,0,2,3,33.33333333333333
292040,2017,6,0,0,6,100.0
292040,2018,1,0,0,1,100.0
292040,2019,1,0,0,1,100.0
292040,2020,3,0,3,6,50.0
292045,2014,0,1,0,1,100.0
292045,2015,2,0,2,4,50.0
292045,2016,2,0,1,3,66.66666666666666
292045,2017,2,0,1,3,66.66666666666666
292045,2018,2,0,0,2,100.0
292045,2019,0,0,2,2,0.0
292045,2020,0,1,0,1,100.0
292050,2012,13,0,0,13,100.0
292050,2013,12,0,0,12,100.0
292050,2014,13,0,0,13,100.0
292050,2015,10,0,3,13,76.92307692307693
292050,2016,5,0,0,5,100.0
292050,2017,8,0,0,8,100.0
292050,2018,8,0,0,8,100.0
292050,2019,4,0,0,4,100.0
292050,2020,8,0,0,8,100.0
292060,2012,2,0,12,14,14.285714285714285
292060,2013,4,1,3,8,62.5
292060,2014,11,0,0,11,100.0
292060,2015,12,0,0,12,100.0
292060,2016,15,0,0,15,100.0
292060,2017,15,0,0,15,100.0
292060,2018,12,0,0,12,100.0
292060,2019,20,0,0,20,100.0
292060,2020,10,0,0,10,100.0
292070,2012,4,0,0,4,100.0
292070,2013,3,0,0,3,100.0
292070,2014,2,0,0,2,100.0
292070,2015,3,0,0,3,100.0
292070,2016,6,0,0,6,100.0
292070,2017,2,0,0,2,100.0
292070,2018,10,0,1,11,90.9090909090909
292070,2019,2,0,1,3,66.66666666666666
292070,2020,2,1,1,4,75.0
292080,2012,0,0,1,1,0.0
292080,2013,0,0,1,1,0.0
292080,2014,0,0,5,5,0.0
292080,2015,0,0,1,1,0.0
292080,2016,3,0,0,3,100.0
292080,2017,3,0,2,5,60.0
292080,2018,2,0,0,2,100.0
292080,2019,2,0,2,4,50.0
292080,2020,1,0,3,4,25.0
292090,2012,4,0,1,5,80.0
292090,2013,2,0,1,3,66.66666666666666
292090,2014,6,0,1,7,85.71428571428571
292090,2015,1,0,2,3,33.33333333333333
292090,2016,3,0,1,4,75.0
292090,2017,4,0,1,5,80.0
292090,2018,8,0,0,8,100.0
292090,2019,3,0,0,3,100.0
292090,2020,1,1,1,3,66.66666666666666
292100,2012,20,0,3,23,86.95652173913044
292100,2013,13,4,3,20,85.0
292100,2014,14,2,3,19,84.21052631578947
292100,2015,17,0,0,17,100.0
292100,2016,15,0,1,16,93.75
292100,2017,10,2,1,13,92.3076923076923
292100,2018,21,0,6,27,77.77777777777779
292100,2019,18,0,4,22,81.81818181818183
292100,2020,14,0,2,16,87.5
292105,2012,6,0,0,6,100.0
292105,2013,3,0,0,3,100.0
292105,2014,5,0,0,5,100.0
292105,2015,4,0,0,4,100.0
292105,2016,1,0,1,2,50.0
292105,2017,1,0,3,4,25.0
292105,2018,0,1,1,2,50.0
292105,2019,0,0,3,3,0.0
292105,2020,2,0,0,2,100.0
292110,2012,15,0,0,15,100.0
292110,2013,9,0,0,9,100.0
292110,2014,7,0,1,8,87.5
292110,2015,12,0,0,12,100.0
292110,2016,13,0,0,13,100.0
292110,2017,11,0,0,11,100.0
292110,2018,12,0,0,12,100.0
292110,2019,11,0,0,11,100.0
292110,2020,10,0,0,10,100.0
292120,2012,7,0,0,7,100.0
292120,2013,11,0,2,13,84.61538461538461
292120,2014,0,0,5,5,0.0
292120,2015,11,0,0,11,100.0
292120,2016,8,0,1,9,88.88888888888889
292120,2017,7,0,1,8,87.5
292120,2018,8,0,0,8,100.0
292120,2019,3,0,1,4,75.0
292120,2020,11,0,0,11,100.0
292130,2012,1,0,0,1,100.0
292130,2013,8,0,0,8,100.0
292130,2014,2,0,0,2,100.0
292130,2015,6,0,3,9,66.66666666666666
292130,2016,0,1,5,6,16.666666666666664
292130,2017,2,0,1,3,66.66666666666666
292130,2018,3,0,0,3,100.0
292130,2019,0,0,1,1,0.0
292130,2020,0,0,5,5,0.0
292140,2012,3,0,0,3,100.0
292140,2013,3,0,3,6,50.0
292140,2014,2,0,0,2,100.0
292140,2015,4,0,0,4,100.0
292140,2016,2,0,0,2,100.0
292140,2017,3,0,0,3,100.0
292140,2018,2,0,0,2,100.0
292140,2019,6,0,0,6,100.0
292140,2020,3,0,1,4,75.0
292145,2012,1,0,1,2,50.0
292145,2013,1,0,0,1,100.0
292145,2014,1,0,0,1,100.0
292145,2015,0,0,3,3,0.0
292145,2016,0,0,3,3,0.0
292145,2018,4,0,1,5,80.0
292145,2019,4,0,0,4,100.0
292145,2020,1,0,0,1,100.0
292150,2012,9,0,4,13,69.23076923076923
292150,2013,14,0,1,15,93.33333333333333
292150,2014,9,0,2,11,81.81818181818183
292150,2015,11,1,7,19,63.1578947368421
292150,2016,1,1,11,13,15.384615384615385
292150,2017,8,0,2,10,80.0
292150,2018,10,0,3,13,76.92307692307693
292150,2019,4,0,11,15,26.666666666666668
292150,2020,0,1,15,16,6.25
292160,2012,0,0,1,1,0.0
292160,2013,0,0,1,1,0.0
292160,2014,1,0,0,1,100.0
292160,2015,1,0,0,1,100.0
292160,2016,0,0,3,3,0.0
292160,2017,0,0,2,2,0.0
292160,2018,0,0,1,1,0.0
292160,2019,0,0,1,1,0.0
292160,2020,0,0,4,4,0.0
292170,2012,13,1,1,15,93.33333333333333
292170,2013,18,0,2,20,90.0
292170,2014,14,0,1,15,93.33333333333333
292170,2015,12,0,0,12,100.0
292170,2016,17,0,0,17,100.0
292170,2017,15,0,0,15,100.0
292170,2018,8,0,1,9,88.88888888888889
292170,2019,9,0,0,9,100.0
292170,2020,7,0,0,7,100.0
292180,2012,3,0,0,3,100.0
292180,2013,5,0,2,7,71.42857142857143
292180,2014,2,0,1,3,66.66666666666666
292180,2015,3,0,0,3,100.0
292180,2016,1,0,1,2,50.0
292180,2017,0,0,3,3,0.0
292180,2018,0,0,2,2,0.0
292180,2019,0,1,2,3,33.33333333333333
292180,2020,0,0,4,4,0.0
292190,2012,3,0,1,4,75.0
292190,2013,3,0,1,4,75.0
292190,2014,4,0,0,4,100.0
292190,2015,3,0,0,3,100.0
292190,2016,2,0,0,2,100.0
292190,2017,3,0,0,3,100.0
292190,2018,4,0,0,4,100.0
292190,2019,0,0,4,4,0.0
292200,2012,16,0,4,20,80.0
292200,2013,16,0,1,17,94.11764705882352
292200,2014,3,0,7,10,30.0
292200,2015,11,0,2,13,84.61538461538461
292200,2016,7,0,10,17,41.17647058823529
292200,2017,5,0,5,10,50.0
292200,2018,5,1,5,11,54.54545454545454
292200,2019,4,0,8,12,33.33333333333333
292200,2020,12,0,3,15,80.0
292205,2012,0,0,9,9,0.0
292205,2013,0,0,3,3,0.0
292205,2014,0,1,1,2,50.0
292205,2015,1,0,0,1,100.0
292205,2016,6,0,0,6,100.0
292205,2017,5,0,0,5,100.0
292205,2018,6,0,0,6,100.0
292205,2019,3,0,1,4,75.0
292205,2020,8,0,0,8,100.0
292210,2012,1,1,0,2,100.0
292210,2013,6,0,0,6,100.0
292210,2014,5,0,0,5,100.0
292210,2015,7,0,0,7,100.0
292210,2016,9,0,0,9,100.0
292210,2017,10,0,1,11,90.9090909090909
292210,2019,5,0,1,6,83.33333333333334
292210,2020,14,0,0,14,100.0
292220,2013,2,0,0,2,100.0
292220,2014,1,0,0,1,100.0
292220,2016,4,0,0,4,100.0
292220,2017,3,0,0,3,100.0
292220,2018,2,0,0,2,100.0
292220,2019,3,0,0,3,100.0
292220,2020,1,0,1,2,50.0
292225,2012,2,0,2,4,50.0
292225,2013,3,1,0,4,100.0
292225,2014,6,0,0,6,100.0
292225,2015,4,0,0,4,100.0
292225,2016,0,0,2,2,0.0
292225,2017,0,0,1,1,0.0
292225,2018,3,0,0,3,100.0
292225,2019,8,0,0,8,100.0
292225,2020,2,0,0,2,100.0
292230,2012,11,0,0,11,100.0
292230,2013,6,0,1,7,85.71428571428571
292230,2014,8,0,0,8,100.0
292230,2015,11,0,1,12,91.66666666666666
292230,2016,15,0,0,15,100.0
292230,2017,12,0,0,12,100.0
292230,2018,13,0,0,13,100.0
292230,2019,9,0,0,9,100.0
292230,2020,9,0,0,9,100.0
292240,2012,6,0,2,8,75.0
292240,2013,5,0,0,5,100.0
292240,2014,6,0,1,7,85.71428571428571
292240,2015,5,0,0,5,100.0
292240,2016,7,0,1,8,87.5
292240,2017,10,0,1,11,90.9090909090909
292240,2018,5,0,1,6,83.33333333333334
292240,2019,1,0,3,4,25.0
292240,2020,6,0,2,8,75.0
292250,2012,9,0,0,9,100.0
292250,2013,12,0,0,12,100.0
292250,2014,5,0,2,7,71.42857142857143
292250,2015,9,0,0,9,100.0
292250,2016,7,0,1,8,87.5
292250,2017,12,0,1,13,92.3076923076923
292250,2018,9,0,0,9,100.0
292250,2019,9,0,2,11,81.81818181818183
292250,2020,10,0,0,10,100.0
292260,2012,2,0,0,2,100.0
292260,2013,5,0,0,5,100.0
292260,2014,2,1,1,4,75.0
292260,2015,5,0,0,5,100.0
292260,2016,3,0,0,3,100.0
292260,2017,7,0,0,7,100.0
292260,2018,1,0,0,1,100.0
292260,2019,6,0,1,7,85.71428571428571
292260,2020,2,0,3,5,40.0
292265,2012,2,0,2,4,50.0
292265,2013,3,0,0,3,100.0
292265,2014,1,0,3,4,25.0
292265,2015,1,0,0,1,100.0
292265,2016,4,0,0,4,100.0
292265,2017,3,1,0,4,100.0
292265,2018,2,0,0,2,100.0
292265,2019,0,0,3,3,0.0
292265,2020,0,0,2,2,0.0
292270,2012,0,0,5,5,0.0
292270,2013,0,0,2,2,0.0
292270,2014,0,0,4,4,0.0
292270,2015,0,0,4,4,0.0
292270,2016,1,0,0,1,100.0
292270,2017,3,0,0,3,100.0
292270,2018,7,0,0,7,100.0
292270,2019,2,0,1,3,66.66666666666666
292270,2020,0,0,3,3,0.0
292273,2012,0,1,2,3,33.33333333333333
292273,2013,1,0,0,1,100.0
292273,2014,0,0,1,1,0.0
292273,2015,0,0,1,1,0.0
292273,2016,2,0,3,5,40.0
292273,2017,0,0,2,2,0.0
292273,2018,2,0,0,2,100.0
292273,2019,0,0,2,2,0.0
292275,2012,1,0,0,1,100.0
292275,2013,1,0,0,1,100.0
292275,2014,0,0,1,1,0.0
292275,2015,3,0,2,5,60.0
292275,2016,1,0,0,1,100.0
292275,2017,1,0,0,1,100.0
292275,2019,1,0,0,1,100.0
292275,2020,2,0,0,2,100.0
292280,2012,3,0,2,5,60.0
292280,2013,2,0,1,3,66.66666666666666
292280,2014,0,0,2,2,0.0
292280,2016,4,0,0,4,100.0
292280,2017,3,0,0,3,100.0
292280,2018,4,0,0,4,100.0
292280,2019,3,0,1,4,75.0
292280,2020,6,0,0,6,100.0
292285,2012,0,0,3,3,0.0
292285,2013,0,1,2,3,33.33333333333333
292285,2014,1,0,1,2,50.0
292285,2015,0,0,2,2,0.0
292285,2016,0,0,1,1,0.0
292285,2017,0,0,1,1,0.0
292285,2018,2,0,2,4,50.0
292285,2019,0,0,4,4,0.0
292285,2020,0,0,5,5,0.0
292290,2012,6,0,2,8,75.0
292290,2013,6,0,0,6,100.0
292290,2014,6,0,5,11,54.54545454545454
292290,2015,0,0,7,7,0.0
292290,2016,0,3,7,10,30.0
292290,2017,0,0,5,5,0.0
292290,2018,0,0,7,7,0.0
292290,2019,0,0,10,10,0.0
292290,2020,0,0,6,6,0.0
292300,2012,11,2,5,18,72.22222222222221
292300,2013,15,0,1,16,93.75
292300,2014,15,0,1,16,93.75
292300,2015,11,0,7,18,61.111111111111114
292300,2016,3,0,18,21,14.285714285714285
292300,2017,1,0,8,9,11.11111111111111
292300,2018,0,0,17,17,0.0
292300,2019,0,0,13,13,0.0
292300,2020,9,0,16,25,36.0
292303,2012,2,0,0,2,100.0
292303,2013,1,0,0,1,100.0
292303,2014,1,0,0,1,100.0
292303,2015,5,0,0,5,100.0
292303,2016,4,0,1,5,80.0
292303,2017,2,0,0,2,100.0
292303,2018,2,0,0,2,100.0
292303,2019,0,0,3,3,0.0
292303,2020,5,0,0,5,100.0
292305,2012,4,0,0,4,100.0
292305,2013,3,0,0,3,100.0
292305,2014,5,0,0,5,100.0
292305,2015,3,0,0,3,100.0
292305,2016,5,0,0,5,100.0
292305,2017,4,0,0,4,100.0
292305,2018,1,0,0,1,100.0
292305,2019,2,0,0,2,100.0
292305,2020,3,0,0,3,100.0
292310,2012,13,0,0,13,100.0
292310,2013,10,0,0,10,100.0
292310,2014,11,0,0,11,100.0
292310,2015,9,0,1,10,90.0
292310,2016,7,0,1,8,87.5
292310,2017,2,0,1,3,66.66666666666666
292310,2018,5,0,3,8,62.5
292310,2019,1,1,7,9,22.22222222222222
292310,2020,0,0,8,8,0.0
292320,2012,7,0,0,7,100.0
292320,2013,7,0,0,7,100.0
292320,2014,4,0,0,4,100.0
292320,2015,12,0,0,12,100.0
292320,2016,9,0,0,9,100.0
292320,2017,8,0,0,8,100.0
292320,2018,7,0,0,7,100.0
292320,2019,6,0,0,6,100.0
292320,2020,5,0,1,6,83.33333333333334
292330,2013,0,0,1,1,0.0
292330,2014,1,0,0,1,100.0
292330,2015,2,0,0,2,100.0
292330,2016,3,0,1,4,75.0
292330,2017,3,0,0,3,100.0
292330,2018,2,0,0,2,100.0
292330,2019,1,0,0,1,100.0
292330,2020,1,0,1,2,50.0
292335,2012,3,0,0,3,100.0
292335,2013,1,0,6,7,14.285714285714285
292335,2014,0,0,7,7,0.0
292335,2015,3,0,0,3,100.0
292335,2016,5,0,2,7,71.42857142857143
292335,2017,5,0,0,5,100.0
292335,2018,8,0,0,8,100.0
292335,2019,5,0,0,5,100.0
292335,2020,6,0,0,6,100.0
292340,2012,3,0,0,3,100.0
292340,2013,4,0,6,10,40.0
292340,2014,4,0,4,8,50.0
292340,2015,2,0,3,5,40.0
292340,2016,2,0,1,3,66.66666666666666
292340,2017,4,0,2,6,66.66666666666666
292340,2018,1,0,3,4,25.0
292340,2019,5,1,4,10,60.0
292340,2020,10,0,0,10,100.0
292350,2012,0,0,1,1,0.0
292350,2013,1,0,1,2,50.0
292350,2015,6,0,0,6,100.0
292350,2016,2,0,0,2,100.0
292350,2017,2,0,0,2,100.0
292350,2018,2,0,2,4,50.0
292350,2019,0,0,4,4,0.0
292360,2012,6,0,1,7,85.71428571428571
292360,2013,2,0,0,2,100.0
292360,2014,2,0,0,2,100.0
292360,2015,2,0,0,2,100.0
292360,2016,4,0,0,4,100.0
292360,2017,4,0,1,5,80.0
292360,2018,9,0,0,9,100.0
292360,2019,3,0,0,3,100.0
292360,2020,1,0,0,1,100.0
292370,2012,6,0,0,6,100.0
292370,2013,6,0,1,7,85.71428571428571
292370,2014,2,0,5,7,28.57142857142857
292370,2015,1,0,6,7,14.285714285714285
292370,2016,6,1,3,10,70.0
292370,2017,4,0,0,4,100.0
292370,2018,4,0,4,8,50.0
292370,2019,5,0,7,12,41.66666666666667
292370,2020,6,0,6,12,50.0
292380,2012,6,0,0,6,100.0
292380,2013,4,0,0,4,100.0
292380,2014,2,0,0,2,100.0
292380,2015,4,0,0,4,100.0
292380,2016,5,0,0,5,100.0
292380,2017,10,0,0,10,100.0
292380,2018,6,0,0,6,100.0
292380,2019,3,0,2,5,60.0
292380,2020,3,0,1,4,75.0
292390,2012,3,0,0,3,100.0
292390,2013,2,0,0,2,100.0
292390,2014,4,0,0,4,100.0
292390,2015,5,0,0,5,100.0
292390,2016,5,0,0,5,100.0
292390,2017,4,0,0,4,100.0
292390,2018,1,0,0,1,100.0
292390,2019,6,0,0,6,100.0
292390,2020,7,0,0,7,100.0
292400,2012,48,0,0,48,100.0
292400,2013,48,0,2,50,96.0
292400,2014,43,0,4,47,91.48936170212765
292400,2015,23,2,5,30,83.33333333333334
292400,2016,35,5,10,50,80.0
292400,2017,35,1,4,40,90.0
292400,2018,39,1,4,44,90.9090909090909
292400,2019,30,2,21,53,60.37735849056604
292400,2020,27,4,19,50,62.0
292405,2012,4,0,2,6,66.66666666666666
292405,2013,2,0,0,2,100.0
292405,2014,2,0,0,2,100.0
292405,2015,6,0,0,6,100.0
292405,2016,2,0,2,4,50.0
292405,2017,3,0,0,3,100.0
292405,2018,4,0,0,4,100.0
292405,2019,2,0,0,2,100.0
292405,2020,0,1,2,3,33.33333333333333
292410,2012,2,0,0,2,100.0
292410,2013,6,0,0,6,100.0
292410,2014,1,0,0,1,100.0
292410,2015,3,0,0,3,100.0
292410,2016,3,0,0,3,100.0
292410,2017,4,0,0,4,100.0
292410,2018,5,0,0,5,100.0
292410,2019,1,0,0,1,100.0
292410,2020,2,0,0,2,100.0
292420,2012,2,0,1,3,66.66666666666666
292420,2013,1,1,1,3,66.66666666666666
292420,2014,2,0,0,2,100.0
292420,2015,2,0,0,2,100.0
292420,2016,2,0,0,2,100.0
292420,2017,4,0,0,4,100.0
292420,2018,2,0,0,2,100.0
292420,2019,4,0,0,4,100.0
292420,2020,1,1,2,4,50.0
292430,2012,8,0,0,8,100.0
292430,2013,3,0,0,3,100.0
292430,2014,12,0,0,12,100.0
292430,2015,4,0,0,4,100.0
292430,2016,11,0,0,11,100.0
292430,2017,5,0,0,5,100.0
292430,2018,7,0,0,7,100.0
292430,2019,7,0,0,7,100.0
292430,2020,4,0,0,4,100.0
292440,2012,7,0,0,7,100.0
292440,2013,9,0,0,9,100.0
292440,2014,13,0,2,15,86.66666666666667
292440,2015,6,0,0,6,100.0
292440,2016,2,0,4,6,33.33333333333333
292440,2017,2,1,2,5,60.0
292440,2018,2,0,1,3,66.66666666666666
292440,2019,5,1,2,8,75.0
292440,2020,9,0,0,9,100.0
292450,2012,2,0,1,3,66.66666666666666
292450,2013,4,0,1,5,80.0
292450,2014,2,0,1,3,66.66666666666666
292450,2015,1,0,0,1,100.0
292450,2016,1,0,2,3,33.33333333333333
292450,2017,7,0,0,7,100.0
292450,2019,3,0,3,6,50.0
292450,2020,4,0,0,4,100.0
292460,2012,3,0,1,4,75.0
292460,2013,2,0,1,3,66.66666666666666
292460,2014,5,1,1,7,85.71428571428571
292460,2015,4,1,1,6,83.33333333333334
292460,2016,6,0,0,6,100.0
292460,2017,8,0,0,8,100.0
292460,2018,7,0,0,7,100.0
292460,2019,6,0,0,6,100.0
292460,2020,6,0,0,6,100.0
292465,2012,2,0,2,4,50.0
292465,2013,5,0,3,8,62.5
292465,2014,0,0,2,2,0.0
292465,2015,3,0,1,4,75.0
292465,2016,0,0,3,3,0.0
292465,2017,0,0,4,4,0.0
292465,2018,0,0,2,2,0.0
292465,2019,0,0,2,2,0.0
292465,2020,0,1,8,9,11.11111111111111
292467,2012,3,0,0,3,100.0
292467,2013,2,0,0,2,100.0
292467,2014,3,0,0,3,100.0
292467,2015,2,0,0,2,100.0
292467,2016,1,0,1,2,50.0
292467,2017,0,0,2,2,0.0
292467,2018,0,0,1,1,0.0
292467,2019,0,0,4,4,0.0
292470,2012,0,0,3,3,0.0
292470,2013,0,0,1,1,0.0
292470,2015,4,0,0,4,100.0
292470,2016,2,0,0,2,100.0
292470,2017,0,0,2,2,0.0
292470,2018,0,0,3,3,0.0
292470,2020,1,0,0,1,100.0
292480,2012,0,0,4,4,0.0
292480,2013,0,1,5,6,16.666666666666664
292480,2014,0,1,5,6,16.666666666666664
292480,2015,6,0,0,6,100.0
292480,2016,7,0,0,7,100.0
292480,2017,10,0,0,10,100.0
292480,2018,5,0,0,5,100.0
292480,2019,4,0,0,4,100.0
292480,2020,8,0,0,8,100.0
292490,2012,1,0,0,1,100.0
292490,2013,2,0,0,2,100.0
292490,2015,2,0,0,2,100.0
292490,2016,1,1,0,2,100.0
292490,2017,1,0,0,1,100.0
292490,2018,1,0,1,2,50.0
292490,2020,0,0,1,1,0.0
292500,2012,4,1,3,8,62.5
292500,2013,1,7,3,11,72.72727272727273
292500,2014,2,1,6,9,33.33333333333333
292500,2015,0,3,9,12,25.0
292500,2016,1,5,7,13,46.15384615384615
292500,2017,0,1,7,8,12.5
292500,2018,10,0,0,10,100.0
292500,2019,1,0,7,8,12.5
292500,2020,0,3,9,12,25.0
292510,2012,20,0,0,20,100.0
292510,2013,9,2,6,17,64.70588235294117
292510,2014,10,3,2,15,86.66666666666667
292510,2015,10,0,0,10,100.0
292510,2016,17,0,1,18,94.44444444444444
292510,2017,18,0,3,21,85.71428571428571
292510,2018,11,0,5,16,68.75
292510,2019,3,1,10,14,28.57142857142857
292510,2020,1,0,16,17,5.88235294117647
292520,2012,12,0,2,14,85.71428571428571
292520,2013,13,0,0,13,100.0
292520,2014,13,0,0,13,100.0
292520,2015,17,0,0,17,100.0
292520,2016,14,1,0,15,100.0
292520,2017,10,0,6,16,62.5
292520,2018,10,0,0,10,100.0
292520,2019,13,0,8,21,61.904761904761905
292520,2020,13,0,5,18,72.22222222222221
292525,2012,3,0,3,6,50.0
292525,2013,3,1,1,5,80.0
292525,2014,7,0,1,8,87.5
292525,2015,6,0,1,7,85.71428571428571
292525,2016,7,0,1,8,87.5
292525,2017,10,0,0,10,100.0
292525,2018,1,0,0,1,100.0
292525,2019,2,0,0,2,100.0
292525,2020,5,0,0,5,100.0
292530,2012,53,0,1,54,98.14814814814815
292530,2013,51,0,0,51,100.0
292530,2014,56,0,0,56,100.0
292530,2015,54,0,0,54,100.0
292530,2016,53,1,21,75,72.0
292530,2017,24,1,19,44,56.81818181818182
292530,2018,38,3,28,69,59.42028985507246
292530,2019,31,1,22,54,59.25925925925925
292530,2020,22,6,41,69,40.57971014492754
292540,2013,1,0,4,5,20.0
292540,2014,0,0,4,4,0.0
292540,2015,0,0,1,1,0.0
292540,2016,1,0,3,4,25.0
292540,2018,0,0,2,2,0.0
292540,2019,0,0,4,4,0.0
292540,2020,0,1,3,4,25.0
292550,2012,11,0,0,11,100.0
292550,2013,17,0,0,17,100.0
292550,2014,12,0,0,12,100.0
292550,2015,10,0,1,11,90.9090909090909
292550,2016,0,2,11,13,15.384615384615385
292550,2017,1,0,9,10,10.0
292550,2018,8,0,5,13,61.53846153846154
292550,2019,9,0,3,12,75.0
292550,2020,8,0,6,14,57.14285714285714
292560,2012,0,1,5,6,16.666666666666664
292560,2013,0,1,7,8,12.5
292560,2014,7,0,2,9,77.77777777777779
292560,2015,1,0,0,1,100.0
292560,2016,7,0,0,7,100.0
292560,2017,7,0,0,7,100.0
292560,2018,3,0,0,3,100.0
292560,2019,5,0,0,5,100.0
292560,2020,7,0,0,7,100.0
292570,2012,1,0,4,5,20.0
292570,2013,1,0,4,5,20.0
292570,2014,0,0,2,2,0.0
292570,2015,0,1,2,3,33.33333333333333
292570,2016,0,0,8,8,0.0
292570,2017,0,0,1,1,0.0
292570,2019,2,0,0,2,100.0
292570,2020,0,0,2,2,0.0
292575,2012,4,2,3,9,66.66666666666666
292575,2013,3,0,1,4,75.0
292575,2014,6,0,0,6,100.0
292575,2015,12,0,0,12,100.0
292575,2016,11,0,0,11,100.0
292575,2017,7,1,2,10,80.0
292575,2018,5,0,4,9,55.55555555555556
292575,2019,2,1,7,10,30.0
292575,2020,11,0,2,13,84.61538461538461
292580,2012,5,0,1,6,83.33333333333334
292580,2013,3,0,6,9,33.33333333333333
292580,2014,5,0,4,9,55.55555555555556
292580,2015,7,0,2,9,77.77777777777779
292580,2016,4,0,3,7,57.14285714285714
292580,2017,5,0,2,7,71.42857142857143
292580,2018,5,0,0,5,100.0
292580,2019,5,0,0,5,100.0
292580,2020,8,0,1,9,88.88888888888889
292590,2012,1,0,3,4,25.0
292590,2013,1,0,3,4,25.0
292590,2014,0,1,0,1,100.0
292590,2015,0,0,6,6,0.0
292590,2016,8,0,2,10,80.0
292590,2017,5,0,0,5,100.0
292590,2018,10,0,0,10,100.0
292590,2019,6,0,0,6,100.0
292590,2020,4,0,2,6,66.66666666666666
292593,2012,0,1,1,2,50.0
292593,2013,1,0,0,1,100.0
292593,2014,0,1,3,4,25.0
292593,2015,2,0,0,2,100.0
292593,2016,2,0,0,2,100.0
292593,2017,4,0,0,4,100.0
292593,2018,3,0,0,3,100.0
292593,2019,1,0,1,2,50.0
292593,2020,0,0,2,2,0.0
292595,2012,3,0,3,6,50.0
292595,2013,2,0,4,6,33.33333333333333
292595,2014,2,0,2,4,50.0
292595,2015,0,0,5,5,0.0
292595,2016,0,0,10,10,0.0
292595,2017,5,0,0,5,100.0
292595,2018,6,0,0,6,100.0
292595,2019,8,0,0,8,100.0
292595,2020,6,2,1,9,88.88888888888889
292600,2012,9,0,0,9,100.0
292600,2013,9,0,0,9,100.0
292600,2014,9,0,0,9,100.0
292600,2015,11,0,0,11,100.0
292600,2016,6,0,0,6,100.0
292600,2017,16,0,0,16,100.0
292600,2018,10,0,0,10,100.0
292600,2019,15,0,0,15,100.0
292600,2020,15,0,0,15,100.0
292610,2012,1,0,0,1,100.0
292610,2013,4,1,3,8,62.5
292610,2014,4,0,2,6,66.66666666666666
292610,2015,2,0,2,4,50.0
292610,2016,4,0,0,4,100.0
292610,2018,2,0,0,2,100.0
292610,2019,6,0,0,6,100.0
292610,2020,3,0,0,3,100.0
292620,2012,8,0,4,12,66.66666666666666
292620,2013,12,0,0,12,100.0
292620,2014,6,0,0,6,100.0
292620,2015,7,0,2,9,77.77777777777779
292620,2016,9,0,2,11,81.81818181818183
292620,2017,13,0,0,13,100.0
292620,2018,11,0,0,11,100.0
292620,2019,10,0,0,10,100.0
292620,2020,15,0,0,15,100.0
292630,2012,6,0,5,11,54.54545454545454
292630,2013,5,0,7,12,41.66666666666667
292630,2014,0,0,4,4,0.0
292630,2015,0,0,13,13,0.0
292630,2016,2,1,2,5,60.0
292630,2017,0,0,15,15,0.0
292630,2018,0,0,12,12,0.0
292630,2019,0,0,10,10,0.0
292630,2020,0,1,4,5,20.0
292640,2012,14,0,0,14,100.0
292640,2013,9,1,0,10,100.0
292640,2014,5,2,1,8,87.5
292640,2015,4,4,6,14,57.14285714285714
292640,2016,2,0,8,10,20.0
292640,2017,10,0,0,10,100.0
292640,2018,14,0,0,14,100.0
292640,2019,8,0,0,8,100.0
292640,2020,10,0,0,10,100.0
292650,2012,0,0,1,1,0.0
292650,2013,2,0,0,2,100.0
292650,2014,7,0,0,7,100.0
292650,2015,1,0,0,1,100.0
292650,2016,0,0,1,1,0.0
292650,2017,4,0,0,4,100.0
292650,2018,5,0,0,5,100.0
292650,2019,4,0,0,4,100.0
292650,2020,2,0,0,2,100.0
292660,2012,10,0,0,10,100.0
292660,2013,15,0,0,15,100.0
292660,2014,15,0,7,22,68.18181818181817
292660,2015,20,0,5,25,80.0
292660,2016,9,0,1,10,90.0
292660,2017,13,0,1,14,92.85714285714286
292660,2018,22,0,7,29,75.86206896551724
292660,2019,16,0,0,16,100.0
292660,2020,27,0,0,27,100.0
292665,2012,1,0,0,1,100.0
292665,2014,1,1,2,4,50.0
292665,2015,2,0,0,2,100.0
292665,2016,2,0,0,2,100.0
292665,2017,6,0,0,6,100.0
292665,2018,2,0,0,2,100.0
292665,2019,4,0,0,4,100.0
292665,2020,2,0,0,2,100.0
292670,2012,2,0,0,2,100.0
292670,2013,3,0,1,4,75.0
292670,2014,4,0,1,5,80.0
292670,2015,4,0,0,4,100.0
292670,2016,4,0,0,4,100.0
292670,2017,3,0,0,3,100.0
292670,2018,2,0,0,2,100.0
292670,2019,2,1,1,4,75.0
292670,2020,2,0,0,2,100.0
292680,2012,0,0,1,1,0.0
292680,2013,0,0,2,2,0.0
292680,2014,0,0,2,2,0.0
292680,2015,1,0,3,4,25.0
292680,2016,1,0,1,2,50.0
292680,2017,1,0,2,3,33.33333333333333
292680,2018,2,0,2,4,50.0
292680,2019,0,0,3,3,0.0
292680,2020,0,1,1,2,50.0
292690,2012,1,1,2,4,50.0
292690,2013,0,0,1,1,0.0
292690,2014,2,0,0,2,100.0
292690,2015,0,0,6,6,0.0
292690,2016,0,0,2,2,0.0
292690,2017,0,0,2,2,0.0
292690,2018,0,0,1,1,0.0
292690,2019,0,0,2,2,0.0
292690,2020,0,0,4,4,0.0
292700,2012,11,0,0,11,100.0
292700,2013,15,0,2,17,88.23529411764706
292700,2014,10,0,4,14,71.42857142857143
292700,2015,10,0,3,13,76.92307692307693
292700,2016,10,0,7,17,58.82352941176471
292700,2017,9,0,0,9,100.0
292700,2018,11,0,2,13,84.61538461538461
292700,2019,13,0,1,14,92.85714285714286
292700,2020,9,0,5,14,64.28571428571429
292710,2012,5,0,0,5,100.0
292710,2013,4,0,1,5,80.0
292710,2014,3,0,0,3,100.0
292710,2015,2,0,1,3,66.66666666666666
292710,2016,2,0,1,3,66.66666666666666
292710,2017,3,0,1,4,75.0
292710,2019,0,1,1,2,50.0
292710,2020,0,0,3,3,0.0
292720,2012,12,0,0,12,100.0
292720,2013,7,0,0,7,100.0
292720,2014,7,0,0,7,100.0
292720,2015,14,0,0,14,100.0
292720,2016,12,0,0,12,100.0
292720,2017,3,0,7,10,30.0
292720,2018,3,1,7,11,36.36363636363637
292720,2019,4,0,4,8,50.0
292720,2020,0,0,9,9,0.0
292730,2012,2,0,7,9,22.22222222222222
292730,2013,2,0,7,9,22.22222222222222
292730,2014,5,0,0,5,100.0
292730,2015,7,0,1,8,87.5
292730,2016,4,0,1,5,80.0
292730,2017,3,3,3,9,66.66666666666666
292730,2018,0,0,4,4,0.0
292730,2019,1,0,7,8,12.5
292730,2020,1,0,3,4,25.0
292740,2012,376,184,563,1123,49.86642920747996
292740,2013,453,216,407,1076,62.174721189591075
292740,2014,452,91,448,991,54.79313824419778
292740,2015,393,214,405,1012,59.980237154150196
292740,2016,540,156,269,965,72.12435233160622
292740,2017,410,217,349,976,64.24180327868852
292740,2018,439,185,382,1006,62.02783300198808
292740,2019,376,45,510,931,45.22019334049409
292740,2020,298,284,647,1229,47.35557363710334
292750,2012,3,0,6,9,33.33333333333333
292750,2013,2,0,2,4,50.0
292750,2014,0,1,11,12,8.333333333333332
292750,2015,7,0,2,9,77.77777777777779
292750,2016,4,0,3,7,57.14285714285714
292750,2017,2,1,3,6,50.0
292750,2018,0,0,4,4,0.0
292750,2019,0,0,11,11,0.0
292750,2020,0,2,8,10,20.0
292760,2012,4,0,0,4,100.0
292760,2013,2,0,0,2,100.0
292760,2014,5,0,1,6,83.33333333333334
292760,2015,5,1,0,6,100.0
292760,2016,1,0,0,1,100.0
292760,2017,4,0,3,7,57.14285714285714
292760,2018,1,0,0,1,100.0
292760,2019,2,0,0,2,100.0
292760,2020,5,0,0,5,100.0
292770,2012,11,0,1,12,91.66666666666666
292770,2013,10,0,0,10,100.0
292770,2014,11,0,0,11,100.0
292770,2015,11,0,1,12,91.66666666666666
292770,2016,8,0,0,8,100.0
292770,2017,13,0,0,13,100.0
292770,2018,12,0,0,12,100.0
292770,2019,13,0,1,14,92.85714285714286
292770,2020,13,0,0,13,100.0
292780,2012,2,0,0,2,100.0
292780,2013,3,0,0,3,100.0
292780,2015,3,0,0,3,100.0
292780,2016,2,0,0,2,100.0
292780,2017,3,0,0,3,100.0
292780,2018,1,0,0,1,100.0
292780,2019,2,0,0,2,100.0
292780,2020,4,0,0,4,100.0
292790,2012,0,1,8,9,11.11111111111111
292790,2013,4,0,0,4,100.0
292790,2014,1,0,0,1,100.0
292790,2015,0,0,1,1,0.0
292790,2016,0,1,10,11,9.090909090909092
292790,2017,4,0,0,4,100.0
292790,2018,4,0,0,4,100.0
292790,2019,3,0,0,3,100.0
292790,2020,2,0,0,2,100.0
292800,2012,3,1,8,12,33.33333333333333
292800,2013,8,0,3,11,72.72727272727273
292800,2014,4,0,3,7,57.14285714285714
292800,2015,7,0,3,10,70.0
292800,2016,8,0,1,9,88.88888888888889
292800,2017,8,0,0,8,100.0
292800,2018,5,0,0,5,100.0
292800,2019,13,0,0,13,100.0
292800,2020,9,0,2,11,81.81818181818183
292805,2012,1,0,4,5,20.0
292805,2013,3,0,1,4,75.0
292805,2014,7,0,0,7,100.0
292805,2015,4,1,0,5,100.0
292805,2016,4,0,0,4,100.0
292805,2017,6,0,0,6,100.0
292805,2018,5,1,2,8,75.0
292805,2019,5,0,0,5,100.0
292805,2020,4,0,4,8,50.0
292810,2012,12,0,0,12,100.0
292810,2013,22,0,1,23,95.65217391304348
292810,2014,11,0,0,11,100.0
292810,2015,10,0,0,10,100.0
292810,2016,9,0,0,9,100.0
292810,2017,16,0,1,17,94.11764705882352
292810,2018,7,0,1,8,87.5
292810,2019,12,0,4,16,75.0
292810,2020,1,1,10,12,16.666666666666664
292820,2012,0,0,5,5,0.0
292820,2013,0,0,4,4,0.0
292820,2014,1,1,6,8,25.0
292820,2015,2,0,3,5,40.0
292820,2016,2,0,4,6,33.33333333333333
292820,2017,3,0,0,3,100.0
292820,2018,9,0,0,9,100.0
292820,2019,4,0,1,5,80.0
292820,2020,10,1,2,13,84.61538461538461
292830,2012,1,0,0,1,100.0
292830,2013,0,0,1,1,0.0
292830,2014,0,1,3,4,25.0
292830,2015,0,1,0,1,100.0
292830,2016,0,0,4,4,0.0
292830,2017,1,0,4,5,20.0
292830,2018,0,0,2,2,0.0
292830,2020,0,0,1,1,0.0
292840,2012,11,0,0,11,100.0
292840,2013,15,0,0,15,100.0
292840,2014,6,0,0,6,100.0
292840,2015,6,0,0,6,100.0
292840,2016,6,0,0,6,100.0
292840,2017,8,0,0,8,100.0
292840,2018,8,0,0,8,100.0
292840,2019,12,0,1,13,92.3076923076923
292840,2020,5,0,0,5,100.0
292850,2012,3,0,0,3,100.0
292850,2013,3,0,0,3,100.0
292850,2015,2,0,0,2,100.0
292850,2016,4,0,0,4,100.0
292850,2017,5,0,0,5,100.0
292850,2018,4,0,0,4,100.0
292850,2019,2,0,0,2,100.0
292850,2020,4,0,0,4,100.0
292860,2012,3,0,20,23,13.043478260869565
292860,2013,5,1,12,18,33.33333333333333
292860,2014,0,0,13,13,0.0
292860,2015,2,2,27,31,12.903225806451612
292860,2016,1,0,18,19,5.263157894736842
292860,2017,0,1,22,23,4.3478260869565215
292860,2018,0,0,18,18,0.0
292860,2019,0,0,25,25,0.0
292860,2020,2,0,25,27,7.4074074074074066
292870,2012,33,0,3,36,91.66666666666666
292870,2013,23,0,2,25,92.0
292870,2014,36,0,4,40,90.0
292870,2015,19,0,6,25,76.0
292870,2016,30,0,6,36,83.33333333333334
292870,2017,33,0,6,39,84.61538461538461
292870,2018,41,0,0,41,100.0
292870,2019,33,0,0,33,100.0
292870,2020,26,0,1,27,96.29629629629629
292880,2012,10,0,9,19,52.63157894736842
292880,2013,7,0,12,19,36.84210526315789
292880,2014,1,1,17,19,10.526315789473683
292880,2015,25,0,2,27,92.5925925925926
292880,2016,16,0,1,17,94.11764705882352
292880,2017,16,1,4,21,80.95238095238095
292880,2018,25,0,0,25,100.0
292880,2019,12,0,3,15,80.0
292880,2020,22,0,0,22,100.0
292890,2012,5,0,0,5,100.0
292890,2013,8,0,1,9,88.88888888888889
292890,2014,7,0,0,7,100.0
292890,2015,10,0,0,10,100.0
292890,2016,8,0,0,8,100.0
292890,2017,8,0,0,8,100.0
292890,2018,12,0,0,12,100.0
292890,2019,9,0,0,9,100.0
292890,2020,6,0,0,6,100.0
292895,2012,3,0,0,3,100.0
292895,2013,1,0,0,1,100.0
292895,2014,1,0,0,1,100.0
292895,2015,4,0,0,4,100.0
292895,2016,3,0,0,3,100.0
292895,2017,2,0,0,2,100.0
292895,2018,2,0,0,2,100.0
292895,2019,3,0,0,3,100.0
292895,2020,7,0,0,7,100.0
292900,2012,1,0,1,2,50.0
292900,2013,5,0,1,6,83.33333333333334
292900,2014,4,0,1,5,80.0
292900,2015,2,0,0,2,100.0
292900,2016,2,2,2,6,66.66666666666666
292900,2017,3,0,0,3,100.0
292900,2018,8,0,0,8,100.0
292900,2019,1,0,1,2,50.0
292900,2020,3,1,1,5,80.0
292905,2012,7,0,0,7,100.0
292905,2013,4,0,0,4,100.0
292905,2014,7,0,0,7,100.0
292905,2015,6,0,0,6,100.0
292905,2016,8,0,0,8,100.0
292905,2017,2,0,1,3,66.66666666666666
292905,2018,0,1,1,2,50.0
292905,2019,0,4,3,7,57.14285714285714
292905,2020,1,0,4,5,20.0
292910,2012,2,0,15,17,11.76470588235294
292910,2013,6,0,0,6,100.0
292910,2014,6,0,2,8,75.0
292910,2015,3,0,2,5,60.0
292910,2016,5,0,0,5,100.0
292910,2017,6,0,0,6,100.0
292910,2018,8,0,2,10,80.0
292910,2019,4,0,5,9,44.44444444444444
292910,2020,1,0,5,6,16.666666666666664
292920,2012,12,0,3,15,80.0
292920,2013,6,0,4,10,60.0
292920,2014,14,0,0,14,100.0
292920,2015,15,0,2,17,88.23529411764706
292920,2016,8,0,0,8,100.0
292920,2017,8,0,1,9,88.88888888888889
292920,2018,8,0,0,8,100.0
292920,2019,10,0,6,16,62.5
292920,2020,20,0,2,22,90.9090909090909
292925,2012,2,0,3,5,40.0
292925,2013,0,1,7,8,12.5
292925,2014,0,0,9,9,0.0
292925,2015,0,0,8,8,0.0
292925,2016,3,0,0,3,100.0
292925,2017,5,1,0,6,100.0
292925,2018,6,0,0,6,100.0
292925,2019,6,0,0,6,100.0
292925,2020,2,0,0,2,100.0
292930,2012,9,0,1,10,90.0
292930,2013,6,0,0,6,100.0
292930,2014,8,0,1,9,88.88888888888889
292930,2015,10,0,0,10,100.0
292930,2016,6,1,2,9,77.77777777777779
292930,2017,0,0,8,8,0.0
292930,2018,6,0,8,14,42.857142857142854
292930,2019,0,1,14,15,6.666666666666667
292930,2020,1,3,10,14,28.57142857142857
292935,2012,4,1,3,8,62.5
292935,2013,0,0,1,1,0.0
292935,2014,2,0,0,2,100.0
292935,2015,5,0,0,5,100.0
292935,2016,5,0,0,5,100.0
292935,2017,3,0,0,3,100.0
292935,2018,6,0,0,6,100.0
292935,2019,3,0,0,3,100.0
292935,2020,3,0,0,3,100.0
292937,2012,0,0,1,1,0.0
292937,2013,0,0,2,2,0.0
292937,2014,0,2,2,4,50.0
292937,2015,1,0,0,1,100.0
292937,2016,5,0,0,5,100.0
292937,2017,2,0,0,2,100.0
292937,2018,1,0,0,1,100.0
292937,2019,2,0,0,2,100.0
292937,2020,3,0,0,3,100.0
292940,2012,1,0,2,3,33.33333333333333
292940,2013,4,0,1,5,80.0
292940,2014,4,0,0,4,100.0
292940,2015,4,0,0,4,100.0
292940,2016,4,0,0,4,100.0
292940,2017,4,0,0,4,100.0
292940,2018,2,0,1,3,66.66666666666666
292940,2019,1,0,2,3,33.33333333333333
292940,2020,5,0,0,5,100.0
292950,2012,15,0,1,16,93.75
292950,2013,12,1,2,15,86.66666666666667
292950,2014,15,0,2,17,88.23529411764706
292950,2015,13,0,0,13,100.0
292950,2016,10,0,0,10,100.0
292950,2017,14,0,1,15,93.33333333333333
292950,2018,12,0,5,17,70.58823529411765
292950,2019,6,0,13,19,31.57894736842105
292950,2020,5,1,16,22,27.27272727272727
292960,2012,4,0,3,7,57.14285714285714
292960,2013,4,0,0,4,100.0
292960,2014,5,0,0,5,100.0
292960,2015,1,1,0,2,100.0
292960,2016,5,0,0,5,100.0
292960,2017,5,0,0,5,100.0
292960,2018,7,0,0,7,100.0
292960,2019,4,0,0,4,100.0
292960,2020,3,0,2,5,60.0
292970,2012,6,0,3,9,66.66666666666666
292970,2013,2,0,0,2,100.0
292970,2014,2,0,0,2,100.0
292970,2015,0,1,6,7,14.285714285714285
292970,2016,0,0,12,12,0.0
292970,2017,4,0,2,6,66.66666666666666
292970,2018,3,0,3,6,50.0
292970,2019,1,0,5,6,16.666666666666664
292970,2020,6,0,0,6,100.0
292975,2012,0,1,3,4,25.0
292975,2013,0,2,3,5,40.0
292975,2014,0,0,4,4,0.0
292975,2015,0,0,4,4,0.0
292975,2016,0,0,6,6,0.0
292975,2017,0,1,3,4,25.0
292975,2018,0,0,4,4,0.0
292975,2019,1,0,2,3,33.33333333333333
292975,2020,0,0,8,8,0.0
292980,2012,4,0,1,5,80.0
292980,2013,1,0,1,2,50.0
292980,2014,2,0,2,4,50.0
292980,2015,7,0,0,7,100.0
292980,2016,3,0,0,3,100.0
292980,2017,2,0,0,2,100.0
292980,2018,4,0,0,4,100.0
292980,2019,2,0,0,2,100.0
292980,2020,8,0,0,8,100.0
292990,2012,10,1,2,13,84.61538461538461
292990,2013,10,0,0,10,100.0
292990,2014,8,0,3,11,72.72727272727273
292990,2015,10,0,4,14,71.42857142857143
292990,2016,5,0,14,19,26.31578947368421
292990,2017,11,0,4,15,73.33333333333333
292990,2018,6,0,8,14,42.857142857142854
292990,2019,5,0,12,17,29.411764705882355
292990,2020,2,0,6,8,25.0
293000,2012,1,0,3,4,25.0
293000,2013,0,0,3,3,0.0
293000,2014,0,0,1,1,0.0
293000,2015,2,0,1,3,66.66666666666666
293000,2016,5,0,0,5,100.0
293000,2017,1,0,0,1,100.0
293000,2018,3,0,0,3,100.0
293000,2019,1,0,0,1,100.0
293000,2020,3,0,0,3,100.0
293010,2012,21,0,0,21,100.0
293010,2013,19,0,0,19,100.0
293010,2014,20,1,0,21,100.0
293010,2015,25,0,3,28,89.28571428571429
293010,2016,29,0,0,29,100.0
293010,2017,35,0,0,35,100.0
293010,2018,20,0,0,20,100.0
293010,2019,28,1,0,29,100.0
293010,2020,30,0,1,31,96.7741935483871
293015,2012,0,0,4,4,0.0
293015,2013,2,0,7,9,22.22222222222222
293015,2014,1,0,4,5,20.0
293015,2015,0,0,6,6,0.0
293015,2016,0,0,10,10,0.0
293015,2017,1,0,7,8,12.5
293015,2018,0,0,6,6,0.0
293015,2019,2,0,10,12,16.666666666666664
293015,2020,0,0,10,10,0.0
293020,2012,6,0,1,7,85.71428571428571
293020,2013,4,0,0,4,100.0
293020,2014,7,0,0,7,100.0
293020,2015,4,0,0,4,100.0
293020,2016,8,0,0,8,100.0
293020,2017,7,3,0,10,100.0
293020,2018,1,0,3,4,25.0
293020,2019,2,0,5,7,28.57142857142857
293020,2020,1,4,6,11,45.45454545454545
293030,2012,3,0,3,6,50.0
293030,2013,6,0,0,6,100.0
293030,2014,1,0,0,1,100.0
293030,2015,5,0,0,5,100.0
293030,2016,6,1,0,7,100.0
293030,2018,0,1,5,6,16.666666666666664
293030,2019,1,0,4,5,20.0
293030,2020,0,0,1,1,0.0
293040,2012,3,0,2,5,60.0
293040,2013,2,0,2,4,50.0
293040,2014,0,1,6,7,14.285714285714285
293040,2015,0,0,5,5,0.0
293040,2016,0,0,5,5,0.0
293040,2017,0,0,2,2,0.0
293040,2018,0,0,2,2,0.0
293040,2019,0,0,6,6,0.0
293040,2020,1,1,6,8,25.0
293050,2012,13,0,1,14,92.85714285714286
293050,2013,22,0,1,23,95.65217391304348
293050,2014,31,0,1,32,96.875
293050,2015,32,0,0,32,100.0
293050,2016,33,0,2,35,94.28571428571428
293050,2017,20,0,7,27,74.07407407407408
293050,2018,29,0,0,29,100.0
293050,2019,30,0,1,31,96.7741935483871
293050,2020,28,0,0,28,100.0
293060,2012,3,0,0,3,100.0
293060,2013,2,0,0,2,100.0
293060,2014,4,0,1,5,80.0
293060,2015,3,0,0,3,100.0
293060,2016,4,0,0,4,100.0
293060,2017,6,0,0,6,100.0
293060,2018,3,0,0,3,100.0
293060,2019,4,0,0,4,100.0
293060,2020,4,0,0,4,100.0
293070,2012,43,11,17,71,76.05633802816901
293070,2013,11,21,28,60,53.333333333333336
293070,2014,28,9,22,59,62.71186440677966
293070,2015,27,9,16,52,69.23076923076923
293070,2016,10,9,17,36,52.77777777777778
293070,2017,31,14,18,63,71.42857142857143
293070,2018,28,1,24,53,54.71698113207547
293070,2019,23,1,17,41,58.536585365853654
293070,2020,43,0,20,63,68.25396825396825
293075,2012,2,0,0,2,100.0
293075,2013,1,0,2,3,33.33333333333333
293075,2014,1,0,1,2,50.0
293075,2015,2,0,0,2,100.0
293075,2016,3,0,2,5,60.0
293075,2017,3,0,3,6,50.0
293075,2018,1,1,2,4,50.0
293075,2019,1,0,0,1,100.0
293075,2020,3,1,0,4,100.0
293076,2012,6,0,2,8,75.0
293076,2013,2,0,0,2,100.0
293076,2014,1,0,1,2,50.0
293076,2015,2,0,2,4,50.0
293076,2016,0,0,3,3,0.0
293076,2017,2,0,0,2,100.0
293076,2018,3,0,0,3,100.0
293076,2019,7,0,1,8,87.5
293076,2020,2,0,1,3,66.66666666666666
293077,2012,9,0,0,9,100.0
293077,2013,9,0,0,9,100.0
293077,2014,2,1,0,3,100.0
293077,2015,5,0,0,5,100.0
293077,2016,8,3,4,15,73.33333333333333
293077,2017,4,1,4,9,55.55555555555556
293077,2018,10,0,0,10,100.0
293077,2019,6,0,4,10,60.0
293077,2020,0,3,9,12,25.0
293080,2012,4,0,0,4,100.0
293080,2013,5,0,0,5,100.0
293080,2014,8,0,0,8,100.0
293080,2015,3,0,0,3,100.0
293080,2016,6,0,0,6,100.0
293080,2017,5,0,0,5,100.0
293080,2018,6,0,1,7,85.71428571428571
293080,2019,2,0,0,2,100.0
293080,2020,2,0,0,2,100.0
293090,2012,1,0,0,1,100.0
293090,2013,3,0,0,3,100.0
293090,2015,5,0,1,6,83.33333333333334
293090,2016,1,0,0,1,100.0
293090,2017,0,0,1,1,0.0
293090,2018,0,0,4,4,0.0
293090,2019,0,1,1,2,50.0
293090,2020,1,0,0,1,100.0
293100,2012,7,0,0,7,100.0
293100,2013,5,0,0,5,100.0
293100,2014,3,0,1,4,75.0
293100,2015,3,0,0,3,100.0
293100,2016,10,0,0,10,100.0
293100,2017,4,0,0,4,100.0
293100,2018,8,0,0,8,100.0
293100,2019,6,0,0,6,100.0
293100,2020,7,0,0,7,100.0
293105,2012,1,0,1,2,50.0
293105,2013,4,0,1,5,80.0
293105,2014,0,0,3,3,0.0
293105,2015,0,0,3,3,0.0
293105,2016,0,1,3,4,25.0
293105,2017,0,0,7,7,0.0
293105,2018,0,0,4,4,0.0
293105,2020,1,1,4,6,33.33333333333333
293110,2012,5,0,0,5,100.0
293110,2013,3,0,1,4,75.0
293110,2014,3,0,0,3,100.0
293110,2015,4,0,1,5,80.0
293110,2016,3,0,0,3,100.0
293110,2017,4,0,0,4,100.0
293110,2018,3,0,0,3,100.0
293110,2019,3,0,1,4,75.0
293110,2020,0,0,7,7,0.0
293120,2012,3,1,0,4,100.0
293120,2013,1,1,5,7,28.57142857142857
293120,2014,1,1,2,4,50.0
293120,2015,0,1,3,4,25.0
293120,2016,0,0,4,4,0.0
293120,2017,6,0,0,6,100.0
293120,2018,5,0,0,5,100.0
293120,2019,4,0,0,4,100.0
293120,2020,7,0,0,7,100.0
293130,2012,0,0,4,4,0.0
293130,2013,0,1,3,4,25.0
293130,2014,0,2,2,4,50.0
293130,2015,1,0,0,1,100.0
293130,2016,9,0,0,9,100.0
293130,2017,4,0,0,4,100.0
293130,2018,7,0,0,7,100.0
293130,2019,1,0,0,1,100.0
293130,2020,6,0,1,7,85.71428571428571
293135,2012,32,1,25,58,56.896551724137936
293135,2013,32,0,33,65,49.23076923076923
293135,2014,47,2,19,68,72.05882352941177
293135,2015,29,0,29,58,50.0
293135,2016,26,4,37,67,44.776119402985074
293135,2017,54,0,6,60,90.0
293135,2018,59,0,5,64,92.1875
293135,2019,47,1,7,55,87.27272727272727
293135,2020,44,4,24,72,66.66666666666666
293140,2012,2,0,0,2,100.0
293140,2013,1,0,0,1,100.0
293140,2015,2,0,0,2,100.0
293140,2016,5,0,0,5,100.0
293140,2018,3,0,0,3,100.0
293140,2019,2,0,0,2,100.0
293140,2020,6,0,0,6,100.0
293150,2012,10,0,2,12,83.33333333333334
293150,2013,8,0,0,8,100.0
293150,2014,6,0,0,6,100.0
293150,2015,5,0,0,5,100.0
293150,2016,6,0,0,6,100.0
293150,2017,0,0,5,5,0.0
293150,2018,9,0,0,9,100.0
293150,2019,1,0,4,5,20.0
293150,2020,7,0,0,7,100.0
293160,2012,1,0,0,1,100.0
293160,2013,3,0,0,3,100.0
293160,2014,4,0,1,5,80.0
293160,2015,3,0,0,3,100.0
293160,2016,4,0,0,4,100.0
293160,2017,5,0,0,5,100.0
293160,2018,1,0,0,1,100.0
293160,2019,4,0,0,4,100.0
293160,2020,0,0,7,7,0.0
293170,2012,6,0,0,6,100.0
293170,2013,1,0,0,1,100.0
293170,2014,3,0,1,4,75.0
293170,2015,12,0,0,12,100.0
293170,2016,4,0,0,4,100.0
293170,2017,2,0,0,2,100.0
293170,2018,3,0,0,3,100.0
293170,2019,2,0,0,2,100.0
293170,2020,7,1,0,8,100.0
293180,2012,0,1,3,4,25.0
293180,2013,7,0,0,7,100.0
293180,2014,4,0,1,5,80.0
293180,2015,6,0,0,6,100.0
293180,2016,4,0,0,4,100.0
293180,2017,1,0,1,2,50.0
293180,2018,7,0,2,9,77.77777777777779
293180,2019,1,0,3,4,25.0
293180,2020,0,0,2,2,0.0
293190,2012,10,0,7,17,58.82352941176471
293190,2013,2,0,11,13,15.384615384615385
293190,2014,4,0,3,7,57.14285714285714
293190,2015,14,0,8,22,63.63636363636363
293190,2016,11,0,4,15,73.33333333333333
293190,2017,3,1,8,12,33.33333333333333
293190,2018,1,0,6,7,14.285714285714285
293190,2019,2,0,11,13,15.384615384615385
293190,2020,0,1,9,10,10.0
293200,2012,2,0,2,4,50.0
293200,2013,4,1,4,9,55.55555555555556
293200,2014,2,1,3,6,50.0
293200,2015,1,1,1,3,66.66666666666666
293200,2016,5,0,5,10,50.0
293200,2017,3,1,0,4,100.0
293200,2018,4,0,0,4,100.0
293200,2019,2,0,1,3,66.66666666666666
293200,2020,1,0,6,7,14.285714285714285
293210,2012,1,1,4,6,33.33333333333333
293210,2013,1,0,3,4,25.0
293210,2014,2,0,1,3,66.66666666666666
293210,2015,2,0,1,3,66.66666666666666
293210,2016,2,0,3,5,40.0
293210,2017,5,0,5,10,50.0
293210,2018,2,0,1,3,66.66666666666666
293210,2019,0,0,5,5,0.0
293210,2020,0,0,4,4,0.0
293220,2012,5,0,4,9,55.55555555555556
293220,2013,2,0,10,12,16.666666666666664
293220,2014,0,0,3,3,0.0
293220,2015,7,2,4,13,69.23076923076923
293220,2016,6,1,1,8,87.5
293220,2017,6,0,2,8,75.0
293220,2018,5,0,0,5,100.0
293220,2019,8,0,2,10,80.0
293220,2020,4,0,0,4,100.0
293230,2012,2,0,5,7,28.57142857142857
293230,2013,1,0,5,6,16.666666666666664
293230,2014,0,2,8,10,20.0
293230,2015,9,1,2,12,83.33333333333334
293230,2016,7,1,0,8,100.0
293230,2017,1,0,3,4,25.0
293230,2018,3,0,3,6,50.0
293230,2019,6,0,3,9,66.66666666666666
293230,2020,11,0,0,11,100.0
293240,2012,3,0,1,4,75.0
293240,2013,4,0,0,4,100.0
293240,2014,6,0,0,6,100.0
293240,2015,7,0,0,7,100.0
293240,2016,6,0,0,6,100.0
293240,2017,4,0,0,4,100.0
293240,2018,3,0,0,3,100.0
293240,2019,3,0,1,4,75.0
293240,2020,0,0,4,4,0.0
293245,2012,2,0,0,2,100.0
293245,2013,3,0,0,3,100.0
293245,2014,5,0,0,5,100.0
293245,2016,4,0,2,6,66.66666666666666
293245,2017,4,0,1,5,80.0
293245,2018,3,0,0,3,100.0
293245,2019,4,0,2,6,66.66666666666666
293245,2020,0,0,2,2,0.0
293250,2012,8,0,1,9,88.88888888888889
293250,2013,8,0,0,8,100.0
293250,2014,10,0,0,10,100.0
293250,2015,5,0,0,5,100.0
293250,2016,6,0,0,6,100.0
293250,2017,6,0,0,6,100.0
293250,2018,11,0,0,11,100.0
293250,2019,11,0,1,12,91.66666666666666
293250,2020,6,0,0,6,100.0
293260,2012,5,0,2,7,71.42857142857143
293260,2013,0,0,2,2,0.0
293260,2014,3,0,0,3,100.0
293260,2015,3,0,0,3,100.0
293260,2016,4,2,3,9,66.66666666666666
293260,2017,6,0,2,8,75.0
293260,2018,2,0,3,5,40.0
293260,2019,0,0,2,2,0.0
293260,2020,0,0,4,4,0.0
293270,2012,7,0,1,8,87.5
293270,2013,5,1,2,8,75.0
293270,2014,6,0,0,6,100.0
293270,2015,3,0,2,5,60.0
293270,2016,7,2,1,10,90.0
293270,2017,2,0,2,4,50.0
293270,2018,7,0,4,11,63.63636363636363
293270,2019,6,1,6,13,53.84615384615385
293270,2020,2,2,6,10,40.0
293280,2012,9,0,1,10,90.0
293280,2013,2,0,3,5,40.0
293280,2014,0,0,2,2,0.0
293280,2015,0,0,9,9,0.0
293280,2016,2,0,6,8,25.0
293280,2017,7,0,1,8,87.5
293280,2018,0,0,2,2,0.0
293280,2019,5,2,0,7,100.0
293280,2020,5,0,2,7,71.42857142857143
293290,2012,27,0,0,27,100.0
293290,2013,27,3,0,30,100.0
293290,2014,45,1,5,51,90.19607843137256
293290,2015,26,0,5,31,83.87096774193549
293290,2016,17,3,9,29,68.96551724137932
293290,2017,23,0,1,24,95.83333333333334
293290,2018,26,0,3,29,89.65517241379311
293290,2019,3,0,31,34,8.823529411764707
293290,2020,0,4,26,30,13.333333333333334
293300,2012,5,0,3,8,62.5
293300,2013,2,0,1,3,66.66666666666666
293300,2014,4,0,0,4,100.0
293300,2015,4,0,0,4,100.0
293300,2016,5,0,2,7,71.42857142857143
293300,2017,5,0,6,11,45.45454545454545
293300,2018,2,0,3,5,40.0
293300,2019,0,0,7,7,0.0
293300,2020,2,0,7,9,22.22222222222222
293305,2012,0,6,2,8,75.0
293305,2013,0,0,4,4,0.0
293305,2014,0,1,4,5,20.0
293305,2015,3,0,1,4,75.0
293305,2016,2,0,0,2,100.0
293305,2017,1,0,0,1,100.0
293305,2018,4,0,1,5,80.0
293305,2019,2,0,1,3,66.66666666666666
293305,2020,8,0,0,8,100.0
293310,2012,0,0,1,1,0.0
293310,2013,0,0,1,1,0.0
293310,2015,3,0,0,3,100.0
293310,2016,3,0,0,3,100.0
293310,2018,3,0,0,3,100.0
293310,2020,4,0,0,4,100.0
293315,2012,3,0,4,7,42.857142857142854
293315,2013,2,0,5,7,28.57142857142857
293315,2014,3,0,3,6,50.0
293315,2015,0,0,2,2,0.0
293315,2016,1,0,2,3,33.33333333333333
293315,2017,5,0,0,5,100.0
293315,2018,4,0,0,4,100.0
293315,2019,5,0,0,5,100.0
293315,2020,6,0,0,6,100.0
293317,2012,3,0,0,3,100.0
293317,2013,4,0,0,4,100.0
293317,2014,6,0,0,6,100.0
293317,2015,4,0,0,4,100.0
293317,2016,2,0,0,2,100.0
293317,2017,6,0,0,6,100.0
293317,2018,3,0,0,3,100.0
293317,2019,4,0,0,4,100.0
293317,2020,3,0,0,3,100.0
293320,2012,11,1,5,17,70.58823529411765
293320,2013,12,0,3,15,80.0
293320,2014,11,0,0,11,100.0
293320,2015,17,0,3,20,85.0
293320,2016,15,0,9,24,62.5
293320,2017,0,1,22,23,4.3478260869565215
293320,2018,0,0,11,11,0.0
293320,2019,0,0,18,18,0.0
293320,2020,0,0,23,23,0.0
293325,2012,0,0,1,1,0.0
293325,2013,1,0,1,2,50.0
293325,2014,1,0,0,1,100.0
293325,2015,0,0,5,5,0.0
293325,2016,0,0,1,1,0.0
293325,2018,1,0,0,1,100.0
293325,2019,0,0,3,3,0.0
293325,2020,2,0,0,2,100.0
293330,2012,86,6,46,138,66.66666666666666
293330,2013,65,7,57,129,55.81395348837209
293330,2014,76,3,33,112,70.53571428571429
293330,2015,72,2,29,103,71.84466019417476
293330,2016,96,5,28,129,78.29457364341084
293330,2017,101,2,16,119,86.5546218487395
293330,2018,98,0,10,108,90.74074074074075
293330,2019,89,2,32,123,73.98373983739837
293330,2020,141,0,9,150,94.0
293340,2012,3,0,0,3,100.0
293340,2014,0,0,5,5,0.0
293340,2015,0,0,4,4,0.0
293340,2016,0,0,2,2,0.0
293340,2017,3,0,2,5,60.0
293340,2018,2,0,1,3,66.66666666666666
293340,2019,3,0,1,4,75.0
293340,2020,0,0,2,2,0.0
293345,2012,3,0,0,3,100.0
293345,2013,2,0,1,3,66.66666666666666
293345,2014,3,0,0,3,100.0
293345,2015,3,0,0,3,100.0
293345,2016,4,0,0,4,100.0
293345,2017,4,0,0,4,100.0
293345,2018,6,0,0,6,100.0
293345,2020,1,0,2,3,33.33333333333333
293350,2012,6,0,1,7,85.71428571428571
293350,2013,4,0,2,6,66.66666666666666
293350,2014,6,0,1,7,85.71428571428571
293350,2015,1,0,2,3,33.33333333333333
293350,2016,12,0,0,12,100.0
293350,2017,7,0,0,7,100.0
293350,2018,6,0,0,6,100.0
293350,2019,12,0,0,12,100.0
293350,2020,7,0,1,8,87.5
293360,2012,0,0,9,9,0.0
293360,2013,2,0,13,15,13.333333333333334
293360,2014,0,0,13,13,0.0
293360,2015,0,0,20,20,0.0
293360,2016,0,0,12,12,0.0
293360,2017,13,0,0,13,100.0
293360,2018,15,0,1,16,93.75
293360,2019,15,0,0,15,100.0
293360,2020,12,0,0,12,100.0
310000,2012,2,18,4,24,83.33333333333334
310000,2013,1,16,4,21,80.95238095238095
310000,2014,0,8,2,10,80.0
310000,2015,1,7,1,9,88.88888888888889
310000,2016,2,8,3,13,76.92307692307693
310000,2017,0,7,0,7,100.0
310000,2018,5,3,2,10,80.0
310000,2019,2,4,0,6,100.0
310000,2020,4,2,1,7,85.71428571428571
310010,2012,1,0,0,1,100.0
310010,2013,1,0,0,1,100.0
310010,2014,3,0,0,3,100.0
310010,2015,2,0,0,2,100.0
310010,2016,5,0,0,5,100.0
310010,2017,4,0,0,4,100.0
310010,2018,1,0,0,1,100.0
310020,2012,5,0,0,5,100.0
310020,2013,10,0,0,10,100.0
310020,2014,7,0,0,7,100.0
310020,2015,8,0,0,8,100.0
310020,2016,14,0,0,14,100.0
310020,2017,7,0,0,7,100.0
310020,2018,7,0,0,7,100.0
310020,2019,6,0,0,6,100.0
310020,2020,7,0,0,7,100.0
310030,2012,2,0,0,2,100.0
310030,2013,2,0,0,2,100.0
310030,2014,4,0,0,4,100.0
310030,2015,3,0,0,3,100.0
310030,2016,6,0,0,6,100.0
310030,2017,6,0,0,6,100.0
310030,2018,4,0,0,4,100.0
310030,2019,2,0,0,2,100.0
310030,2020,3,0,0,3,100.0
310040,2012,2,0,0,2,100.0
310040,2013,1,0,1,2,50.0
310040,2014,3,0,0,3,100.0
310040,2015,1,0,0,1,100.0
310040,2016,2,0,0,2,100.0
310040,2017,3,0,0,3,100.0
310040,2018,2,0,0,2,100.0
310040,2019,1,0,0,1,100.0
310040,2020,0,1,0,1,100.0
310050,2012,7,0,0,7,100.0
310050,2013,7,0,0,7,100.0
310050,2014,2,0,0,2,100.0
310050,2015,4,0,0,4,100.0
310050,2016,4,0,0,4,100.0
310050,2018,2,0,0,2,100.0
310050,2019,3,0,1,4,75.0
310050,2020,1,0,0,1,100.0
310060,2012,1,0,1,2,50.0
310060,2013,1,0,0,1,100.0
310060,2014,1,1,3,5,40.0
310060,2015,4,0,2,6,66.66666666666666
310060,2016,2,0,0,2,100.0
310060,2017,4,0,0,4,100.0
310060,2018,3,0,0,3,100.0
310060,2019,6,0,0,6,100.0
310060,2020,3,0,0,3,100.0
310070,2015,1,0,0,1,100.0
310080,2013,1,0,0,1,100.0
310080,2014,2,0,0,2,100.0
310080,2017,3,0,0,3,100.0
310080,2018,3,0,0,3,100.0
310080,2019,1,0,0,1,100.0
310090,2012,8,0,0,8,100.0
310090,2013,5,0,0,5,100.0
310090,2014,13,0,0,13,100.0
310090,2015,7,0,0,7,100.0
310090,2016,9,0,0,9,100.0
310090,2017,12,0,0,12,100.0
310090,2018,5,0,0,5,100.0
310090,2019,9,0,0,9,100.0
310090,2020,9,0,0,9,100.0
310100,2012,1,0,1,2,50.0
310100,2013,2,0,1,3,66.66666666666666
310100,2014,2,0,0,2,100.0
310100,2015,7,0,0,7,100.0
310100,2016,5,0,0,5,100.0
310100,2017,1,0,0,1,100.0
310100,2018,6,0,0,6,100.0
310100,2019,6,0,2,8,75.0
310100,2020,2,0,0,2,100.0
310110,2012,9,0,0,9,100.0
310110,2013,4,0,0,4,100.0
310110,2014,5,0,0,5,100.0
310110,2015,7,0,0,7,100.0
310110,2016,5,0,0,5,100.0
310110,2017,15,0,0,15,100.0
310110,2018,6,0,0,6,100.0
310110,2019,4,0,0,4,100.0
310110,2020,6,0,0,6,100.0
310120,2012,2,0,0,2,100.0
310120,2013,1,0,1,2,50.0
310120,2014,1,0,0,1,100.0
310120,2015,4,0,0,4,100.0
310120,2016,1,0,0,1,100.0
310120,2017,2,0,0,2,100.0
310120,2019,1,0,0,1,100.0
310120,2020,2,0,0,2,100.0
310130,2012,0,0,2,2,0.0
310130,2013,2,0,0,2,100.0
310130,2014,1,0,0,1,100.0
310130,2016,1,0,0,1,100.0
310140,2012,1,0,0,1,100.0
310140,2014,1,0,0,1,100.0
310140,2017,1,0,0,1,100.0
310140,2019,1,0,0,1,100.0
310140,2020,3,0,0,3,100.0
310150,2012,16,0,0,16,100.0
310150,2013,12,0,0,12,100.0
310150,2014,17,0,0,17,100.0
310150,2015,13,0,0,13,100.0
310150,2016,14,0,0,14,100.0
310150,2017,16,0,0,16,100.0
310150,2018,15,0,0,15,100.0
310150,2019,14,1,0,15,100.0
310150,2020,17,0,0,17,100.0
310160,2012,34,0,4,38,89.47368421052632
310160,2013,26,0,0,26,100.0
310160,2014,29,0,0,29,100.0
310160,2015,22,0,0,22,100.0
310160,2016,25,0,0,25,100.0
310160,2017,28,0,0,28,100.0
310160,2018,36,0,0,36,100.0
310160,2019,23,0,0,23,100.0
310160,2020,35,0,0,35,100.0
310163,2012,2,0,0,2,100.0
310163,2013,1,0,0,1,100.0
310163,2014,1,0,1,2,50.0
310163,2015,5,0,0,5,100.0
310163,2016,2,0,0,2,100.0
310163,2017,3,0,0,3,100.0
310163,2019,3,0,0,3,100.0
310163,2020,1,0,0,1,100.0
310170,2012,19,0,1,20,95.0
310170,2013,6,0,0,6,100.0
310170,2014,22,0,0,22,100.0
310170,2015,14,0,0,14,100.0
310170,2016,19,0,0,19,100.0
310170,2017,17,0,0,17,100.0
310170,2018,14,0,0,14,100.0
310170,2019,12,0,1,13,92.3076923076923
310170,2020,17,0,0,17,100.0
310180,2012,3,0,0,3,100.0
310180,2013,1,0,0,1,100.0
310180,2014,2,0,0,2,100.0
310180,2015,3,0,0,3,100.0
310180,2016,2,0,0,2,100.0
310180,2017,1,0,0,1,100.0
310180,2018,4,0,0,4,100.0
310180,2019,4,0,0,4,100.0
310180,2020,5,0,0,5,100.0
310190,2012,6,0,0,6,100.0
310190,2013,7,0,0,7,100.0
310190,2014,9,0,0,9,100.0
310190,2015,7,0,0,7,100.0
310190,2016,7,0,0,7,100.0
310190,2017,7,0,0,7,100.0
310190,2018,4,0,0,4,100.0
310190,2019,2,0,0,2,100.0
310190,2020,4,0,0,4,100.0
310200,2012,9,0,0,9,100.0
310200,2013,5,0,0,5,100.0
310200,2014,2,0,0,2,100.0
310200,2015,2,0,0,2,100.0
310200,2016,3,0,0,3,100.0
310200,2017,5,1,0,6,100.0
310200,2018,4,0,1,5,80.0
310200,2019,5,0,0,5,100.0
310200,2020,3,1,0,4,100.0
310205,2012,4,0,0,4,100.0
310205,2013,1,0,0,1,100.0
310205,2014,1,0,0,1,100.0
310205,2015,2,0,0,2,100.0
310205,2016,2,0,0,2,100.0
310205,2018,1,0,0,1,100.0
310205,2020,2,0,1,3,66.66666666666666
310210,2012,5,0,0,5,100.0
310210,2013,5,0,0,5,100.0
310210,2014,4,0,0,4,100.0
310210,2015,3,1,5,9,44.44444444444444
310210,2016,3,0,1,4,75.0
310210,2017,4,0,0,4,100.0
310210,2019,6,0,0,6,100.0
310210,2020,3,0,0,3,100.0
310220,2012,1,0,0,1,100.0
310220,2014,5,0,0,5,100.0
310220,2015,1,0,0,1,100.0
310220,2016,1,0,0,1,100.0
310220,2017,1,0,0,1,100.0
310220,2018,1,0,0,1,100.0
310220,2019,1,0,0,1,100.0
310220,2020,1,0,0,1,100.0
310230,2012,7,0,0,7,100.0
310230,2013,5,0,0,5,100.0
310230,2014,7,0,1,8,87.5
310230,2015,6,0,0,6,100.0
310230,2016,5,0,0,5,100.0
310230,2017,4,0,0,4,100.0
310230,2018,5,0,0,5,100.0
310230,2019,8,0,0,8,100.0
310230,2020,5,0,0,5,100.0
310240,2012,1,0,0,1,100.0
310240,2013,1,0,0,1,100.0
310240,2014,2,0,0,2,100.0
310240,2015,1,0,0,1,100.0
310240,2016,2,0,0,2,100.0
310240,2017,1,0,0,1,100.0
310240,2018,1,0,0,1,100.0
310240,2019,2,0,0,2,100.0
310240,2020,2,0,0,2,100.0
310250,2012,2,0,0,2,100.0
310250,2013,1,0,0,1,100.0
310250,2014,1,0,0,1,100.0
310250,2015,3,0,0,3,100.0
310250,2016,2,0,0,2,100.0
310250,2017,1,0,0,1,100.0
310250,2018,2,0,0,2,100.0
310250,2019,2,0,0,2,100.0
310260,2012,18,0,0,18,100.0
310260,2013,13,0,0,13,100.0
310260,2014,14,0,0,14,100.0
310260,2015,6,0,0,6,100.0
310260,2016,12,0,0,12,100.0
310260,2017,12,0,0,12,100.0
310260,2018,12,0,0,12,100.0
310260,2019,9,0,0,9,100.0
310260,2020,17,0,0,17,100.0
310270,2012,3,0,0,3,100.0
310270,2013,2,0,0,2,100.0
310270,2014,5,0,0,5,100.0
310270,2015,1,0,0,1,100.0
310270,2016,7,0,0,7,100.0
310270,2017,4,0,0,4,100.0
310270,2019,5,0,0,5,100.0
310270,2020,1,0,1,2,50.0
310280,2012,1,0,0,1,100.0
310280,2013,6,0,0,6,100.0
310280,2014,6,0,0,6,100.0
310280,2015,1,0,0,1,100.0
310280,2016,3,0,0,3,100.0
310280,2017,1,0,0,1,100.0
310280,2018,6,0,0,6,100.0
310280,2019,2,0,0,2,100.0
310280,2020,5,0,0,5,100.0
310285,2012,3,0,0,3,100.0
310285,2013,3,0,1,4,75.0
310285,2014,3,0,1,4,75.0
310285,2015,3,0,0,3,100.0
310285,2016,5,0,0,5,100.0
310285,2017,4,0,0,4,100.0
310285,2018,3,0,0,3,100.0
310285,2019,4,0,0,4,100.0
310285,2020,0,0,2,2,0.0
310290,2012,3,0,0,3,100.0
310290,2013,7,0,0,7,100.0
310290,2014,6,0,0,6,100.0
310290,2015,4,0,0,4,100.0
310290,2016,6,0,0,6,100.0
310290,2017,4,0,0,4,100.0
310290,2018,10,0,0,10,100.0
310290,2019,2,0,0,2,100.0
310290,2020,6,0,0,6,100.0
310300,2012,8,0,0,8,100.0
310300,2013,3,0,0,3,100.0
310300,2014,6,0,0,6,100.0
310300,2015,7,0,0,7,100.0
310300,2016,2,0,0,2,100.0
310300,2017,4,0,0,4,100.0
310300,2018,6,0,0,6,100.0
310300,2019,7,0,0,7,100.0
310300,2020,2,0,0,2,100.0
310310,2012,1,0,0,1,100.0
310310,2013,1,0,0,1,100.0
310310,2015,1,0,0,1,100.0
310310,2018,2,0,0,2,100.0
310310,2019,2,0,1,3,66.66666666666666
310310,2020,1,0,0,1,100.0
310320,2013,2,0,0,2,100.0
310320,2014,1,0,0,1,100.0
310320,2015,1,0,1,2,50.0
310320,2018,1,0,0,1,100.0
310330,2012,1,0,0,1,100.0
310330,2013,2,0,1,3,66.66666666666666
310330,2018,0,1,1,2,50.0
310330,2019,1,0,1,2,50.0
310340,2012,6,0,4,10,60.0
310340,2013,18,0,1,19,94.73684210526315
310340,2014,18,0,0,18,100.0
310340,2015,5,0,4,9,55.55555555555556
310340,2016,12,0,0,12,100.0
310340,2017,16,0,0,16,100.0
310340,2018,11,1,1,13,92.3076923076923
310340,2019,9,0,2,11,81.81818181818183
310340,2020,18,0,1,19,94.73684210526315
310350,2012,42,0,0,42,100.0
310350,2013,34,0,0,34,100.0
310350,2014,42,0,0,42,100.0
310350,2015,37,0,1,38,97.36842105263158
310350,2016,33,0,0,33,100.0
310350,2017,33,1,0,34,100.0
310350,2018,29,0,0,29,100.0
310350,2019,35,0,1,36,97.22222222222221
310350,2020,34,0,0,34,100.0
310360,2012,0,1,0,1,100.0
310360,2013,0,0,2,2,0.0
310360,2015,0,0,1,1,0.0
310360,2016,0,0,2,2,0.0
310360,2018,0,0,2,2,0.0
310360,2019,0,0,3,3,0.0
310360,2020,0,0,1,1,0.0
310370,2012,2,0,0,2,100.0
310370,2013,6,0,0,6,100.0
310370,2014,1,0,0,1,100.0
310370,2015,3,0,0,3,100.0
310370,2016,3,0,0,3,100.0
310370,2017,2,0,0,2,100.0
310370,2018,3,0,0,3,100.0
310370,2019,2,0,0,2,100.0
310370,2020,2,0,0,2,100.0
310375,2012,3,0,0,3,100.0
310375,2013,1,0,0,1,100.0
310375,2014,4,0,0,4,100.0
310375,2015,2,0,0,2,100.0
310375,2016,3,1,0,4,100.0
310375,2017,3,0,0,3,100.0
310375,2019,1,0,0,1,100.0
310375,2020,4,0,0,4,100.0
310380,2013,1,0,0,1,100.0
310380,2015,1,0,0,1,100.0
310380,2017,1,0,0,1,100.0
310390,2012,4,0,0,4,100.0
310390,2013,2,0,2,4,50.0
310390,2014,1,0,0,1,100.0
310390,2016,0,0,1,1,0.0
310390,2017,3,0,0,3,100.0
310390,2018,2,0,0,2,100.0
310390,2019,3,0,0,3,100.0
310400,2012,40,0,0,40,100.0
310400,2013,42,0,0,42,100.0
310400,2014,39,0,0,39,100.0
310400,2015,25,0,0,25,100.0
310400,2016,31,0,0,31,100.0
310400,2017,44,0,0,44,100.0
310400,2018,30,0,0,30,100.0
310400,2019,47,0,0,47,100.0
310400,2020,28,0,2,30,93.33333333333333
310410,2012,3,0,1,4,75.0
310410,2013,2,0,0,2,100.0
310410,2014,5,0,0,5,100.0
310410,2015,1,0,0,1,100.0
310410,2018,5,0,0,5,100.0
310410,2019,2,0,0,2,100.0
310410,2020,2,0,0,2,100.0
310420,2012,11,0,0,11,100.0
310420,2013,11,0,0,11,100.0
310420,2014,5,0,0,5,100.0
310420,2015,16,0,0,16,100.0
310420,2016,23,0,0,23,100.0
310420,2017,7,0,0,7,100.0
310420,2018,13,0,0,13,100.0
310420,2019,16,0,0,16,100.0
310420,2020,6,0,0,6,100.0
310430,2012,8,0,0,8,100.0
310430,2013,8,0,0,8,100.0
310430,2014,2,0,0,2,100.0
310430,2015,2,0,0,2,100.0
310430,2016,6,0,0,6,100.0
310430,2017,1,0,0,1,100.0
310430,2018,4,0,0,4,100.0
310430,2019,5,0,0,5,100.0
310430,2020,3,0,1,4,75.0
310440,2013,4,0,0,4,100.0
310440,2014,1,1,0,2,100.0
310440,2015,2,0,0,2,100.0
310440,2016,2,0,0,2,100.0
310440,2019,3,0,0,3,100.0
310440,2020,1,0,0,1,100.0
310445,2013,5,0,0,5,100.0
310445,2015,1,0,0,1,100.0
310445,2016,3,0,0,3,100.0
310445,2017,1,0,0,1,100.0
310445,2018,0,0,3,3,0.0
310445,2019,1,0,0,1,100.0
310445,2020,3,0,0,3,100.0
310450,2012,3,0,0,3,100.0
310450,2013,5,0,0,5,100.0
310450,2014,8,0,0,8,100.0
310450,2015,8,0,0,8,100.0
310450,2016,2,0,0,2,100.0
310450,2017,6,0,0,6,100.0
310450,2018,7,0,0,7,100.0
310450,2019,6,0,0,6,100.0
310450,2020,2,0,0,2,100.0
310460,2012,5,0,0,5,100.0
310460,2013,7,0,0,7,100.0
310460,2014,7,0,0,7,100.0
310460,2015,1,1,0,2,100.0
310460,2016,3,0,0,3,100.0
310460,2017,3,0,0,3,100.0
310460,2018,5,0,0,5,100.0
310460,2019,4,0,0,4,100.0
310460,2020,5,0,0,5,100.0
310470,2012,6,0,0,6,100.0
310470,2013,4,0,0,4,100.0
310470,2014,7,0,0,7,100.0
310470,2015,5,0,0,5,100.0
310470,2016,6,0,0,6,100.0
310470,2017,0,0,2,2,0.0
310470,2018,1,0,0,1,100.0
310470,2019,1,0,1,2,50.0
310470,2020,0,1,4,5,20.0
310480,2013,2,0,0,2,100.0
310480,2014,3,0,0,3,100.0
310480,2015,2,0,0,2,100.0
310480,2016,1,0,0,1,100.0
310480,2017,4,0,0,4,100.0
310480,2018,2,0,0,2,100.0
310480,2019,1,0,0,1,100.0
310480,2020,4,0,0,4,100.0
310490,2012,2,0,0,2,100.0
310490,2013,6,0,0,6,100.0
310490,2014,6,0,0,6,100.0
310490,2015,3,0,0,3,100.0
310490,2016,4,0,0,4,100.0
310490,2017,9,0,0,9,100.0
310490,2018,5,0,0,5,100.0
310490,2019,12,0,0,12,100.0
310490,2020,5,0,0,5,100.0
310500,2012,4,0,0,4,100.0
310500,2013,5,0,0,5,100.0
310500,2014,2,0,0,2,100.0
310500,2015,1,0,0,1,100.0
310500,2016,5,0,0,5,100.0
310500,2017,2,0,0,2,100.0
310500,2018,4,0,0,4,100.0
310500,2019,4,0,0,4,100.0
310500,2020,2,0,0,2,100.0
310510,2012,10,0,0,10,100.0
310510,2013,12,0,0,12,100.0
310510,2014,15,0,0,15,100.0
310510,2015,3,0,0,3,100.0
310510,2016,7,0,0,7,100.0
310510,2017,7,0,0,7,100.0
310510,2018,5,0,0,5,100.0
310510,2019,7,0,0,7,100.0
310510,2020,5,0,0,5,100.0
310520,2014,2,0,0,2,100.0
310520,2015,3,0,0,3,100.0
310520,2016,1,0,0,1,100.0
310520,2017,2,0,0,2,100.0
310520,2018,2,0,1,3,66.66666666666666
310520,2019,1,0,0,1,100.0
310520,2020,0,0,1,1,0.0
310530,2012,4,0,0,4,100.0
310530,2013,1,0,0,1,100.0
310530,2014,3,0,0,3,100.0
310530,2015,4,0,0,4,100.0
310530,2016,3,0,0,3,100.0
310530,2017,2,0,0,2,100.0
310530,2018,1,0,0,1,100.0
310530,2019,1,0,0,1,100.0
310530,2020,1,0,0,1,100.0
310540,2012,0,0,9,9,0.0
310540,2013,6,0,0,6,100.0
310540,2014,8,0,0,8,100.0
310540,2015,10,0,0,10,100.0
310540,2016,9,0,0,9,100.0
310540,2017,8,0,0,8,100.0
310540,2018,2,0,4,6,33.33333333333333
310540,2019,0,0,13,13,0.0
310540,2020,0,6,3,9,66.66666666666666
310550,2012,2,0,1,3,66.66666666666666
310550,2013,1,0,0,1,100.0
310550,2015,4,0,0,4,100.0
310550,2017,2,0,0,2,100.0
310550,2018,3,0,0,3,100.0
310550,2020,1,0,0,1,100.0
310560,2012,55,2,0,57,100.0
310560,2013,42,2,3,47,93.61702127659575
310560,2014,48,0,3,51,94.11764705882352
310560,2015,37,0,1,38,97.36842105263158
310560,2016,40,1,0,41,100.0
310560,2017,48,0,2,50,96.0
310560,2018,35,0,0,35,100.0
310560,2019,41,0,0,41,100.0
310560,2020,47,0,0,47,100.0
310570,2012,1,0,0,1,100.0
310570,2013,2,0,0,2,100.0
310570,2014,1,0,0,1,100.0
310570,2015,1,0,0,1,100.0
310570,2016,2,0,0,2,100.0
310570,2017,1,0,0,1,100.0
310570,2018,2,0,0,2,100.0
310570,2019,2,0,0,2,100.0
310570,2020,1,0,0,1,100.0
310590,2012,11,0,0,11,100.0
310590,2013,13,0,0,13,100.0
310590,2014,9,0,0,9,100.0
310590,2015,12,0,0,12,100.0
310590,2016,10,0,0,10,100.0
310590,2017,9,0,0,9,100.0
310590,2018,7,0,0,7,100.0
310590,2019,12,0,1,13,92.3076923076923
310590,2020,9,0,0,9,100.0
310600,2012,2,0,0,2,100.0
310600,2013,7,0,0,7,100.0
310600,2014,8,0,0,8,100.0
310600,2015,5,0,0,5,100.0
310600,2016,4,0,0,4,100.0
310600,2017,4,0,0,4,100.0
310600,2018,4,0,0,4,100.0
310600,2019,2,0,0,2,100.0
310600,2020,4,0,0,4,100.0
310610,2013,2,0,0,2,100.0
310610,2015,0,0,1,1,0.0
310610,2016,0,0,1,1,0.0
310610,2017,2,0,0,2,100.0
310610,2018,1,0,0,1,100.0
310620,2012,695,70,58,823,92.95261239368166
310620,2013,758,8,9,775,98.83870967741936
310620,2014,706,2,2,710,99.71830985915493
310620,2015,568,36,34,638,94.67084639498434
310620,2016,598,22,27,647,95.82689335394127
310620,2017,608,14,5,627,99.20255183413079
310620,2018,625,0,0,625,100.0
310620,2019,684,0,0,684,100.0
310620,2020,773,0,0,773,100.0
310630,2012,10,0,0,10,100.0
310630,2013,11,0,0,11,100.0
310630,2014,11,0,0,11,100.0
310630,2015,13,0,0,13,100.0
310630,2016,5,0,0,5,100.0
310630,2017,9,0,0,9,100.0
310630,2018,14,0,0,14,100.0
310630,2019,6,0,0,6,100.0
310630,2020,14,0,0,14,100.0
310640,2012,2,0,0,2,100.0
310640,2013,3,0,0,3,100.0
310640,2014,4,0,0,4,100.0
310640,2015,4,0,0,4,100.0
310640,2016,3,0,0,3,100.0
310640,2019,2,0,0,2,100.0
310640,2020,3,0,0,3,100.0
310650,2012,0,0,2,2,0.0
310650,2013,2,0,0,2,100.0
310650,2014,1,0,0,1,100.0
310650,2015,4,0,0,4,100.0
310650,2016,2,0,0,2,100.0
310650,2017,3,0,0,3,100.0
310650,2018,4,0,0,4,100.0
310650,2019,6,0,0,6,100.0
310650,2020,1,0,0,1,100.0
310660,2012,4,0,0,4,100.0
310660,2013,2,0,0,2,100.0
310660,2014,1,0,0,1,100.0
310660,2015,3,0,1,4,75.0
310660,2016,3,0,0,3,100.0
310660,2018,1,0,0,1,100.0
310660,2019,2,0,0,2,100.0
310660,2020,1,0,0,1,100.0
310665,2013,2,0,0,2,100.0
310665,2014,1,0,0,1,100.0
310665,2015,3,0,0,3,100.0
310665,2017,1,0,0,1,100.0
310665,2020,2,0,0,2,100.0
310670,2012,68,14,56,138,59.42028985507246
310670,2013,87,8,41,136,69.85294117647058
310670,2014,93,5,43,141,69.50354609929079
310670,2015,129,5,41,175,76.57142857142857
310670,2016,127,1,12,140,91.42857142857143
310670,2017,125,2,11,138,92.02898550724638
310670,2018,102,1,12,115,89.56521739130436
310670,2019,136,0,8,144,94.44444444444444
310670,2020,136,0,1,137,99.27007299270073
310680,2012,2,0,0,2,100.0
310680,2013,2,0,0,2,100.0
310680,2014,0,0,1,1,0.0
310680,2015,3,0,0,3,100.0
310680,2018,1,0,0,1,100.0
310680,2019,1,0,0,1,100.0
310690,2012,4,0,0,4,100.0
310690,2013,7,0,0,7,100.0
310690,2014,4,0,1,5,80.0
310690,2015,4,0,0,4,100.0
310690,2016,5,0,0,5,100.0
310690,2017,7,0,0,7,100.0
310690,2018,5,0,0,5,100.0
310690,2019,3,0,0,3,100.0
310690,2020,5,0,0,5,100.0
310700,2012,1,0,0,1,100.0
310700,2013,1,0,0,1,100.0
310700,2014,1,0,0,1,100.0
310700,2018,1,0,0,1,100.0
310710,2012,18,0,0,18,100.0
310710,2013,11,0,0,11,100.0
310710,2014,14,0,0,14,100.0
310710,2015,19,0,0,19,100.0
310710,2016,16,0,1,17,94.11764705882352
310710,2017,12,0,0,12,100.0
310710,2018,16,0,0,16,100.0
310710,2019,10,0,0,10,100.0
310710,2020,14,0,0,14,100.0
310720,2012,0,1,0,1,100.0
310720,2014,0,0,1,1,0.0
310720,2015,0,0,3,3,0.0
310720,2016,0,0,1,1,0.0
310720,2018,0,0,1,1,0.0
310720,2019,0,0,1,1,0.0
310730,2012,14,0,0,14,100.0
310730,2013,20,0,0,20,100.0
310730,2014,21,0,1,22,95.45454545454545
310730,2015,28,0,0,28,100.0
310730,2016,23,0,0,23,100.0
310730,2017,18,0,0,18,100.0
310730,2018,12,0,0,12,100.0
310730,2019,19,0,0,19,100.0
310730,2020,21,0,0,21,100.0
310740,2012,15,0,0,15,100.0
310740,2013,14,0,0,14,100.0
310740,2014,17,0,0,17,100.0
310740,2015,17,0,0,17,100.0
310740,2016,14,0,0,14,100.0
310740,2017,18,0,0,18,100.0
310740,2018,13,0,0,13,100.0
310740,2019,6,1,0,7,100.0
310740,2020,12,0,0,12,100.0
310750,2012,2,0,0,2,100.0
310750,2013,2,0,0,2,100.0
310750,2014,1,0,0,1,100.0
310750,2015,3,0,0,3,100.0
310750,2016,1,0,4,5,20.0
310750,2017,5,0,0,5,100.0
310750,2018,3,0,0,3,100.0
310750,2020,0,0,3,3,0.0
310760,2012,1,0,0,1,100.0
310760,2013,2,0,0,2,100.0
310760,2014,1,0,0,1,100.0
310760,2016,1,0,0,1,100.0
310760,2018,1,0,0,1,100.0
310760,2019,1,0,0,1,100.0
310760,2020,1,0,0,1,100.0
310770,2014,2,0,0,2,100.0
310770,2015,2,0,0,2,100.0
310770,2016,5,0,0,5,100.0
310770,2017,1,0,0,1,100.0
310770,2018,2,0,0,2,100.0
310770,2019,3,0,0,3,100.0
310770,2020,2,0,0,2,100.0
310780,2012,10,0,0,10,100.0
310780,2013,5,0,0,5,100.0
310780,2014,7,0,0,7,100.0
310780,2015,2,0,0,2,100.0
310780,2016,5,0,0,5,100.0
310780,2017,4,0,0,4,100.0
310780,2018,5,0,0,5,100.0
310780,2019,4,0,0,4,100.0
310780,2020,6,0,0,6,100.0
310790,2012,3,0,0,3,100.0
310790,2013,6,0,0,6,100.0
310790,2014,2,0,0,2,100.0
310790,2015,1,0,0,1,100.0
310790,2017,6,0,0,6,100.0
310790,2018,3,0,0,3,100.0
310790,2019,3,0,0,3,100.0
310790,2020,4,0,0,4,100.0
310800,2012,6,0,0,6,100.0
310800,2013,10,0,0,10,100.0
310800,2014,7,0,0,7,100.0
310800,2015,5,0,0,5,100.0
310800,2016,8,0,0,8,100.0
310800,2017,11,0,0,11,100.0
310800,2018,2,0,0,2,100.0
310800,2019,9,0,0,9,100.0
310800,2020,6,0,0,6,100.0
310810,2012,2,0,0,2,100.0
310810,2013,2,0,1,3,66.66666666666666
310810,2015,0,0,2,2,0.0
310810,2016,2,0,2,4,50.0
310810,2017,0,0,1,1,0.0
310810,2018,0,0,2,2,0.0
310810,2019,4,0,0,4,100.0
310810,2020,2,0,0,2,100.0
310820,2013,4,0,0,4,100.0
310820,2015,5,0,0,5,100.0
310820,2016,3,0,0,3,100.0
310820,2018,4,0,0,4,100.0
310820,2019,2,0,0,2,100.0
310820,2020,1,0,0,1,100.0
310825,2012,1,0,0,1,100.0
310825,2013,2,0,0,2,100.0
310825,2014,1,0,0,1,100.0
310825,2016,2,0,0,2,100.0
310825,2017,4,0,0,4,100.0
310825,2018,2,0,0,2,100.0
310825,2019,2,0,0,2,100.0
310830,2012,6,0,0,6,100.0
310830,2013,6,0,0,6,100.0
310830,2014,6,0,0,6,100.0
310830,2015,3,0,0,3,100.0
310830,2016,5,0,0,5,100.0
310830,2017,4,0,0,4,100.0
310830,2018,6,0,0,6,100.0
310830,2019,2,0,0,2,100.0
310830,2020,7,0,0,7,100.0
310840,2012,8,0,0,8,100.0
310840,2013,4,0,0,4,100.0
310840,2015,5,0,0,5,100.0
310840,2016,2,0,0,2,100.0
310840,2017,4,0,0,4,100.0
310840,2019,1,0,0,1,100.0
310840,2020,6,0,0,6,100.0
310850,2013,3,0,0,3,100.0
310850,2014,2,0,0,2,100.0
310850,2015,2,0,0,2,100.0
310850,2016,2,0,0,2,100.0
310850,2017,3,0,0,3,100.0
310850,2018,1,0,0,1,100.0
310850,2019,3,0,0,3,100.0
310850,2020,3,0,0,3,100.0
310855,2012,1,1,3,5,40.0
310855,2013,4,0,0,4,100.0
310855,2014,8,0,0,8,100.0
310855,2015,5,0,0,5,100.0
310855,2016,4,0,0,4,100.0
310855,2017,7,0,0,7,100.0
310855,2018,6,0,0,6,100.0
310855,2019,6,0,0,6,100.0
310855,2020,6,0,1,7,85.71428571428571
310860,2012,15,0,2,17,88.23529411764706
310860,2013,9,0,0,9,100.0
310860,2014,9,0,1,10,90.0
310860,2015,10,0,0,10,100.0
310860,2016,9,0,0,9,100.0
310860,2017,5,0,0,5,100.0
310860,2018,8,0,0,8,100.0
310860,2019,12,0,0,12,100.0
310860,2020,16,0,0,16,100.0
310870,2012,1,1,0,2,100.0
310870,2013,1,0,0,1,100.0
310870,2014,3,0,0,3,100.0
310870,2016,1,0,0,1,100.0
310870,2017,1,0,0,1,100.0
310870,2018,1,0,0,1,100.0
310870,2020,0,0,2,2,0.0
310880,2014,1,0,0,1,100.0
310880,2015,2,0,0,2,100.0
310880,2016,2,0,0,2,100.0
310880,2017,1,0,0,1,100.0
310880,2018,2,0,0,2,100.0
310880,2019,2,0,0,2,100.0
310880,2020,1,0,0,1,100.0
310890,2012,3,0,0,3,100.0
310890,2014,8,0,0,8,100.0
310890,2015,2,0,0,2,100.0
310890,2016,4,0,0,4,100.0
310890,2017,4,0,0,4,100.0
310890,2018,2,0,0,2,100.0
310890,2019,3,0,0,3,100.0
310890,2020,5,0,0,5,100.0
310900,2012,13,0,0,13,100.0
310900,2013,11,0,0,11,100.0
310900,2014,14,0,0,14,100.0
310900,2015,11,0,0,11,100.0
310900,2016,8,0,0,8,100.0
310900,2017,9,0,0,9,100.0
310900,2018,12,0,0,12,100.0
310900,2019,42,0,0,42,100.0
310900,2020,11,0,0,11,100.0
310910,2013,3,0,1,4,75.0
310910,2015,2,0,0,2,100.0
310910,2016,1,0,0,1,100.0
310910,2017,2,0,0,2,100.0
310910,2018,3,0,0,3,100.0
310910,2019,6,0,0,6,100.0
310910,2020,3,0,0,3,100.0
310920,2012,4,0,0,4,100.0
310920,2013,6,0,0,6,100.0
310920,2014,4,0,0,4,100.0
310920,2015,2,0,0,2,100.0
310920,2016,9,0,0,9,100.0
310920,2017,4,0,0,4,100.0
310920,2018,1,0,0,1,100.0
310920,2019,2,0,0,2,100.0
310920,2020,1,0,0,1,100.0
310925,2013,1,0,0,1,100.0
310925,2014,2,0,0,2,100.0
310925,2015,2,1,0,3,100.0
310925,2016,1,0,0,1,100.0
310925,2017,2,0,0,2,100.0
310925,2018,1,0,0,1,100.0
310925,2020,1,0,0,1,100.0
310930,2012,9,0,0,9,100.0
310930,2013,5,0,0,5,100.0
310930,2014,8,0,0,8,100.0
310930,2015,14,0,0,14,100.0
310930,2016,5,0,0,5,100.0
310930,2017,5,0,0,5,100.0
310930,2018,10,0,0,10,100.0
310930,2019,10,0,0,10,100.0
310930,2020,6,0,0,6,100.0
310940,2012,3,0,17,20,15.0
310940,2013,8,0,7,15,53.333333333333336
310940,2014,0,0,8,8,0.0
310940,2015,9,0,2,11,81.81818181818183
310940,2016,14,0,0,14,100.0
310940,2017,15,0,0,15,100.0
310940,2018,11,0,0,11,100.0
310940,2019,7,0,0,7,100.0
310940,2020,11,0,0,11,100.0
310945,2012,2,0,0,2,100.0
310945,2013,1,0,0,1,100.0
310945,2014,3,0,0,3,100.0
310945,2015,2,0,0,2,100.0
310945,2016,2,0,0,2,100.0
310945,2017,3,0,0,3,100.0
310945,2018,2,0,0,2,100.0
310945,2020,4,0,0,4,100.0
310950,2012,4,0,0,4,100.0
310950,2013,6,0,0,6,100.0
310950,2014,0,0,2,2,0.0
310950,2015,2,0,0,2,100.0
310950,2016,7,0,0,7,100.0
310950,2017,5,0,0,5,100.0
310950,2018,2,0,0,2,100.0
310950,2019,4,0,0,4,100.0
310950,2020,8,0,0,8,100.0
310960,2012,2,0,0,2,100.0
310960,2014,2,0,0,2,100.0
310960,2015,1,0,0,1,100.0
310960,2016,2,0,0,2,100.0
310960,2017,4,0,0,4,100.0
310960,2018,1,0,0,1,100.0
310960,2019,1,0,0,1,100.0
310970,2012,2,0,0,2,100.0
310970,2013,1,0,0,1,100.0
310970,2014,2,0,0,2,100.0
310970,2015,2,0,0,2,100.0
310970,2016,1,0,0,1,100.0
310970,2017,1,0,0,1,100.0
310970,2018,2,0,0,2,100.0
310970,2019,4,0,0,4,100.0
310970,2020,1,0,0,1,100.0
310980,2012,1,0,0,1,100.0
310980,2013,1,0,0,1,100.0
310980,2015,2,0,0,2,100.0
310980,2016,2,0,0,2,100.0
310980,2018,1,0,0,1,100.0
310980,2019,2,0,0,2,100.0
310980,2020,1,0,1,2,50.0
310990,2012,3,0,0,3,100.0
310990,2013,4,0,0,4,100.0
310990,2014,3,0,0,3,100.0
310990,2015,3,0,0,3,100.0
310990,2016,5,0,0,5,100.0
310990,2017,5,0,0,5,100.0
310990,2018,7,0,1,8,87.5
310990,2019,4,0,0,4,100.0
310990,2020,5,0,0,5,100.0
311000,2012,2,0,11,13,15.384615384615385
311000,2013,12,1,2,15,86.66666666666667
311000,2014,15,0,0,15,100.0
311000,2015,16,0,0,16,100.0
311000,2016,13,0,0,13,100.0
311000,2017,14,0,1,15,93.33333333333333
311000,2018,11,0,0,11,100.0
311000,2019,5,0,0,5,100.0
311000,2020,7,0,1,8,87.5
311010,2012,3,0,0,3,100.0
311010,2013,4,0,0,4,100.0
311010,2014,1,0,0,1,100.0
311010,2015,1,0,0,1,100.0
311010,2016,3,0,0,3,100.0
311010,2017,4,0,0,4,100.0
311010,2018,1,0,0,1,100.0
311010,2019,4,0,0,4,100.0
311010,2020,5,0,0,5,100.0
311020,2013,2,0,0,2,100.0
311020,2016,1,0,0,1,100.0
311020,2017,2,0,0,2,100.0
311020,2018,5,0,0,5,100.0
311020,2019,2,0,0,2,100.0
311030,2012,7,0,0,7,100.0
311030,2013,8,0,0,8,100.0
311030,2014,4,0,0,4,100.0
311030,2015,4,0,0,4,100.0
311030,2016,3,0,0,3,100.0
311030,2017,5,0,1,6,83.33333333333334
311030,2018,5,0,1,6,83.33333333333334
311030,2019,2,0,0,2,100.0
311030,2020,4,0,0,4,100.0
311040,2012,1,0,0,1,100.0
311040,2014,1,0,0,1,100.0
311040,2015,1,0,0,1,100.0
311040,2017,2,0,0,2,100.0
311040,2019,0,0,1,1,0.0
311040,2020,1,0,0,1,100.0
311050,2012,4,0,0,4,100.0
311050,2013,5,0,0,5,100.0
311050,2014,4,0,0,4,100.0
311050,2015,7,0,0,7,100.0
311050,2016,10,0,0,10,100.0
311050,2017,5,0,1,6,83.33333333333334
311050,2018,8,0,0,8,100.0
311050,2019,10,0,2,12,83.33333333333334
311050,2020,8,0,3,11,72.72727272727273
311060,2012,13,0,0,13,100.0
311060,2013,6,0,0,6,100.0
311060,2014,3,0,0,3,100.0
311060,2015,11,0,0,11,100.0
311060,2016,2,0,0,2,100.0
311060,2017,6,0,0,6,100.0
311060,2018,5,0,1,6,83.33333333333334
311060,2019,4,0,0,4,100.0
311060,2020,0,0,10,10,0.0
311070,2012,6,0,0,6,100.0
311070,2013,2,0,1,3,66.66666666666666
311070,2014,7,0,0,7,100.0
311070,2015,2,0,0,2,100.0
311070,2016,3,0,0,3,100.0
311070,2017,3,0,0,3,100.0
311070,2018,4,0,0,4,100.0
311070,2019,3,0,0,3,100.0
311070,2020,2,0,0,2,100.0
311080,2013,1,0,0,1,100.0
311080,2014,2,0,0,2,100.0
311080,2015,2,0,0,2,100.0
311080,2016,2,0,0,2,100.0
311080,2019,2,2,1,5,80.0
311080,2020,0,1,1,2,50.0
311090,2012,4,0,0,4,100.0
311090,2013,3,0,0,3,100.0
311090,2014,2,0,0,2,100.0
311090,2015,4,0,0,4,100.0
311090,2016,5,0,0,5,100.0
311090,2017,4,0,0,4,100.0
311090,2018,8,0,0,8,100.0
311090,2019,8,0,0,8,100.0
311090,2020,6,0,0,6,100.0
311100,2012,6,0,0,6,100.0
311100,2013,7,0,0,7,100.0
311100,2014,9,0,0,9,100.0
311100,2015,6,0,0,6,100.0
311100,2016,6,0,0,6,100.0
311100,2017,7,0,1,8,87.5
311100,2018,4,0,1,5,80.0
311100,2019,6,0,0,6,100.0
311100,2020,7,0,0,7,100.0
311110,2012,5,0,0,5,100.0
311110,2013,4,0,0,4,100.0
311110,2014,7,0,0,7,100.0
311110,2015,8,0,0,8,100.0
311110,2016,7,0,0,7,100.0
311110,2017,5,0,0,5,100.0
311110,2018,4,0,0,4,100.0
311110,2019,5,0,0,5,100.0
311110,2020,6,1,0,7,100.0
311115,2012,1,0,0,1,100.0
311115,2013,2,0,0,2,100.0
311115,2014,5,0,0,5,100.0
311115,2015,3,0,0,3,100.0
311115,2018,1,0,0,1,100.0
311115,2020,1,0,0,1,100.0
311120,2012,16,0,0,16,100.0
311120,2013,23,0,0,23,100.0
311120,2014,16,0,0,16,100.0
311120,2015,19,1,1,21,95.23809523809523
311120,2016,19,0,0,19,100.0
311120,2017,17,0,0,17,100.0
311120,2018,15,0,0,15,100.0
311120,2019,16,0,0,16,100.0
311120,2020,19,0,0,19,100.0
311130,2012,6,0,0,6,100.0
311130,2013,2,0,0,2,100.0
311130,2014,3,0,0,3,100.0
311130,2015,5,0,0,5,100.0
311130,2016,4,0,0,4,100.0
311130,2017,3,0,0,3,100.0
311130,2018,4,0,0,4,100.0
311130,2019,1,0,0,1,100.0
311130,2020,1,0,0,1,100.0
311140,2012,2,0,0,2,100.0
311140,2013,5,0,0,5,100.0
311140,2014,5,0,0,5,100.0
311140,2015,3,0,0,3,100.0
311140,2016,2,0,0,2,100.0
311140,2017,1,0,0,1,100.0
311140,2018,4,0,0,4,100.0
311140,2019,5,0,0,5,100.0
311140,2020,2,0,0,2,100.0
311150,2012,6,0,0,6,100.0
311150,2013,6,0,0,6,100.0
311150,2014,10,0,1,11,90.9090909090909
311150,2015,8,0,1,9,88.88888888888889
311150,2016,5,0,0,5,100.0
311150,2017,9,0,0,9,100.0
311150,2018,4,0,0,4,100.0
311150,2019,2,0,0,2,100.0
311150,2020,0,0,3,3,0.0
311160,2012,4,1,4,9,55.55555555555556
311160,2013,7,0,0,7,100.0
311160,2014,6,0,1,7,85.71428571428571
311160,2015,7,0,0,7,100.0
311160,2016,10,0,0,10,100.0
311160,2017,10,0,0,10,100.0
311160,2018,7,0,0,7,100.0
311160,2019,12,0,0,12,100.0
311160,2020,7,0,0,7,100.0
311170,2013,1,0,0,1,100.0
311170,2014,1,0,0,1,100.0
311170,2017,2,0,0,2,100.0
311170,2018,1,0,0,1,100.0
311170,2019,2,0,0,2,100.0
311180,2012,2,0,0,2,100.0
311180,2013,2,0,0,2,100.0
311180,2014,3,0,0,3,100.0
311180,2015,1,0,0,1,100.0
311180,2016,2,0,0,2,100.0
311180,2017,4,0,0,4,100.0
311180,2018,4,0,0,4,100.0
311180,2019,4,0,0,4,100.0
311180,2020,6,0,0,6,100.0
311190,2012,2,0,0,2,100.0
311190,2013,2,0,1,3,66.66666666666666
311190,2014,2,0,0,2,100.0
311190,2015,3,0,0,3,100.0
311190,2016,1,0,0,1,100.0
311190,2017,2,0,0,2,100.0
311190,2018,1,0,0,1,100.0
311190,2019,2,0,1,3,66.66666666666666
311190,2020,0,0,1,1,0.0
311200,2012,6,0,0,6,100.0
311200,2013,3,0,0,3,100.0
311200,2014,4,0,0,4,100.0
311200,2015,3,0,0,3,100.0
311200,2016,4,0,0,4,100.0
311200,2017,5,0,0,5,100.0
311200,2018,2,0,0,2,100.0
311200,2019,6,0,0,6,100.0
311200,2020,6,0,0,6,100.0
311205,2013,2,0,0,2,100.0
311205,2015,0,0,1,1,0.0
311205,2016,1,0,1,2,50.0
311205,2017,2,0,0,2,100.0
311205,2018,4,0,0,4,100.0
311205,2019,2,0,0,2,100.0
311205,2020,2,0,0,2,100.0
311210,2012,1,0,0,1,100.0
311210,2014,1,0,0,1,100.0
311210,2015,1,0,0,1,100.0
311210,2016,1,0,0,1,100.0
311210,2017,5,0,0,5,100.0
311210,2018,4,0,0,4,100.0
311210,2019,1,0,0,1,100.0
311210,2020,0,1,0,1,100.0
311220,2012,2,0,0,2,100.0
311220,2013,2,0,0,2,100.0
311220,2015,4,0,0,4,100.0
311220,2017,1,0,0,1,100.0
311220,2018,1,0,0,1,100.0
311220,2019,2,0,0,2,100.0
311220,2020,2,0,0,2,100.0
311230,2012,10,0,0,10,100.0
311230,2013,13,0,0,13,100.0
311230,2014,19,0,0,19,100.0
311230,2015,6,0,0,6,100.0
311230,2016,16,0,0,16,100.0
311230,2017,14,0,0,14,100.0
311230,2018,19,0,0,19,100.0
311230,2019,7,0,1,8,87.5
311230,2020,12,0,0,12,100.0
311240,2012,1,0,0,1,100.0
311240,2013,2,0,0,2,100.0
311240,2015,1,0,1,2,50.0
311240,2016,4,0,0,4,100.0
311240,2017,3,0,0,3,100.0
311240,2019,5,0,0,5,100.0
311240,2020,3,0,0,3,100.0
311250,2012,6,0,1,7,85.71428571428571
311250,2013,2,0,0,2,100.0
311250,2014,3,0,0,3,100.0
311250,2016,7,0,0,7,100.0
311250,2017,1,0,0,1,100.0
311250,2018,2,0,0,2,100.0
311250,2019,6,0,0,6,100.0
311250,2020,2,0,0,2,100.0
311260,2012,6,0,0,6,100.0
311260,2013,4,0,0,4,100.0
311260,2014,5,0,0,5,100.0
311260,2015,3,0,0,3,100.0
311260,2016,2,0,0,2,100.0
311260,2017,3,0,0,3,100.0
311260,2018,4,0,0,4,100.0
311260,2019,2,0,0,2,100.0
311260,2020,4,0,0,4,100.0
311265,2012,3,0,0,3,100.0
311265,2014,3,0,0,3,100.0
311265,2015,2,0,0,2,100.0
311265,2016,1,0,0,1,100.0
311265,2017,1,0,0,1,100.0
311265,2018,4,0,0,4,100.0
311265,2019,3,0,0,3,100.0
311270,2012,5,0,0,5,100.0
311270,2013,6,0,0,6,100.0
311270,2014,7,0,1,8,87.5
311270,2015,6,0,0,6,100.0
311270,2016,9,0,0,9,100.0
311270,2017,4,0,0,4,100.0
311270,2018,7,0,0,7,100.0
311270,2019,6,0,0,6,100.0
311270,2020,8,0,0,8,100.0
311280,2012,1,0,0,1,100.0
311280,2013,1,0,0,1,100.0
311280,2014,1,0,0,1,100.0
311280,2015,3,0,0,3,100.0
311280,2016,1,0,0,1,100.0
311280,2017,2,0,0,2,100.0
311280,2018,5,0,0,5,100.0
311280,2019,2,0,0,2,100.0
311280,2020,3,0,0,3,100.0
311290,2012,3,0,0,3,100.0
311290,2013,6,0,0,6,100.0
311290,2014,5,0,0,5,100.0
311290,2016,2,0,0,2,100.0
311290,2017,2,0,0,2,100.0
311290,2018,4,0,0,4,100.0
311290,2019,3,0,0,3,100.0
311290,2020,5,0,0,5,100.0
311300,2012,9,0,0,9,100.0
311300,2013,9,0,1,10,90.0
311300,2014,11,0,0,11,100.0
311300,2015,12,0,0,12,100.0
311300,2016,6,0,0,6,100.0
311300,2017,9,0,0,9,100.0
311300,2018,6,0,0,6,100.0
311300,2019,10,0,0,10,100.0
311300,2020,12,0,0,12,100.0
311310,2016,1,0,0,1,100.0
311310,2017,2,0,0,2,100.0
311310,2018,2,0,0,2,100.0
311310,2019,2,0,0,2,100.0
311310,2020,1,0,0,1,100.0
311320,2012,8,0,1,9,88.88888888888889
311320,2013,9,0,0,9,100.0
311320,2014,14,0,0,14,100.0
311320,2015,9,0,0,9,100.0
311320,2016,8,0,0,8,100.0
311320,2017,13,0,0,13,100.0
311320,2018,10,0,0,10,100.0
311320,2019,4,0,0,4,100.0
311320,2020,9,0,0,9,100.0
311330,2012,11,0,0,11,100.0
311330,2013,9,0,0,9,100.0
311330,2014,19,0,0,19,100.0
311330,2015,12,0,1,13,92.3076923076923
311330,2016,21,0,0,21,100.0
311330,2017,9,0,0,9,100.0
311330,2018,11,0,1,12,91.66666666666666
311330,2019,15,0,0,15,100.0
311330,2020,11,1,0,12,100.0
311340,2012,31,0,0,31,100.0
311340,2013,29,0,0,29,100.0
311340,2014,22,0,0,22,100.0
311340,2015,37,0,0,37,100.0
311340,2016,38,1,0,39,100.0
311340,2017,36,0,0,36,100.0
311340,2018,21,0,0,21,100.0
311340,2019,27,0,0,27,100.0
311340,2020,29,0,1,30,96.66666666666667
311350,2012,6,0,0,6,100.0
311350,2013,3,0,0,3,100.0
311350,2014,2,0,0,2,100.0
311350,2015,5,0,0,5,100.0
311350,2016,6,0,0,6,100.0
311350,2017,1,0,0,1,100.0
311350,2018,3,0,0,3,100.0
311350,2019,4,0,0,4,100.0
311350,2020,1,0,1,2,50.0
311360,2013,4,0,0,4,100.0
311360,2014,2,0,0,2,100.0
311360,2015,5,0,0,5,100.0
311360,2016,3,0,0,3,100.0
311360,2018,1,0,0,1,100.0
311360,2019,1,0,0,1,100.0
311360,2020,1,0,0,1,100.0
311370,2012,4,0,5,9,44.44444444444444
311370,2013,6,0,0,6,100.0
311370,2014,8,0,0,8,100.0
311370,2015,10,0,0,10,100.0
311370,2016,12,0,0,12,100.0
311370,2017,6,0,0,6,100.0
311370,2018,9,0,0,9,100.0
311370,2019,2,0,3,5,40.0
311370,2020,3,0,3,6,50.0
311380,2013,1,0,0,1,100.0
311380,2014,2,0,0,2,100.0
311380,2018,1,0,0,1,100.0
311390,2012,3,0,0,3,100.0
311390,2013,8,0,0,8,100.0
311390,2014,6,0,0,6,100.0
311390,2015,7,0,1,8,87.5
311390,2016,1,0,0,1,100.0
311390,2017,5,0,0,5,100.0
311390,2018,4,0,0,4,100.0
311390,2019,5,0,0,5,100.0
311390,2020,2,0,0,2,100.0
311400,2012,6,0,1,7,85.71428571428571
311400,2013,4,0,0,4,100.0
311400,2014,4,0,0,4,100.0
311400,2015,4,0,0,4,100.0
311400,2017,3,0,0,3,100.0
311400,2018,5,0,0,5,100.0
311400,2019,2,0,0,2,100.0
311400,2020,4,0,0,4,100.0
311410,2012,1,0,0,1,100.0
311410,2013,3,0,1,4,75.0
311410,2014,7,0,0,7,100.0
311410,2015,4,0,0,4,100.0
311410,2016,11,0,0,11,100.0
311410,2017,7,0,0,7,100.0
311410,2018,3,0,0,3,100.0
311410,2019,7,0,0,7,100.0
311410,2020,4,0,0,4,100.0
311420,2012,8,0,0,8,100.0
311420,2013,4,0,0,4,100.0
311420,2014,9,0,0,9,100.0
311420,2015,3,0,0,3,100.0
311420,2016,8,0,0,8,100.0
311420,2017,6,0,0,6,100.0
311420,2018,7,0,0,7,100.0
311420,2019,7,0,0,7,100.0
311420,2020,8,0,0,8,100.0
311430,2012,12,0,0,12,100.0
311430,2013,8,0,0,8,100.0
311430,2014,9,0,0,9,100.0
311430,2015,17,0,0,17,100.0
311430,2016,15,0,0,15,100.0
311430,2017,15,0,0,15,100.0
311430,2018,9,0,0,9,100.0
311430,2019,11,0,0,11,100.0
311430,2020,15,0,0,15,100.0
311440,2012,4,0,0,4,100.0
311440,2013,3,0,0,3,100.0
311440,2014,3,0,2,5,60.0
311440,2015,6,0,2,8,75.0
311440,2016,3,0,0,3,100.0
311440,2017,11,0,0,11,100.0
311440,2018,5,0,0,5,100.0
311440,2019,7,0,0,7,100.0
311440,2020,0,1,2,3,33.33333333333333
311450,2012,3,0,4,7,42.857142857142854
311450,2013,6,0,0,6,100.0
311450,2014,7,0,0,7,100.0
311450,2015,4,0,0,4,100.0
311450,2016,3,0,0,3,100.0
311450,2017,4,0,0,4,100.0
311450,2018,5,0,0,5,100.0
311450,2019,3,0,0,3,100.0
311450,2020,5,0,0,5,100.0
311455,2012,4,0,0,4,100.0
311455,2014,1,0,0,1,100.0
311455,2015,3,0,0,3,100.0
311455,2016,7,0,0,7,100.0
311455,2017,2,0,0,2,100.0
311455,2018,2,0,0,2,100.0
311455,2019,3,0,0,3,100.0
311455,2020,2,1,0,3,100.0
311460,2015,1,0,0,1,100.0
311460,2016,1,0,0,1,100.0
311460,2017,1,0,0,1,100.0
311460,2018,1,0,0,1,100.0
311460,2019,2,0,0,2,100.0
311460,2020,2,0,0,2,100.0
311470,2012,1,0,0,1,100.0
311470,2013,2,0,0,2,100.0
311470,2018,1,0,0,1,100.0
311470,2019,2,0,0,2,100.0
311480,2012,2,1,1,4,75.0
311480,2013,1,0,0,1,100.0
311480,2014,1,0,0,1,100.0
311480,2015,1,0,0,1,100.0
311480,2016,4,0,0,4,100.0
311480,2020,1,0,0,1,100.0
311490,2012,2,0,0,2,100.0
311490,2014,1,0,0,1,100.0
311490,2016,1,0,0,1,100.0
311490,2017,1,0,0,1,100.0
311490,2018,1,0,0,1,100.0
311500,2017,2,0,1,3,66.66666666666666
311500,2019,1,0,0,1,100.0
311500,2020,2,0,0,2,100.0
311510,2012,6,0,0,6,100.0
311510,2013,9,0,0,9,100.0
311510,2014,5,0,0,5,100.0
311510,2015,6,0,0,6,100.0
311510,2016,2,0,0,2,100.0
311510,2017,1,0,0,1,100.0
311510,2018,7,0,0,7,100.0
311510,2019,6,0,0,6,100.0
311510,2020,3,0,0,3,100.0
311520,2012,1,0,0,1,100.0
311520,2014,0,0,1,1,0.0
311520,2015,1,0,0,1,100.0
311520,2016,1,0,0,1,100.0
311520,2017,3,0,0,3,100.0
311520,2018,1,0,0,1,100.0
311520,2019,1,0,0,1,100.0
311520,2020,3,0,0,3,100.0
311530,2012,31,0,0,31,100.0
311530,2013,18,0,0,18,100.0
311530,2014,17,0,0,17,100.0
311530,2015,19,0,0,19,100.0
311530,2016,32,0,0,32,100.0
311530,2017,12,0,0,12,100.0
311530,2018,24,0,0,24,100.0
311530,2019,30,0,0,30,100.0
311530,2020,27,0,2,29,93.10344827586206
311535,2013,1,0,0,1,100.0
311535,2015,4,0,0,4,100.0
311535,2016,3,0,0,3,100.0
311535,2017,1,0,0,1,100.0
311535,2019,2,0,0,2,100.0
311535,2020,1,0,0,1,100.0
311540,2013,1,0,0,1,100.0
311540,2015,1,0,0,1,100.0
311540,2016,1,0,0,1,100.0
311540,2020,2,0,0,2,100.0
311545,2012,5,0,0,5,100.0
311545,2013,1,0,0,1,100.0
311545,2014,5,0,0,5,100.0
311545,2015,6,0,0,6,100.0
311545,2016,10,0,0,10,100.0
311545,2017,10,0,0,10,100.0
311545,2018,2,0,0,2,100.0
311545,2019,3,0,0,3,100.0
311545,2020,1,0,0,1,100.0
311547,2012,4,0,0,4,100.0
311547,2013,4,0,0,4,100.0
311547,2014,4,0,0,4,100.0
311547,2015,2,0,0,2,100.0
311547,2016,1,0,0,1,100.0
311547,2017,2,0,0,2,100.0
311547,2018,4,0,0,4,100.0
311547,2019,1,0,0,1,100.0
311547,2020,1,0,0,1,100.0
311550,2012,4,0,0,4,100.0
311550,2013,8,0,0,8,100.0
311550,2014,5,0,0,5,100.0
311550,2015,5,0,0,5,100.0
311550,2016,7,0,0,7,100.0
311550,2017,6,0,0,6,100.0
311550,2018,7,0,0,7,100.0
311550,2019,5,0,0,5,100.0
311550,2020,10,0,0,10,100.0
311560,2012,1,0,0,1,100.0
311560,2018,1,0,0,1,100.0
311570,2012,4,0,0,4,100.0
311570,2013,3,0,0,3,100.0
311570,2014,3,0,0,3,100.0
311570,2015,4,0,0,4,100.0
311570,2016,1,0,2,3,33.33333333333333
311570,2017,4,0,0,4,100.0
311570,2018,3,0,0,3,100.0
311570,2019,5,0,0,5,100.0
311570,2020,0,1,0,1,100.0
311580,2012,6,0,0,6,100.0
311580,2013,4,0,0,4,100.0
311580,2014,5,0,0,5,100.0
311580,2015,6,0,0,6,100.0
311580,2017,3,0,0,3,100.0
311580,2018,3,0,0,3,100.0
311580,2019,3,0,2,5,60.0
311580,2020,4,0,0,4,100.0
311590,2012,0,1,0,1,100.0
311590,2013,0,0,1,1,0.0
311590,2014,0,0,1,1,0.0
311590,2015,0,0,3,3,0.0
311590,2016,1,0,1,2,50.0
311590,2017,0,0,1,1,0.0
311590,2018,0,0,1,1,0.0
311590,2019,0,0,1,1,0.0
311600,2012,2,0,0,2,100.0
311600,2013,2,0,0,2,100.0
311600,2014,4,0,0,4,100.0
311600,2015,1,1,0,2,100.0
311600,2016,2,0,0,2,100.0
311600,2017,2,0,0,2,100.0
311600,2020,1,0,1,2,50.0
311610,2012,2,0,0,2,100.0
311610,2013,7,0,0,7,100.0
311610,2014,4,0,0,4,100.0
311610,2015,3,0,0,3,100.0
311610,2016,3,0,0,3,100.0
311610,2017,2,0,0,2,100.0
311610,2018,2,0,0,2,100.0
311610,2019,3,0,0,3,100.0
311610,2020,2,0,0,2,100.0
311615,2012,2,0,0,2,100.0
311615,2013,2,0,0,2,100.0
311615,2014,5,0,0,5,100.0
311615,2016,3,0,0,3,100.0
311615,2017,4,0,0,4,100.0
311615,2018,1,0,0,1,100.0
311615,2019,3,0,0,3,100.0
311615,2020,2,0,0,2,100.0
311620,2012,2,0,0,2,100.0
311620,2013,1,0,0,1,100.0
311620,2014,4,0,1,5,80.0
311620,2015,0,1,0,1,100.0
311620,2017,1,0,0,1,100.0
311620,2019,0,0,1,1,0.0
311620,2020,0,0,1,1,0.0
311630,2012,3,0,0,3,100.0
311630,2013,2,0,0,2,100.0
311630,2015,5,0,0,5,100.0
311630,2016,5,0,0,5,100.0
311630,2017,2,0,0,2,100.0
311630,2018,1,0,0,1,100.0
311630,2020,1,0,0,1,100.0
311640,2013,1,0,1,2,50.0
311640,2014,1,0,0,1,100.0
311640,2016,0,0,1,1,0.0
311640,2018,1,0,0,1,100.0
311640,2019,1,0,0,1,100.0
311640,2020,1,0,0,1,100.0
311650,2012,1,0,0,1,100.0
311650,2013,2,0,0,2,100.0
311650,2014,1,0,0,1,100.0
311650,2015,3,0,0,3,100.0
311650,2016,6,0,0,6,100.0
311650,2017,4,0,0,4,100.0
311650,2018,3,0,0,3,100.0
311650,2019,3,0,0,3,100.0
311650,2020,2,0,0,2,100.0
311660,2012,5,0,0,5,100.0
311660,2013,12,0,1,13,92.3076923076923
311660,2014,9,0,0,9,100.0
311660,2015,11,0,0,11,100.0
311660,2016,7,0,0,7,100.0
311660,2017,10,0,0,10,100.0
311660,2018,9,0,0,9,100.0
311660,2019,4,0,0,4,100.0
311660,2020,5,0,0,5,100.0
311670,2012,1,0,0,1,100.0
311670,2013,3,0,0,3,100.0
311670,2014,3,0,0,3,100.0
311670,2015,2,0,0,2,100.0
311670,2016,3,0,0,3,100.0
311670,2017,1,0,0,1,100.0
311670,2018,3,0,0,3,100.0
311670,2019,6,0,0,6,100.0
311670,2020,5,0,0,5,100.0
311680,2012,2,0,0,2,100.0
311680,2013,1,0,0,1,100.0
311680,2014,7,0,0,7,100.0
311680,2015,2,0,0,2,100.0
311680,2016,2,0,0,2,100.0
311680,2017,4,0,0,4,100.0
311680,2018,2,0,0,2,100.0
311680,2019,4,0,1,5,80.0
311680,2020,3,0,3,6,50.0
311690,2012,1,0,0,1,100.0
311690,2013,1,0,0,1,100.0
311690,2014,1,0,0,1,100.0
311690,2015,2,0,0,2,100.0
311690,2017,1,0,0,1,100.0
311690,2018,1,0,0,1,100.0
311690,2019,0,0,1,1,0.0
311700,2013,3,0,0,3,100.0
311700,2016,4,0,0,4,100.0
311700,2018,1,0,0,1,100.0
311700,2020,2,0,0,2,100.0
311710,2013,1,0,0,1,100.0
311710,2014,5,0,0,5,100.0
311710,2015,4,0,0,4,100.0
311710,2016,1,0,0,1,100.0
311710,2017,2,0,0,2,100.0
311710,2018,2,0,0,2,100.0
311710,2019,6,0,0,6,100.0
311710,2020,3,0,0,3,100.0
311720,2012,1,0,0,1,100.0
311720,2014,2,0,0,2,100.0
311720,2015,1,0,0,1,100.0
311720,2019,1,0,0,1,100.0
311730,2012,10,0,0,10,100.0
311730,2013,8,0,0,8,100.0
311730,2014,9,0,0,9,100.0
311730,2015,12,0,0,12,100.0
311730,2016,11,0,0,11,100.0
311730,2017,7,0,0,7,100.0
311730,2018,6,0,0,6,100.0
311730,2019,12,0,0,12,100.0
311730,2020,14,0,0,14,100.0
311740,2012,6,0,0,6,100.0
311740,2014,2,0,0,2,100.0
311740,2017,1,0,0,1,100.0
311740,2019,2,0,0,2,100.0
311740,2020,3,0,0,3,100.0
311750,2012,1,0,3,4,25.0
311750,2013,0,0,5,5,0.0
311750,2014,2,0,1,3,66.66666666666666
311750,2015,5,0,0,5,100.0
311750,2016,6,0,0,6,100.0
311750,2017,6,0,1,7,85.71428571428571
311750,2018,6,0,0,6,100.0
311750,2019,9,0,0,9,100.0
311750,2020,7,0,0,7,100.0
311760,2012,1,0,0,1,100.0
311760,2013,2,0,0,2,100.0
311760,2014,3,0,0,3,100.0
311760,2015,3,0,0,3,100.0
311760,2016,2,0,0,2,100.0
311760,2017,2,0,0,2,100.0
311760,2018,1,0,0,1,100.0
311760,2019,2,0,0,2,100.0
311760,2020,2,0,0,2,100.0
311770,2012,7,0,0,7,100.0
311770,2013,8,0,1,9,88.88888888888889
311770,2014,7,0,0,7,100.0
311770,2015,5,0,0,5,100.0
311770,2016,5,0,0,5,100.0
311770,2017,5,0,0,5,100.0
311770,2018,1,0,0,1,100.0
311770,2019,3,0,0,3,100.0
311770,2020,5,0,0,5,100.0
311780,2012,2,0,0,2,100.0
311780,2013,3,0,0,3,100.0
311780,2014,1,0,0,1,100.0
311780,2016,6,0,0,6,100.0
311780,2017,2,0,0,2,100.0
311780,2018,5,0,0,5,100.0
311780,2019,2,0,0,2,100.0
311780,2020,7,0,0,7,100.0
311783,2012,2,0,0,2,100.0
311783,2015,2,0,0,2,100.0
311783,2016,1,0,0,1,100.0
311783,2018,3,0,0,3,100.0
311783,2019,3,0,0,3,100.0
311787,2012,2,0,0,2,100.0
311787,2014,3,0,0,3,100.0
311787,2015,3,0,1,4,75.0
311787,2016,3,0,1,4,75.0
311787,2017,0,0,2,2,0.0
311787,2019,0,0,2,2,0.0
311787,2020,0,0,1,1,0.0
311790,2012,2,0,0,2,100.0
311790,2013,1,0,0,1,100.0
311790,2014,3,0,0,3,100.0
311790,2015,2,0,0,2,100.0
311790,2016,3,0,0,3,100.0
311790,2017,1,0,0,1,100.0
311790,2018,4,0,0,4,100.0
311790,2019,5,0,2,7,71.42857142857143
311790,2020,1,0,1,2,50.0
311800,2012,18,0,0,18,100.0
311800,2013,11,0,1,12,91.66666666666666
311800,2014,18,0,0,18,100.0
311800,2015,21,0,0,21,100.0
311800,2016,16,0,0,16,100.0
311800,2017,20,0,0,20,100.0
311800,2018,15,0,0,15,100.0
311800,2019,12,0,0,12,100.0
311800,2020,15,0,0,15,100.0
311810,2012,1,0,0,1,100.0
311810,2013,5,0,0,5,100.0
311810,2014,1,0,0,1,100.0
311810,2015,0,0,1,1,0.0
311810,2017,1,0,2,3,33.33333333333333
311810,2018,3,0,0,3,100.0
311810,2019,2,0,0,2,100.0
311810,2020,2,0,0,2,100.0
311820,2012,2,0,0,2,100.0
311820,2014,1,0,0,1,100.0
311820,2015,2,0,0,2,100.0
311820,2016,1,0,0,1,100.0
311820,2017,2,0,0,2,100.0
311820,2018,2,0,0,2,100.0
311820,2019,1,0,0,1,100.0
311820,2020,3,0,0,3,100.0
311830,2012,33,0,0,33,100.0
311830,2013,37,0,0,37,100.0
311830,2014,35,0,0,35,100.0
311830,2015,46,0,0,46,100.0
311830,2016,43,0,0,43,100.0
311830,2017,35,0,0,35,100.0
311830,2018,49,0,0,49,100.0
311830,2019,29,0,1,30,96.66666666666667
311830,2020,43,0,0,43,100.0
311840,2012,8,0,0,8,100.0
311840,2013,14,0,0,14,100.0
311840,2014,6,0,0,6,100.0
311840,2015,5,0,0,5,100.0
311840,2016,3,0,0,3,100.0
311840,2017,8,0,0,8,100.0
311840,2018,4,0,0,4,100.0
311840,2019,3,0,0,3,100.0
311840,2020,5,0,0,5,100.0
311850,2016,1,0,0,1,100.0
311850,2018,1,0,0,1,100.0
311850,2020,1,0,0,1,100.0
311860,2012,199,0,0,199,100.0
311860,2013,180,7,15,202,92.57425742574257
311860,2014,198,0,0,198,100.0
311860,2015,216,0,1,217,99.53917050691244
311860,2016,207,0,0,207,100.0
311860,2017,168,0,0,168,100.0
311860,2018,175,0,0,175,100.0
311860,2019,168,0,0,168,100.0
311860,2020,208,0,0,208,100.0
311870,2012,3,0,1,4,75.0
311870,2013,4,0,0,4,100.0
311870,2014,2,0,0,2,100.0
311870,2015,2,0,0,2,100.0
311870,2016,4,0,0,4,100.0
311870,2017,1,0,0,1,100.0
311870,2018,4,0,0,4,100.0
311870,2019,3,0,0,3,100.0
311870,2020,2,0,0,2,100.0
311880,2012,7,0,0,7,100.0
311880,2013,4,0,1,5,80.0
311880,2014,11,0,0,11,100.0
311880,2015,8,0,0,8,100.0
311880,2016,4,0,0,4,100.0
311880,2017,4,0,0,4,100.0
311880,2018,5,0,0,5,100.0
311880,2019,10,0,0,10,100.0
311880,2020,9,0,2,11,81.81818181818183
311890,2012,2,0,0,2,100.0
311890,2013,1,0,0,1,100.0
311890,2014,2,0,0,2,100.0
311890,2015,1,0,0,1,100.0
311890,2016,2,0,0,2,100.0
311890,2017,2,0,0,2,100.0
311890,2018,2,0,0,2,100.0
311890,2019,2,0,0,2,100.0
311890,2020,5,0,0,5,100.0
311900,2012,5,0,0,5,100.0
311900,2015,1,0,0,1,100.0
311900,2016,2,0,0,2,100.0
311900,2017,4,0,0,4,100.0
311900,2018,3,0,0,3,100.0
311900,2019,3,0,0,3,100.0
311900,2020,2,0,0,2,100.0
311910,2012,11,0,0,11,100.0
311910,2013,14,0,0,14,100.0
311910,2014,9,0,1,10,90.0
311910,2015,8,0,0,8,100.0
311910,2016,10,0,0,10,100.0
311910,2017,9,0,0,9,100.0
311910,2018,7,0,1,8,87.5
311910,2019,13,0,0,13,100.0
311910,2020,7,0,0,7,100.0
311920,2012,3,0,0,3,100.0
311920,2013,1,0,0,1,100.0
311920,2014,1,0,0,1,100.0
311920,2015,3,0,0,3,100.0
311920,2016,2,0,0,2,100.0
311920,2018,1,0,0,1,100.0
311920,2019,2,0,1,3,66.66666666666666
311920,2020,0,2,4,6,33.33333333333333
311930,2012,6,0,0,6,100.0
311930,2013,5,0,0,5,100.0
311930,2014,9,0,0,9,100.0
311930,2015,12,0,0,12,100.0
311930,2016,7,0,0,7,100.0
311930,2017,8,0,0,8,100.0
311930,2018,9,0,0,9,100.0
311930,2019,10,0,0,10,100.0
311930,2020,8,0,0,8,100.0
311940,2012,51,0,0,51,100.0
311940,2013,41,0,0,41,100.0
311940,2014,31,0,1,32,96.875
311940,2015,30,0,0,30,100.0
311940,2016,41,0,0,41,100.0
311940,2017,30,0,0,30,100.0
311940,2018,24,0,0,24,100.0
311940,2019,21,0,0,21,100.0
311940,2020,31,0,0,31,100.0
311950,2012,5,0,0,5,100.0
311950,2013,2,0,0,2,100.0
311950,2014,6,0,0,6,100.0
311950,2015,2,0,0,2,100.0
311950,2016,1,0,0,1,100.0
311950,2017,2,0,1,3,66.66666666666666
311950,2018,3,0,0,3,100.0
311950,2019,2,0,0,2,100.0
311950,2020,0,0,3,3,0.0
311960,2014,0,0,3,3,0.0
311960,2015,0,1,1,2,50.0
311960,2016,0,0,2,2,0.0
311960,2017,2,0,0,2,100.0
311960,2018,1,0,0,1,100.0
311970,2013,3,0,0,3,100.0
311970,2014,1,0,0,1,100.0
311970,2016,1,0,0,1,100.0
311970,2019,2,0,0,2,100.0
311970,2020,1,0,0,1,100.0
311980,2012,1,0,3,4,25.0
311980,2013,1,0,0,1,100.0
311980,2014,0,0,1,1,0.0
311980,2017,1,0,0,1,100.0
311980,2018,1,0,0,1,100.0
311990,2012,1,0,0,1,100.0
311990,2013,1,0,0,1,100.0
311990,2015,2,0,0,2,100.0
311990,2017,2,0,0,2,100.0
311990,2018,1,0,1,2,50.0
311990,2020,1,0,0,1,100.0
311995,2012,3,0,0,3,100.0
311995,2013,2,0,0,2,100.0
311995,2014,3,0,0,3,100.0
311995,2015,3,0,0,3,100.0
311995,2017,2,0,0,2,100.0
311995,2018,1,0,0,1,100.0
311995,2020,2,0,0,2,100.0
312000,2012,1,0,0,1,100.0
312000,2013,1,0,0,1,100.0
312000,2017,3,0,0,3,100.0
312000,2018,1,0,0,1,100.0
312000,2019,1,0,0,1,100.0
312000,2020,1,0,0,1,100.0
312010,2013,3,0,0,3,100.0
312010,2014,3,0,0,3,100.0
312010,2015,3,0,0,3,100.0
312010,2016,1,0,0,1,100.0
312010,2017,3,0,0,3,100.0
312010,2018,1,0,1,2,50.0
312010,2019,1,0,0,1,100.0
312015,2012,8,0,0,8,100.0
312015,2013,1,0,0,1,100.0
312015,2014,3,0,0,3,100.0
312015,2015,7,0,0,7,100.0
312015,2017,2,0,1,3,66.66666666666666
312015,2018,3,0,0,3,100.0
312015,2019,1,0,0,1,100.0
312015,2020,1,0,0,1,100.0
312020,2012,9,0,0,9,100.0
312020,2013,7,0,0,7,100.0
312020,2014,2,0,1,3,66.66666666666666
312020,2015,1,0,0,1,100.0
312020,2016,7,0,0,7,100.0
312020,2017,4,0,0,4,100.0
312020,2018,3,0,0,3,100.0
312020,2019,2,0,0,2,100.0
312020,2020,6,0,0,6,100.0
312030,2012,3,0,0,3,100.0
312030,2015,3,0,0,3,100.0
312030,2016,3,0,0,3,100.0
312030,2017,1,0,0,1,100.0
312030,2018,2,0,0,2,100.0
312030,2019,1,0,0,1,100.0
312030,2020,3,0,0,3,100.0
312040,2012,3,0,0,3,100.0
312040,2013,2,0,0,2,100.0
312040,2014,0,1,2,3,33.33333333333333
312040,2015,2,1,1,4,75.0
312040,2016,3,0,0,3,100.0
312040,2017,2,0,0,2,100.0
312040,2018,1,0,0,1,100.0
312040,2019,3,0,0,3,100.0
312040,2020,2,0,0,2,100.0
312050,2012,4,0,0,4,100.0
312050,2013,1,1,0,2,100.0
312050,2014,1,0,0,1,100.0
312050,2015,3,0,0,3,100.0
312050,2016,1,0,0,1,100.0
312050,2017,2,0,0,2,100.0
312050,2018,1,0,0,1,100.0
312050,2019,1,0,0,1,100.0
312050,2020,3,0,0,3,100.0
312060,2013,1,0,0,1,100.0
312060,2014,2,0,1,3,66.66666666666666
312060,2015,0,0,1,1,0.0
312060,2016,1,0,0,1,100.0
312060,2017,0,0,1,1,0.0
312060,2018,3,0,0,3,100.0
312060,2020,1,0,0,1,100.0
312070,2012,2,0,0,2,100.0
312070,2013,3,0,0,3,100.0
312070,2014,1,0,0,1,100.0
312070,2015,1,0,0,1,100.0
312070,2016,2,0,0,2,100.0
312070,2019,1,0,0,1,100.0
312080,2012,12,1,1,14,92.85714285714286
312080,2013,4,0,0,4,100.0
312080,2014,5,0,0,5,100.0
312080,2015,9,0,0,9,100.0
312080,2016,6,0,0,6,100.0
312080,2017,5,0,0,5,100.0
312080,2018,5,0,0,5,100.0
312080,2019,6,0,0,6,100.0
312080,2020,6,0,0,6,100.0
312083,2012,1,0,1,2,50.0
312083,2013,1,0,0,1,100.0
312083,2014,3,0,1,4,75.0
312083,2015,1,0,0,1,100.0
312083,2016,3,0,0,3,100.0
312083,2017,4,0,0,4,100.0
312083,2018,1,0,0,1,100.0
312083,2020,1,0,0,1,100.0
312087,2012,2,0,0,2,100.0
312087,2013,2,0,0,2,100.0
312087,2014,3,0,0,3,100.0
312087,2015,5,0,0,5,100.0
312087,2016,4,0,0,4,100.0
312087,2018,4,0,0,4,100.0
312087,2019,2,0,0,2,100.0
312087,2020,3,0,1,4,75.0
312090,2012,24,0,1,25,96.0
312090,2013,21,0,0,21,100.0
312090,2014,30,0,0,30,100.0
312090,2015,21,0,0,21,100.0
312090,2016,24,0,0,24,100.0
312090,2017,34,0,1,35,97.14285714285714
312090,2018,27,0,0,27,100.0
312090,2019,23,0,0,23,100.0
312090,2020,24,0,0,24,100.0
312100,2012,3,0,0,3,100.0
312100,2013,6,0,0,6,100.0
312100,2014,1,0,0,1,100.0
312100,2015,3,0,0,3,100.0
312100,2016,2,0,1,3,66.66666666666666
312100,2017,3,0,0,3,100.0
312100,2018,3,0,0,3,100.0
312100,2019,2,0,0,2,100.0
312100,2020,4,0,0,4,100.0
312110,2012,3,0,0,3,100.0
312110,2014,4,0,0,4,100.0
312110,2016,1,0,0,1,100.0
312110,2017,1,0,0,1,100.0
312110,2018,2,0,0,2,100.0
312110,2019,2,0,0,2,100.0
312110,2020,2,0,0,2,100.0
312120,2012,1,0,1,2,50.0
312120,2013,2,0,0,2,100.0
312120,2014,2,0,0,2,100.0
312120,2015,1,0,0,1,100.0
312120,2017,2,0,1,3,66.66666666666666
312120,2018,1,0,0,1,100.0
312120,2020,3,0,0,3,100.0
312125,2012,3,0,0,3,100.0
312125,2014,4,0,0,4,100.0
312125,2015,4,0,0,4,100.0
312125,2016,1,0,0,1,100.0
312125,2017,0,0,3,3,0.0
312125,2018,0,0,3,3,0.0
312125,2019,1,0,2,3,33.33333333333333
312125,2020,0,0,3,3,0.0
312130,2012,1,0,0,1,100.0
312130,2013,3,0,0,3,100.0
312130,2015,2,0,0,2,100.0
312130,2017,1,0,0,1,100.0
312130,2019,1,0,0,1,100.0
312130,2020,1,0,1,2,50.0
312140,2012,4,0,0,4,100.0
312140,2013,4,0,0,4,100.0
312140,2014,2,0,0,2,100.0
312140,2015,1,0,0,1,100.0
312140,2017,2,0,0,2,100.0
312140,2019,3,0,0,3,100.0
312140,2020,1,0,0,1,100.0
312150,2012,2,0,0,2,100.0
312150,2013,3,0,0,3,100.0
312150,2014,1,0,0,1,100.0
312150,2015,1,0,0,1,100.0
312150,2016,3,0,0,3,100.0
312150,2017,2,0,0,2,100.0
312150,2018,2,0,0,2,100.0
312150,2020,2,0,0,2,100.0
312160,2012,16,0,0,16,100.0
312160,2013,19,0,0,19,100.0
312160,2014,17,0,0,17,100.0
312160,2015,24,0,0,24,100.0
312160,2016,16,0,0,16,100.0
312160,2017,7,0,0,7,100.0
312160,2018,11,0,0,11,100.0
312160,2019,27,0,0,27,100.0
312160,2020,19,0,0,19,100.0
312170,2012,0,0,1,1,0.0
312170,2013,2,0,0,2,100.0
312170,2014,2,0,1,3,66.66666666666666
312170,2016,1,0,0,1,100.0
312170,2017,3,0,0,3,100.0
312170,2018,2,0,0,2,100.0
312170,2019,3,0,0,3,100.0
312180,2012,3,0,0,3,100.0
312180,2013,6,0,0,6,100.0
312180,2014,1,0,0,1,100.0
312180,2015,1,0,0,1,100.0
312180,2016,4,0,0,4,100.0
312180,2017,2,0,0,2,100.0
312180,2018,4,0,0,4,100.0
312190,2012,0,0,1,1,0.0
312190,2013,4,0,0,4,100.0
312190,2014,1,0,0,1,100.0
312190,2015,2,0,0,2,100.0
312190,2016,2,0,0,2,100.0
312190,2017,5,0,0,5,100.0
312190,2019,4,0,0,4,100.0
312200,2012,7,0,0,7,100.0
312200,2013,5,0,0,5,100.0
312200,2014,8,0,0,8,100.0
312200,2015,8,0,0,8,100.0
312200,2016,12,0,0,12,100.0
312200,2017,13,0,0,13,100.0
312200,2018,6,0,0,6,100.0
312200,2019,9,0,0,9,100.0
312200,2020,8,0,0,8,100.0
312210,2012,2,0,0,2,100.0
312210,2013,3,0,0,3,100.0
312210,2014,2,0,0,2,100.0
312210,2015,2,0,0,2,100.0
312210,2016,0,0,1,1,0.0
312210,2017,1,0,0,1,100.0
312210,2019,1,0,1,2,50.0
312210,2020,0,0,1,1,0.0
312220,2012,5,0,0,5,100.0
312220,2013,1,0,0,1,100.0
312220,2014,4,0,0,4,100.0
312220,2015,2,0,0,2,100.0
312220,2016,1,0,0,1,100.0
312220,2017,3,0,0,3,100.0
312220,2018,3,0,0,3,100.0
312220,2019,1,0,0,1,100.0
312220,2020,6,0,0,6,100.0
312230,2012,68,1,13,82,84.14634146341463
312230,2013,46,1,15,62,75.80645161290323
312230,2014,48,0,9,57,84.21052631578947
312230,2015,63,0,0,63,100.0
312230,2016,70,0,0,70,100.0
312230,2017,65,0,0,65,100.0
312230,2018,65,0,0,65,100.0
312230,2019,47,0,0,47,100.0
312230,2020,60,0,0,60,100.0
312235,2012,3,0,0,3,100.0
312235,2013,1,0,0,1,100.0
312235,2014,2,0,0,2,100.0
312235,2015,6,0,0,6,100.0
312235,2016,2,0,0,2,100.0
312235,2017,4,0,0,4,100.0
312235,2018,2,0,0,2,100.0
312235,2019,5,0,1,6,83.33333333333334
312235,2020,2,0,1,3,66.66666666666666
312240,2013,1,0,0,1,100.0
312240,2014,4,0,0,4,100.0
312240,2015,1,0,0,1,100.0
312240,2017,2,0,0,2,100.0
312240,2018,2,0,0,2,100.0
312240,2019,2,0,0,2,100.0
312240,2020,1,0,0,1,100.0
312245,2012,5,0,0,5,100.0
312245,2013,2,0,0,2,100.0
312245,2014,2,0,0,2,100.0
312245,2016,6,0,0,6,100.0
312245,2018,1,0,0,1,100.0
312245,2019,4,0,0,4,100.0
312245,2020,5,0,1,6,83.33333333333334
312247,2012,0,0,1,1,0.0
312247,2013,2,0,0,2,100.0
312247,2015,3,0,0,3,100.0
312247,2016,4,0,0,4,100.0
312247,2017,2,0,0,2,100.0
312247,2018,1,0,0,1,100.0
312247,2019,1,0,0,1,100.0
312247,2020,1,0,0,1,100.0
312250,2014,3,0,0,3,100.0
312250,2015,1,0,0,1,100.0
312250,2016,1,0,1,2,50.0
312250,2017,1,0,1,2,50.0
312250,2018,3,0,0,3,100.0
312250,2019,4,0,0,4,100.0
312250,2020,1,0,0,1,100.0
312260,2012,1,0,0,1,100.0
312260,2013,2,0,0,2,100.0
312260,2014,3,0,0,3,100.0
312260,2015,1,0,3,4,25.0
312260,2016,3,0,0,3,100.0
312260,2017,1,0,0,1,100.0
312260,2018,2,0,0,2,100.0
312260,2019,2,0,0,2,100.0
312260,2020,1,0,0,1,100.0
312270,2012,1,0,0,1,100.0
312270,2013,3,0,0,3,100.0
312270,2014,2,0,0,2,100.0
312270,2016,1,0,0,1,100.0
312270,2017,0,0,1,1,0.0
312270,2018,0,0,1,1,0.0
312270,2020,0,0,1,1,0.0
312280,2014,1,0,0,1,100.0
312280,2015,2,0,0,2,100.0
312280,2017,2,0,0,2,100.0
312280,2020,1,0,0,1,100.0
312290,2012,3,0,0,3,100.0
312290,2014,1,0,0,1,100.0
312290,2015,6,0,0,6,100.0
312290,2016,3,0,0,3,100.0
312290,2017,2,0,0,2,100.0
312290,2018,2,0,0,2,100.0
312290,2019,4,0,0,4,100.0
312290,2020,1,0,0,1,100.0
312300,2012,3,0,0,3,100.0
312300,2013,1,0,0,1,100.0
312300,2014,2,0,0,2,100.0
312300,2015,1,0,1,2,50.0
312300,2016,1,0,0,1,100.0
312300,2017,5,0,0,5,100.0
312300,2018,3,0,0,3,100.0
312300,2019,1,0,1,2,50.0
312300,2020,1,0,1,2,50.0
312310,2012,1,0,0,1,100.0
312310,2014,5,0,0,5,100.0
312310,2015,1,0,0,1,100.0
312310,2016,3,0,0,3,100.0
312310,2017,2,0,0,2,100.0
312310,2018,2,0,0,2,100.0
312310,2020,2,0,0,2,100.0
312320,2012,6,1,0,7,100.0
312320,2013,4,0,0,4,100.0
312320,2014,4,0,0,4,100.0
312320,2015,0,1,4,5,20.0
312320,2016,4,0,0,4,100.0
312320,2017,7,0,0,7,100.0
312320,2018,3,0,0,3,100.0
312320,2019,4,0,0,4,100.0
312320,2020,5,0,0,5,100.0
312330,2013,2,0,0,2,100.0
312330,2014,3,0,0,3,100.0
312330,2015,3,0,0,3,100.0
312330,2016,0,0,1,1,0.0
312330,2017,2,0,0,2,100.0
312330,2018,2,0,0,2,100.0
312330,2019,1,0,0,1,100.0
312340,2014,1,0,0,1,100.0
312340,2015,1,0,0,1,100.0
312350,2014,2,0,0,2,100.0
312350,2015,1,0,0,1,100.0
312350,2016,1,0,0,1,100.0
312352,2012,1,0,0,1,100.0
312352,2013,2,0,0,2,100.0
312352,2015,1,0,0,1,100.0
312352,2016,3,0,0,3,100.0
312352,2017,3,0,0,3,100.0
312352,2018,2,0,0,2,100.0
312352,2019,1,0,0,1,100.0
312352,2020,0,0,1,1,0.0
312360,2012,4,0,0,4,100.0
312360,2013,6,0,1,7,85.71428571428571
312360,2014,5,0,0,5,100.0
312360,2015,7,0,0,7,100.0
312360,2016,9,0,0,9,100.0
312360,2017,14,0,0,14,100.0
312360,2018,10,0,0,10,100.0
312360,2019,8,0,0,8,100.0
312360,2020,5,0,0,5,100.0
312370,2012,4,0,0,4,100.0
312370,2013,7,0,0,7,100.0
312370,2014,3,0,0,3,100.0
312370,2015,3,0,0,3,100.0
312370,2016,7,0,0,7,100.0
312370,2017,3,0,0,3,100.0
312370,2018,4,0,0,4,100.0
312370,2019,3,0,0,3,100.0
312370,2020,5,0,0,5,100.0
312380,2012,2,0,0,2,100.0
312380,2013,4,0,0,4,100.0
312380,2015,1,0,0,1,100.0
312380,2016,1,0,0,1,100.0
312380,2017,3,0,0,3,100.0
312380,2018,2,0,0,2,100.0
312380,2019,4,0,0,4,100.0
312385,2012,2,0,0,2,100.0
312385,2013,2,0,0,2,100.0
312385,2014,2,0,0,2,100.0
312385,2015,3,0,0,3,100.0
312385,2016,4,0,0,4,100.0
312385,2017,4,0,0,4,100.0
312385,2018,2,0,0,2,100.0
312385,2019,2,0,0,2,100.0
312385,2020,1,0,0,1,100.0
312390,2012,5,0,0,5,100.0
312390,2013,4,0,0,4,100.0
312390,2014,4,0,0,4,100.0
312390,2015,8,0,0,8,100.0
312390,2016,9,0,0,9,100.0
312390,2017,5,0,0,5,100.0
312390,2018,11,0,0,11,100.0
312390,2019,5,0,0,5,100.0
312390,2020,4,0,0,4,100.0
312400,2012,6,0,0,6,100.0
312400,2013,8,0,0,8,100.0
312400,2015,7,0,0,7,100.0
312400,2016,1,0,0,1,100.0
312400,2017,3,0,0,3,100.0
312400,2018,6,0,0,6,100.0
312400,2019,6,0,0,6,100.0
312400,2020,10,0,0,10,100.0
312410,2012,22,0,0,22,100.0
312410,2013,20,0,0,20,100.0
312410,2014,18,0,0,18,100.0
312410,2015,24,0,0,24,100.0
312410,2016,20,0,1,21,95.23809523809523
312410,2017,20,0,0,20,100.0
312410,2018,23,0,0,23,100.0
312410,2019,21,0,0,21,100.0
312410,2020,20,0,1,21,95.23809523809523
312420,2012,8,0,0,8,100.0
312420,2013,16,0,0,16,100.0
312420,2014,9,0,0,9,100.0
312420,2015,8,0,0,8,100.0
312420,2016,4,0,0,4,100.0
312420,2017,6,0,0,6,100.0
312420,2018,10,0,0,10,100.0
312420,2019,6,0,0,6,100.0
312420,2020,7,0,0,7,100.0
312430,2012,12,0,0,12,100.0
312430,2013,9,0,1,10,90.0
312430,2014,10,0,1,11,90.9090909090909
312430,2015,9,0,1,10,90.0
312430,2016,10,0,0,10,100.0
312430,2017,10,0,0,10,100.0
312430,2018,6,0,0,6,100.0
312430,2019,3,0,0,3,100.0
312430,2020,5,0,0,5,100.0
312440,2013,1,0,0,1,100.0
312440,2014,2,0,0,2,100.0
312440,2016,1,0,0,1,100.0
312440,2017,1,0,0,1,100.0
312440,2018,1,0,0,1,100.0
312440,2019,2,0,0,2,100.0
312440,2020,2,0,0,2,100.0
312450,2012,2,0,0,2,100.0
312450,2013,1,0,0,1,100.0
312450,2014,5,0,0,5,100.0
312450,2015,1,0,0,1,100.0
312450,2016,1,0,0,1,100.0
312450,2017,3,0,0,3,100.0
312450,2018,3,0,0,3,100.0
312450,2019,4,0,0,4,100.0
312450,2020,5,0,0,5,100.0
312460,2012,1,0,1,2,50.0
312460,2013,1,0,0,1,100.0
312460,2014,1,0,0,1,100.0
312460,2015,1,0,0,1,100.0
312460,2017,1,0,0,1,100.0
312470,2012,0,3,0,3,100.0
312470,2013,0,0,3,3,0.0
312470,2015,0,0,2,2,0.0
312470,2016,1,0,0,1,100.0
312470,2017,2,0,0,2,100.0
312470,2018,1,0,0,1,100.0
312470,2019,1,0,0,1,100.0
312470,2020,3,0,0,3,100.0
312480,2013,2,0,0,2,100.0
312480,2014,3,0,0,3,100.0
312480,2015,0,0,3,3,0.0
312480,2017,0,1,1,2,50.0
312480,2018,2,0,0,2,100.0
312480,2019,3,0,0,3,100.0
312480,2020,3,0,0,3,100.0
312490,2012,1,0,0,1,100.0
312490,2013,9,0,0,9,100.0
312490,2014,2,0,0,2,100.0
312490,2015,1,0,0,1,100.0
312490,2016,3,0,0,3,100.0
312490,2017,5,0,0,5,100.0
312490,2018,5,0,0,5,100.0
312490,2019,3,0,0,3,100.0
312490,2020,3,0,2,5,60.0
312500,2012,2,0,0,2,100.0
312500,2013,3,0,0,3,100.0
312500,2014,3,0,0,3,100.0
312500,2015,2,0,0,2,100.0
312500,2016,4,0,0,4,100.0
312500,2017,1,0,0,1,100.0
312500,2018,4,0,0,4,100.0
312500,2020,2,0,0,2,100.0
312510,2012,10,0,1,11,90.9090909090909
312510,2013,7,0,0,7,100.0
312510,2014,17,0,0,17,100.0
312510,2015,13,0,0,13,100.0
312510,2016,9,0,0,9,100.0
312510,2017,7,0,0,7,100.0
312510,2018,15,0,0,15,100.0
312510,2019,6,0,0,6,100.0
312510,2020,12,0,0,12,100.0
312520,2015,2,0,0,2,100.0
312520,2016,1,0,0,1,100.0
312530,2012,3,0,0,3,100.0
312530,2015,1,0,0,1,100.0
312530,2017,1,0,0,1,100.0
312530,2019,0,0,1,1,0.0
312540,2013,1,0,0,1,100.0
312540,2014,1,0,0,1,100.0
312540,2015,1,0,0,1,100.0
312540,2016,2,0,0,2,100.0
312540,2017,1,0,0,1,100.0
312540,2018,3,0,0,3,100.0
312540,2019,2,0,0,2,100.0
312540,2020,1,0,0,1,100.0
312550,2012,2,0,0,2,100.0
312550,2013,1,0,0,1,100.0
312550,2014,2,0,0,2,100.0
312550,2016,0,0,1,1,0.0
312550,2018,2,0,0,2,100.0
312550,2019,1,0,0,1,100.0
312550,2020,2,0,1,3,66.66666666666666
312560,2012,3,0,0,3,100.0
312560,2013,4,0,0,4,100.0
312560,2014,2,0,0,2,100.0
312560,2015,2,0,0,2,100.0
312560,2016,4,0,0,4,100.0
312560,2017,9,0,0,9,100.0
312560,2018,2,0,0,2,100.0
312560,2019,2,0,0,2,100.0
312560,2020,2,0,0,2,100.0
312570,2012,2,0,0,2,100.0
312570,2013,5,0,0,5,100.0
312570,2014,6,0,0,6,100.0
312570,2015,7,0,0,7,100.0
312570,2016,8,0,0,8,100.0
312570,2017,4,0,0,4,100.0
312570,2018,3,0,0,3,100.0
312570,2019,1,0,0,1,100.0
312570,2020,5,0,0,5,100.0
312580,2012,1,0,0,1,100.0
312580,2015,1,0,0,1,100.0
312580,2017,1,0,0,1,100.0
312580,2019,0,0,1,1,0.0
312580,2020,0,0,1,1,0.0
312590,2012,4,0,0,4,100.0
312590,2013,2,0,0,2,100.0
312590,2014,2,0,0,2,100.0
312590,2015,1,0,0,1,100.0
312590,2016,4,0,0,4,100.0
312590,2017,2,0,0,2,100.0
312590,2018,4,0,0,4,100.0
312590,2019,2,0,0,2,100.0
312590,2020,2,0,3,5,40.0
312595,2012,4,0,0,4,100.0
312595,2013,2,0,0,2,100.0
312595,2014,1,0,0,1,100.0
312595,2015,3,0,0,3,100.0
312595,2016,5,0,0,5,100.0
312595,2017,5,0,0,5,100.0
312595,2018,3,0,0,3,100.0
312595,2019,4,0,0,4,100.0
312595,2020,4,0,0,4,100.0
312600,2012,0,0,1,1,0.0
312600,2013,0,0,2,2,0.0
312600,2014,0,0,3,3,0.0
312600,2016,0,0,2,2,0.0
312600,2017,0,0,1,1,0.0
312600,2018,0,0,1,1,0.0
312600,2019,0,1,1,2,50.0
312600,2020,0,0,1,1,0.0
312610,2012,39,0,0,39,100.0
312610,2013,22,0,0,22,100.0
312610,2014,23,0,0,23,100.0
312610,2015,21,0,0,21,100.0
312610,2016,25,0,0,25,100.0
312610,2017,18,0,0,18,100.0
312610,2018,22,0,0,22,100.0
312610,2019,22,0,0,22,100.0
312610,2020,25,0,0,25,100.0
312620,2012,1,0,0,1,100.0
312620,2013,1,0,0,1,100.0
312620,2014,1,0,0,1,100.0
312620,2015,3,0,0,3,100.0
312620,2016,2,0,0,2,100.0
312620,2017,2,0,0,2,100.0
312620,2018,1,0,0,1,100.0
312620,2019,2,0,0,2,100.0
312620,2020,1,0,0,1,100.0
312630,2012,2,0,0,2,100.0
312630,2014,2,0,0,2,100.0
312630,2015,1,0,0,1,100.0
312630,2016,1,0,0,1,100.0
312630,2018,1,0,0,1,100.0
312630,2020,1,0,0,1,100.0
312640,2012,2,0,0,2,100.0
312640,2013,1,0,0,1,100.0
312640,2014,1,0,0,1,100.0
312640,2015,1,0,0,1,100.0
312640,2016,3,0,0,3,100.0
312640,2017,1,0,0,1,100.0
312650,2012,3,0,0,3,100.0
312650,2013,2,0,0,2,100.0
312650,2014,2,0,0,2,100.0
312650,2015,2,0,0,2,100.0
312650,2016,5,0,0,5,100.0
312650,2017,1,0,0,1,100.0
312650,2018,3,0,0,3,100.0
312650,2020,4,0,0,4,100.0
312660,2012,3,0,0,3,100.0
312660,2013,2,0,0,2,100.0
312660,2014,3,0,0,3,100.0
312660,2015,2,0,0,2,100.0
312660,2016,1,0,0,1,100.0
312660,2017,1,0,0,1,100.0
312660,2018,2,0,0,2,100.0
312660,2019,1,0,0,1,100.0
312660,2020,2,0,0,2,100.0
312670,2012,8,0,0,8,100.0
312670,2013,6,0,0,6,100.0
312670,2014,8,0,0,8,100.0
312670,2015,11,0,0,11,100.0
312670,2016,6,0,0,6,100.0
312670,2017,6,0,0,6,100.0
312670,2018,10,0,0,10,100.0
312670,2019,8,0,0,8,100.0
312670,2020,6,0,0,6,100.0
312675,2012,1,0,0,1,100.0
312675,2013,5,0,1,6,83.33333333333334
312675,2014,1,0,0,1,100.0
312675,2015,1,0,0,1,100.0
312675,2016,1,0,0,1,100.0
312675,2017,1,0,0,1,100.0
312675,2019,2,0,0,2,100.0
312675,2020,2,0,0,2,100.0
312680,2012,1,0,0,1,100.0
312680,2013,2,0,0,2,100.0
312680,2014,3,0,0,3,100.0
312680,2015,2,0,0,2,100.0
312680,2016,1,0,0,1,100.0
312680,2018,1,0,0,1,100.0
312680,2019,3,0,0,3,100.0
312680,2020,1,0,1,2,50.0
312690,2012,4,0,0,4,100.0
312690,2013,3,0,0,3,100.0
312690,2014,6,0,0,6,100.0
312690,2015,2,0,1,3,66.66666666666666
312690,2016,2,0,0,2,100.0
312690,2017,4,0,0,4,100.0
312690,2018,5,0,0,5,100.0
312690,2019,1,1,1,3,66.66666666666666
312690,2020,4,0,0,4,100.0
312695,2014,2,0,0,2,100.0
312695,2016,0,0,1,1,0.0
312695,2017,1,0,0,1,100.0
312695,2018,3,0,0,3,100.0
312695,2019,0,0,1,1,0.0
312695,2020,0,1,1,2,50.0
312700,2012,3,0,0,3,100.0
312700,2013,5,0,0,5,100.0
312700,2014,5,0,2,7,71.42857142857143
312700,2015,3,0,1,4,75.0
312700,2016,3,1,0,4,100.0
312700,2017,1,0,0,1,100.0
312700,2018,1,0,1,2,50.0
312700,2019,3,0,0,3,100.0
312700,2020,1,0,5,6,16.666666666666664
312705,2012,2,0,0,2,100.0
312705,2013,2,0,0,2,100.0
312705,2016,1,0,0,1,100.0
312705,2017,1,0,0,1,100.0
312705,2020,3,0,1,4,75.0
312707,2013,6,0,0,6,100.0
312707,2014,3,0,0,3,100.0
312707,2015,2,0,1,3,66.66666666666666
312707,2016,1,0,0,1,100.0
312707,2017,6,0,0,6,100.0
312707,2018,2,0,0,2,100.0
312707,2019,2,0,0,2,100.0
312707,2020,3,0,0,3,100.0
312710,2012,18,0,0,18,100.0
312710,2013,27,0,0,27,100.0
312710,2014,22,0,0,22,100.0
312710,2015,19,0,0,19,100.0
312710,2016,25,0,0,25,100.0
312710,2017,23,0,0,23,100.0
312710,2018,20,0,0,20,100.0
312710,2019,17,0,0,17,100.0
312710,2020,25,0,1,26,96.15384615384616
312720,2012,1,0,0,1,100.0
312720,2016,1,0,0,1,100.0
312720,2017,0,0,1,1,0.0
312720,2018,1,0,0,1,100.0
312720,2019,0,0,1,1,0.0
312720,2020,3,0,0,3,100.0
312730,2012,1,0,0,1,100.0
312730,2013,4,0,0,4,100.0
312730,2014,3,0,0,3,100.0
312730,2015,8,0,0,8,100.0
312730,2016,1,0,0,1,100.0
312730,2017,2,0,0,2,100.0
312730,2018,2,0,0,2,100.0
312730,2019,1,1,0,2,100.0
312730,2020,0,2,0,2,100.0
312733,2012,2,0,0,2,100.0
312733,2014,2,0,0,2,100.0
312733,2015,3,0,0,3,100.0
312733,2016,1,0,0,1,100.0
312733,2017,2,0,0,2,100.0
312733,2018,1,0,0,1,100.0
312733,2019,1,0,0,1,100.0
312733,2020,1,0,0,1,100.0
312735,2013,1,0,0,1,100.0
312735,2014,1,0,0,1,100.0
312735,2015,1,0,0,1,100.0
312735,2017,2,0,0,2,100.0
312735,2018,1,0,0,1,100.0
312737,2013,1,0,0,1,100.0
312737,2015,1,0,0,1,100.0
312737,2017,1,0,0,1,100.0
312737,2018,2,0,0,2,100.0
312737,2019,1,0,0,1,100.0
312737,2020,3,0,0,3,100.0
312738,2012,2,0,0,2,100.0
312738,2014,1,0,0,1,100.0
312738,2015,2,0,0,2,100.0
312738,2016,1,0,0,1,100.0
312738,2017,3,0,0,3,100.0
312738,2019,1,0,1,2,50.0
312740,2012,1,0,0,1,100.0
312740,2014,1,0,0,1,100.0
312740,2015,2,0,0,2,100.0
312740,2016,1,0,0,1,100.0
312740,2017,2,0,0,2,100.0
312740,2018,2,0,0,2,100.0
312740,2019,1,0,0,1,100.0
312740,2020,1,0,0,1,100.0
312750,2012,1,0,0,1,100.0
312750,2013,1,0,0,1,100.0
312750,2014,1,0,0,1,100.0
312750,2017,0,0,1,1,0.0
312750,2018,4,0,0,4,100.0
312750,2020,3,0,0,3,100.0
312760,2012,1,0,0,1,100.0
312760,2013,4,0,0,4,100.0
312760,2014,3,0,0,3,100.0
312760,2015,2,0,0,2,100.0
312760,2016,1,0,0,1,100.0
312760,2017,3,0,0,3,100.0
312760,2019,4,0,0,4,100.0
312760,2020,5,0,3,8,62.5
312770,2012,95,0,1,96,98.95833333333334
312770,2013,107,0,1,108,99.07407407407408
312770,2014,95,0,0,95,100.0
312770,2015,109,0,1,110,99.0909090909091
312770,2016,97,0,1,98,98.9795918367347
312770,2017,98,0,0,98,100.0
312770,2018,88,0,1,89,98.87640449438202
312770,2019,94,0,2,96,97.91666666666666
312770,2020,110,5,4,119,96.63865546218487
312780,2012,1,0,0,1,100.0
312780,2013,2,0,0,2,100.0
312780,2014,5,0,0,5,100.0
312780,2015,4,0,0,4,100.0
312780,2016,11,0,0,11,100.0
312780,2017,1,0,0,1,100.0
312780,2018,3,0,0,3,100.0
312780,2019,6,0,0,6,100.0
312780,2020,2,0,0,2,100.0
312790,2020,0,0,1,1,0.0
312800,2012,11,0,0,11,100.0
312800,2013,16,0,0,16,100.0
312800,2014,9,0,0,9,100.0
312800,2015,9,0,0,9,100.0
312800,2016,12,0,0,12,100.0
312800,2017,8,0,0,8,100.0
312800,2018,9,0,0,9,100.0
312800,2019,10,1,0,11,100.0
312800,2020,13,0,2,15,86.66666666666667
312810,2012,5,0,0,5,100.0
312810,2013,2,0,0,2,100.0
312810,2014,4,0,0,4,100.0
312810,2015,4,0,0,4,100.0
312810,2016,2,0,0,2,100.0
312810,2017,2,0,0,2,100.0
312810,2018,4,0,0,4,100.0
312810,2019,5,0,1,6,83.33333333333334
312810,2020,5,0,0,5,100.0
312820,2012,2,0,0,2,100.0
312820,2013,4,0,0,4,100.0
312820,2014,3,0,0,3,100.0
312820,2015,4,0,0,4,100.0
312820,2016,3,0,0,3,100.0
312820,2017,5,0,0,5,100.0
312820,2018,4,0,1,5,80.0
312820,2020,2,0,2,4,50.0
312825,2013,1,0,0,1,100.0
312825,2015,2,0,0,2,100.0
312825,2016,2,0,0,2,100.0
312825,2017,2,0,0,2,100.0
312825,2019,1,0,0,1,100.0
312830,2012,4,0,0,4,100.0
312830,2013,8,0,0,8,100.0
312830,2014,7,0,0,7,100.0
312830,2015,8,0,0,8,100.0
312830,2016,5,0,0,5,100.0
312830,2017,4,0,0,4,100.0
312830,2018,3,0,0,3,100.0
312830,2019,5,0,0,5,100.0
312830,2020,7,0,0,7,100.0
312840,2012,6,0,0,6,100.0
312840,2013,2,0,0,2,100.0
312840,2014,8,0,0,8,100.0
312840,2015,4,0,0,4,100.0
312840,2016,4,0,0,4,100.0
312840,2017,1,0,0,1,100.0
312840,2018,3,0,0,3,100.0
312840,2019,4,0,0,4,100.0
312840,2020,2,0,0,2,100.0
312850,2013,1,0,0,1,100.0
312850,2014,2,0,0,2,100.0
312850,2015,1,0,0,1,100.0
312850,2016,1,0,0,1,100.0
312850,2017,1,0,0,1,100.0
312850,2018,1,0,0,1,100.0
312850,2019,1,0,0,1,100.0
312850,2020,1,0,0,1,100.0
312860,2012,3,0,0,3,100.0
312860,2013,2,1,1,4,75.0
312860,2014,1,0,0,1,100.0
312860,2015,2,0,0,2,100.0
312860,2016,1,0,0,1,100.0
312860,2017,3,1,1,5,80.0
312860,2018,2,1,0,3,100.0
312860,2019,3,0,0,3,100.0
312860,2020,0,2,1,3,66.66666666666666
312870,2012,12,0,0,12,100.0
312870,2013,25,1,0,26,100.0
312870,2014,9,0,0,9,100.0
312870,2015,17,0,0,17,100.0
312870,2016,18,0,0,18,100.0
312870,2017,13,0,0,13,100.0
312870,2018,16,0,0,16,100.0
312870,2019,15,0,0,15,100.0
312870,2020,22,0,0,22,100.0
312880,2012,1,0,0,1,100.0
312880,2013,4,0,0,4,100.0
312880,2015,1,0,0,1,100.0
312880,2016,2,0,0,2,100.0
312880,2017,1,0,0,1,100.0
312880,2018,1,0,0,1,100.0
312880,2019,4,0,0,4,100.0
312880,2020,4,0,0,4,100.0
312890,2013,2,0,0,2,100.0
312890,2015,2,0,0,2,100.0
312890,2016,2,0,0,2,100.0
312890,2018,3,0,0,3,100.0
312890,2019,3,0,0,3,100.0
312890,2020,3,0,0,3,100.0
312900,2012,3,0,0,3,100.0
312900,2013,2,0,0,2,100.0
312900,2014,1,0,0,1,100.0
312900,2015,1,0,0,1,100.0
312900,2016,4,0,0,4,100.0
312900,2017,1,0,0,1,100.0
312900,2018,4,0,0,4,100.0
312900,2019,1,0,0,1,100.0
312900,2020,2,0,0,2,100.0
312910,2012,3,0,0,3,100.0
312910,2013,3,0,0,3,100.0
312910,2014,2,0,0,2,100.0
312910,2015,1,0,0,1,100.0
312910,2016,1,0,0,1,100.0
312910,2018,2,0,0,2,100.0
312910,2019,1,0,0,1,100.0
312910,2020,0,1,1,2,50.0
312920,2012,3,0,0,3,100.0
312920,2013,3,0,0,3,100.0
312920,2015,2,0,0,2,100.0
312920,2016,2,0,0,2,100.0
312920,2017,3,0,0,3,100.0
312920,2018,3,0,0,3,100.0
312920,2019,1,0,1,2,50.0
312920,2020,4,0,0,4,100.0
312930,2012,5,0,0,5,100.0
312930,2013,5,0,0,5,100.0
312930,2014,4,0,0,4,100.0
312930,2015,1,0,0,1,100.0
312930,2016,4,0,0,4,100.0
312930,2017,1,0,0,1,100.0
312930,2018,4,0,0,4,100.0
312930,2019,3,0,0,3,100.0
312930,2020,2,0,2,4,50.0
312940,2012,2,0,2,4,50.0
312940,2013,3,0,0,3,100.0
312940,2014,6,0,0,6,100.0
312940,2015,2,0,0,2,100.0
312940,2016,1,0,0,1,100.0
312940,2017,4,0,0,4,100.0
312940,2018,2,0,0,2,100.0
312940,2019,4,0,0,4,100.0
312940,2020,2,0,0,2,100.0
312950,2012,8,0,0,8,100.0
312950,2013,8,0,0,8,100.0
312950,2014,9,0,0,9,100.0
312950,2015,8,0,0,8,100.0
312950,2016,7,0,0,7,100.0
312950,2017,5,0,0,5,100.0
312950,2018,9,0,0,9,100.0
312950,2019,5,0,0,5,100.0
312950,2020,5,0,0,5,100.0
312960,2012,1,0,1,2,50.0
312960,2013,1,0,0,1,100.0
312960,2014,2,0,0,2,100.0
312960,2015,5,0,0,5,100.0
312960,2016,6,0,0,6,100.0
312960,2018,5,0,1,6,83.33333333333334
312960,2019,2,0,0,2,100.0
312965,2012,1,0,0,1,100.0
312965,2013,3,0,0,3,100.0
312965,2014,1,0,0,1,100.0
312965,2015,2,0,0,2,100.0
312965,2016,2,0,0,2,100.0
312965,2018,1,0,0,1,100.0
312965,2019,2,0,0,2,100.0
312965,2020,3,0,0,3,100.0
312970,2012,5,0,0,5,100.0
312970,2013,2,0,0,2,100.0
312970,2014,4,0,0,4,100.0
312970,2015,5,0,0,5,100.0
312970,2016,1,0,0,1,100.0
312970,2017,3,0,0,3,100.0
312970,2018,1,0,0,1,100.0
312970,2019,3,0,0,3,100.0
312970,2020,2,0,2,4,50.0
312980,2012,68,3,1,72,98.61111111111111
312980,2013,34,0,7,41,82.92682926829268
312980,2014,51,1,4,56,92.85714285714286
312980,2015,20,6,37,63,41.269841269841265
312980,2016,40,2,17,59,71.1864406779661
312980,2017,50,0,0,50,100.0
312980,2018,42,0,1,43,97.67441860465115
312980,2019,57,0,1,58,98.27586206896551
312980,2020,60,0,2,62,96.7741935483871
312990,2012,1,0,0,1,100.0
312990,2013,1,0,0,1,100.0
312990,2014,2,0,0,2,100.0
312990,2017,1,0,0,1,100.0
312990,2020,1,0,0,1,100.0
313000,2012,1,0,0,1,100.0
313000,2013,1,0,0,1,100.0
313000,2014,1,0,0,1,100.0
313000,2015,1,0,0,1,100.0
313000,2016,1,0,0,1,100.0
313000,2017,2,0,0,2,100.0
313005,2012,3,0,2,5,60.0
313005,2013,3,0,0,3,100.0
313005,2014,4,0,0,4,100.0
313005,2015,4,0,0,4,100.0
313005,2016,2,0,0,2,100.0
313005,2017,6,0,0,6,100.0
313005,2018,7,0,0,7,100.0
313005,2019,3,0,0,3,100.0
313005,2020,3,0,0,3,100.0
313010,2012,16,0,3,19,84.21052631578947
313010,2013,19,0,0,19,100.0
313010,2014,15,0,0,15,100.0
313010,2015,9,0,0,9,100.0
313010,2016,8,0,0,8,100.0
313010,2017,12,0,0,12,100.0
313010,2018,9,0,0,9,100.0
313010,2019,10,0,0,10,100.0
313010,2020,8,0,0,8,100.0
313020,2012,1,1,1,3,66.66666666666666
313020,2013,1,0,1,2,50.0
313020,2014,3,0,1,4,75.0
313020,2015,4,0,0,4,100.0
313020,2016,1,0,0,1,100.0
313020,2017,3,0,0,3,100.0
313020,2019,2,0,0,2,100.0
313020,2020,2,0,0,2,100.0
313030,2012,0,0,1,1,0.0
313030,2013,3,0,0,3,100.0
313030,2014,4,0,0,4,100.0
313030,2015,1,0,0,1,100.0
313030,2016,4,0,0,4,100.0
313030,2017,2,0,0,2,100.0
313030,2019,4,0,0,4,100.0
313030,2020,2,0,0,2,100.0
313040,2012,2,0,1,3,66.66666666666666
313040,2014,1,0,0,1,100.0
313040,2015,3,0,0,3,100.0
313040,2016,2,0,0,2,100.0
313040,2017,3,0,0,3,100.0
313040,2019,4,0,0,4,100.0
313040,2020,3,0,0,3,100.0
313050,2012,2,0,0,2,100.0
313050,2013,4,0,0,4,100.0
313050,2014,5,0,0,5,100.0
313050,2015,2,0,0,2,100.0
313050,2016,4,0,0,4,100.0
313050,2017,3,0,0,3,100.0
313050,2018,5,0,0,5,100.0
313050,2019,10,0,0,10,100.0
313050,2020,8,0,0,8,100.0
313055,2012,4,0,0,4,100.0
313055,2013,4,0,0,4,100.0
313055,2014,3,0,0,3,100.0
313055,2015,4,0,0,4,100.0
313055,2016,4,0,0,4,100.0
313055,2017,1,0,0,1,100.0
313055,2019,3,0,0,3,100.0
313055,2020,3,0,0,3,100.0
313060,2012,4,0,0,4,100.0
313060,2013,2,0,0,2,100.0
313060,2014,1,0,0,1,100.0
313060,2015,1,0,0,1,100.0
313060,2016,1,0,0,1,100.0
313060,2017,1,0,0,1,100.0
313060,2018,1,0,0,1,100.0
313060,2019,2,0,0,2,100.0
313060,2020,2,0,0,2,100.0
313065,2013,1,0,0,1,100.0
313065,2014,0,0,1,1,0.0
313065,2016,2,1,0,3,100.0
313065,2017,2,0,0,2,100.0
313065,2018,2,0,0,2,100.0
313065,2019,1,0,0,1,100.0
313065,2020,1,0,0,1,100.0
313070,2014,2,0,0,2,100.0
313070,2015,5,0,0,5,100.0
313070,2016,3,0,1,4,75.0
313070,2017,2,0,0,2,100.0
313070,2018,3,0,0,3,100.0
313070,2019,1,1,0,2,100.0
313070,2020,1,0,0,1,100.0
313080,2013,1,0,1,2,50.0
313080,2014,1,0,0,1,100.0
313080,2015,1,0,0,1,100.0
313080,2019,2,0,0,2,100.0
313080,2020,1,0,0,1,100.0
313090,2012,7,0,0,7,100.0
313090,2013,5,0,1,6,83.33333333333334
313090,2014,6,0,1,7,85.71428571428571
313090,2015,8,0,0,8,100.0
313090,2016,8,0,0,8,100.0
313090,2017,3,0,0,3,100.0
313090,2018,4,0,0,4,100.0
313090,2019,6,0,0,6,100.0
313090,2020,4,0,0,4,100.0
313100,2012,1,0,0,1,100.0
313100,2013,2,0,0,2,100.0
313100,2014,5,0,0,5,100.0
313100,2015,4,0,0,4,100.0
313100,2016,4,0,0,4,100.0
313100,2017,1,0,0,1,100.0
313100,2018,2,0,0,2,100.0
313100,2019,1,0,0,1,100.0
313110,2012,2,0,0,2,100.0
313110,2013,1,0,0,1,100.0
313110,2014,5,0,0,5,100.0
313110,2015,6,0,0,6,100.0
313110,2016,3,0,0,3,100.0
313110,2017,1,0,0,1,100.0
313110,2018,1,0,0,1,100.0
313110,2019,1,0,0,1,100.0
313110,2020,2,0,0,2,100.0
313115,2012,6,0,0,6,100.0
313115,2013,2,0,0,2,100.0
313115,2014,9,0,0,9,100.0
313115,2015,4,0,0,4,100.0
313115,2016,8,0,0,8,100.0
313115,2017,7,0,0,7,100.0
313115,2018,4,0,0,4,100.0
313115,2019,6,0,0,6,100.0
313115,2020,8,0,0,8,100.0
313120,2012,6,2,0,8,100.0
313120,2013,4,0,0,4,100.0
313120,2014,9,0,0,9,100.0
313120,2015,5,0,0,5,100.0
313120,2016,4,0,0,4,100.0
313120,2017,10,0,1,11,90.9090909090909
313120,2018,7,0,0,7,100.0
313120,2019,3,0,0,3,100.0
313120,2020,1,0,0,1,100.0
313130,2012,82,0,0,82,100.0
313130,2013,69,0,0,69,100.0
313130,2014,74,0,0,74,100.0
313130,2015,59,0,0,59,100.0
313130,2016,77,0,0,77,100.0
313130,2017,63,0,1,64,98.4375
313130,2018,58,0,0,58,100.0
313130,2019,47,0,0,47,100.0
313130,2020,74,0,3,77,96.1038961038961
313140,2013,1,0,0,1,100.0
313140,2014,1,0,0,1,100.0
313140,2015,3,0,0,3,100.0
313140,2016,3,0,0,3,100.0
313140,2017,1,0,0,1,100.0
313140,2018,1,0,0,1,100.0
313140,2020,2,0,0,2,100.0
313150,2012,7,0,0,7,100.0
313150,2013,4,0,0,4,100.0
313150,2014,3,0,0,3,100.0
313150,2015,4,0,0,4,100.0
313150,2016,1,0,0,1,100.0
313150,2017,2,0,0,2,100.0
313150,2018,1,0,0,1,100.0
313150,2019,4,0,0,4,100.0
313150,2020,2,0,0,2,100.0
313160,2012,3,0,0,3,100.0
313160,2014,2,0,0,2,100.0
313160,2015,1,0,0,1,100.0
313160,2016,1,0,0,1,100.0
313160,2017,1,0,0,1,100.0
313160,2018,3,0,0,3,100.0
313160,2019,1,0,0,1,100.0
313160,2020,2,0,0,2,100.0
313170,2012,31,0,0,31,100.0
313170,2013,47,0,0,47,100.0
313170,2014,36,0,0,36,100.0
313170,2015,49,0,0,49,100.0
313170,2016,34,0,0,34,100.0
313170,2017,32,0,1,33,96.96969696969697
313170,2018,32,0,0,32,100.0
313170,2019,34,0,0,34,100.0
313170,2020,42,0,0,42,100.0
313180,2012,2,0,1,3,66.66666666666666
313180,2013,5,0,0,5,100.0
313180,2014,7,0,0,7,100.0
313180,2015,1,0,0,1,100.0
313180,2016,2,0,2,4,50.0
313180,2017,2,0,0,2,100.0
313180,2018,5,0,0,5,100.0
313180,2019,3,0,0,3,100.0
313180,2020,5,0,1,6,83.33333333333334
313190,2012,16,0,0,16,100.0
313190,2013,10,1,1,12,91.66666666666666
313190,2014,19,0,0,19,100.0
313190,2015,8,0,2,10,80.0
313190,2016,14,0,0,14,100.0
313190,2017,16,0,0,16,100.0
313190,2018,16,0,0,16,100.0
313190,2019,12,0,0,12,100.0
313190,2020,18,0,2,20,90.0
313200,2012,2,0,0,2,100.0
313200,2013,1,0,0,1,100.0
313200,2016,1,0,0,1,100.0
313200,2017,2,0,0,2,100.0
313200,2018,3,0,0,3,100.0
313200,2019,1,0,0,1,100.0
313200,2020,0,0,1,1,0.0
313210,2012,6,0,0,6,100.0
313210,2013,12,0,0,12,100.0
313210,2014,5,0,0,5,100.0
313210,2015,9,0,0,9,100.0
313210,2016,6,0,0,6,100.0
313210,2017,2,0,0,2,100.0
313210,2018,9,0,0,9,100.0
313210,2019,8,0,0,8,100.0
313210,2020,8,0,0,8,100.0
313220,2012,2,0,0,2,100.0
313220,2013,2,0,0,2,100.0
313220,2014,3,0,0,3,100.0
313220,2015,3,0,0,3,100.0
313220,2016,1,0,0,1,100.0
313220,2017,5,0,0,5,100.0
313220,2018,6,0,0,6,100.0
313220,2019,1,1,3,5,40.0
313220,2020,9,0,0,9,100.0
313230,2012,12,0,0,12,100.0
313230,2013,3,0,1,4,75.0
313230,2014,4,0,0,4,100.0
313230,2015,4,0,0,4,100.0
313230,2016,7,0,1,8,87.5
313230,2017,3,0,0,3,100.0
313230,2018,8,0,0,8,100.0
313230,2019,8,0,0,8,100.0
313230,2020,11,0,0,11,100.0
313240,2012,29,0,0,29,100.0
313240,2013,25,0,0,25,100.0
313240,2014,22,0,0,22,100.0
313240,2015,20,0,0,20,100.0
313240,2016,28,0,0,28,100.0
313240,2017,15,0,0,15,100.0
313240,2018,28,0,0,28,100.0
313240,2019,28,0,0,28,100.0
313240,2020,23,0,0,23,100.0
313250,2012,8,0,0,8,100.0
313250,2013,11,0,0,11,100.0
313250,2014,6,0,0,6,100.0
313250,2015,7,0,0,7,100.0
313250,2016,6,0,0,6,100.0
313250,2017,12,0,0,12,100.0
313250,2018,3,0,0,3,100.0
313250,2019,3,0,2,5,60.0
313250,2020,4,0,0,4,100.0
313260,2012,4,0,0,4,100.0
313260,2014,1,0,0,1,100.0
313260,2015,2,0,0,2,100.0
313260,2017,3,0,0,3,100.0
313260,2018,2,0,0,2,100.0
313260,2020,4,0,0,4,100.0
313270,2012,5,0,0,5,100.0
313270,2013,17,0,0,17,100.0
313270,2014,10,0,0,10,100.0
313270,2015,10,0,1,11,90.9090909090909
313270,2016,9,0,0,9,100.0
313270,2017,9,0,0,9,100.0
313270,2018,7,0,0,7,100.0
313270,2019,5,0,0,5,100.0
313270,2020,0,0,7,7,0.0
313280,2014,2,0,0,2,100.0
313280,2016,2,0,0,2,100.0
313280,2017,1,0,0,1,100.0
313280,2018,1,0,0,1,100.0
313280,2020,1,0,0,1,100.0
313290,2012,3,0,0,3,100.0
313290,2013,3,0,0,3,100.0
313290,2014,2,0,0,2,100.0
313290,2015,4,0,0,4,100.0
313290,2016,7,0,0,7,100.0
313290,2017,1,0,0,1,100.0
313290,2018,2,0,0,2,100.0
313290,2019,2,0,0,2,100.0
313290,2020,1,0,0,1,100.0
313300,2012,4,0,0,4,100.0
313300,2013,4,0,0,4,100.0
313300,2014,2,0,1,3,66.66666666666666
313300,2015,3,0,0,3,100.0
313300,2016,6,0,0,6,100.0
313300,2017,3,0,0,3,100.0
313300,2018,5,0,0,5,100.0
313300,2019,3,0,0,3,100.0
313300,2020,2,0,0,2,100.0
313310,2012,5,0,0,5,100.0
313310,2013,4,0,0,4,100.0
313310,2014,6,0,0,6,100.0
313310,2015,6,0,0,6,100.0
313310,2016,3,0,0,3,100.0
313310,2017,2,0,0,2,100.0
313310,2018,5,0,0,5,100.0
313310,2019,3,0,0,3,100.0
313310,2020,7,0,0,7,100.0
313320,2012,6,0,0,6,100.0
313320,2013,3,0,0,3,100.0
313320,2014,4,0,0,4,100.0
313320,2015,4,0,0,4,100.0
313320,2016,2,0,0,2,100.0
313320,2017,6,0,0,6,100.0
313320,2018,6,0,0,6,100.0
313320,2019,4,0,0,4,100.0
313320,2020,3,0,0,3,100.0
313330,2012,14,0,1,15,93.33333333333333
313330,2013,10,0,0,10,100.0
313330,2014,11,0,0,11,100.0
313330,2015,11,0,0,11,100.0
313330,2016,11,0,2,13,84.61538461538461
313330,2017,5,0,0,5,100.0
313330,2018,10,0,0,10,100.0
313330,2019,5,0,1,6,83.33333333333334
313330,2020,9,0,3,12,75.0
313340,2012,5,0,0,5,100.0
313340,2013,4,0,0,4,100.0
313340,2014,3,0,0,3,100.0
313340,2015,4,0,0,4,100.0
313340,2016,8,0,0,8,100.0
313340,2017,4,0,0,4,100.0
313340,2018,4,0,0,4,100.0
313340,2019,1,0,0,1,100.0
313340,2020,6,0,0,6,100.0
313350,2012,11,0,0,11,100.0
313350,2013,7,0,0,7,100.0
313350,2014,6,0,0,6,100.0
313350,2015,9,0,0,9,100.0
313350,2016,4,0,0,4,100.0
313350,2017,6,0,0,6,100.0
313350,2018,9,0,0,9,100.0
313350,2019,6,0,0,6,100.0
313350,2020,9,0,0,9,100.0
313360,2013,3,0,0,3,100.0
313360,2014,4,0,1,5,80.0
313360,2015,1,0,1,2,50.0
313360,2016,6,0,0,6,100.0
313360,2017,3,0,0,3,100.0
313360,2018,2,0,1,3,66.66666666666666
313360,2019,1,0,0,1,100.0
313360,2020,3,0,1,4,75.0
313370,2012,6,0,0,6,100.0
313370,2013,3,0,0,3,100.0
313370,2014,3,0,0,3,100.0
313370,2015,6,0,0,6,100.0
313370,2016,8,0,0,8,100.0
313370,2017,1,0,0,1,100.0
313370,2018,3,0,0,3,100.0
313370,2019,6,0,0,6,100.0
313370,2020,4,0,0,4,100.0
313375,2012,6,0,0,6,100.0
313375,2013,2,0,0,2,100.0
313375,2014,5,0,0,5,100.0
313375,2015,2,0,0,2,100.0
313375,2016,5,0,0,5,100.0
313375,2017,2,0,0,2,100.0
313375,2018,5,0,0,5,100.0
313375,2019,3,0,0,3,100.0
313375,2020,2,0,0,2,100.0
313380,2012,28,0,0,28,100.0
313380,2013,37,0,0,37,100.0
313380,2014,38,0,0,38,100.0
313380,2015,35,0,0,35,100.0
313380,2016,43,0,1,44,97.72727272727273
313380,2017,32,0,0,32,100.0
313380,2018,25,0,0,25,100.0
313380,2019,27,0,0,27,100.0
313380,2020,26,0,0,26,100.0
313390,2012,1,0,0,1,100.0
313390,2013,0,0,1,1,0.0
313390,2014,0,0,4,4,0.0
313390,2015,0,0,2,2,0.0
313390,2016,4,0,0,4,100.0
313390,2017,3,0,0,3,100.0
313390,2018,0,0,1,1,0.0
313390,2019,4,0,2,6,66.66666666666666
313390,2020,1,0,0,1,100.0
313400,2012,4,0,2,6,66.66666666666666
313400,2013,5,0,2,7,71.42857142857143
313400,2014,4,0,0,4,100.0
313400,2015,1,0,2,3,33.33333333333333
313400,2016,7,0,0,7,100.0
313400,2017,4,0,0,4,100.0
313400,2018,4,0,0,4,100.0
313400,2019,3,0,0,3,100.0
313400,2020,5,0,0,5,100.0
313410,2012,0,1,1,2,50.0
313410,2013,3,0,0,3,100.0
313410,2014,4,0,0,4,100.0
313410,2015,0,0,1,1,0.0
313410,2016,1,0,1,2,50.0
313410,2017,2,0,0,2,100.0
313410,2018,3,0,0,3,100.0
313410,2019,3,0,1,4,75.0
313410,2020,2,1,0,3,100.0
313420,2012,34,0,0,34,100.0
313420,2013,32,0,0,32,100.0
313420,2014,32,0,0,32,100.0
313420,2015,44,0,0,44,100.0
313420,2016,29,0,0,29,100.0
313420,2017,38,0,0,38,100.0
313420,2018,33,0,0,33,100.0
313420,2019,34,0,0,34,100.0
313420,2020,35,0,0,35,100.0
313430,2012,3,0,1,4,75.0
313430,2013,1,0,0,1,100.0
313430,2014,2,0,0,2,100.0
313430,2015,1,0,0,1,100.0
313430,2016,4,0,0,4,100.0
313430,2017,2,0,0,2,100.0
313430,2018,4,0,0,4,100.0
313430,2019,1,0,0,1,100.0
313440,2012,8,0,0,8,100.0
313440,2013,15,0,0,15,100.0
313440,2014,17,0,0,17,100.0
313440,2015,15,0,0,15,100.0
313440,2016,16,0,0,16,100.0
313440,2017,12,0,0,12,100.0
313440,2018,11,0,0,11,100.0
313440,2019,13,0,0,13,100.0
313440,2020,17,0,0,17,100.0
313450,2012,1,0,0,1,100.0
313450,2013,1,0,0,1,100.0
313450,2014,3,0,0,3,100.0
313450,2015,2,0,0,2,100.0
313450,2017,5,0,0,5,100.0
313450,2018,1,0,0,1,100.0
313450,2019,4,0,0,4,100.0
313460,2012,4,1,0,5,100.0
313460,2013,7,0,0,7,100.0
313460,2014,4,0,0,4,100.0
313460,2015,7,0,0,7,100.0
313460,2016,5,0,0,5,100.0
313460,2017,4,0,0,4,100.0
313460,2018,5,0,0,5,100.0
313460,2019,6,0,1,7,85.71428571428571
313460,2020,8,0,1,9,88.88888888888889
313470,2012,2,0,0,2,100.0
313470,2014,6,0,0,6,100.0
313470,2015,3,0,0,3,100.0
313470,2016,4,0,0,4,100.0
313470,2017,5,0,0,5,100.0
313470,2018,3,0,0,3,100.0
313470,2019,3,0,0,3,100.0
313470,2020,5,0,0,5,100.0
313480,2013,2,0,0,2,100.0
313480,2014,1,0,0,1,100.0
313480,2015,2,0,0,2,100.0
313480,2016,1,0,0,1,100.0
313480,2017,3,0,0,3,100.0
313480,2018,1,0,0,1,100.0
313480,2019,3,0,0,3,100.0
313480,2020,0,0,1,1,0.0
313490,2012,8,0,0,8,100.0
313490,2013,6,0,0,6,100.0
313490,2014,5,0,0,5,100.0
313490,2015,8,0,0,8,100.0
313490,2016,8,0,0,8,100.0
313490,2017,5,0,0,5,100.0
313490,2018,9,0,0,9,100.0
313490,2019,6,0,0,6,100.0
313490,2020,10,0,0,10,100.0
313500,2012,1,0,0,1,100.0
313500,2016,2,0,0,2,100.0
313500,2017,1,0,0,1,100.0
313500,2019,1,0,0,1,100.0
313500,2020,0,0,1,1,0.0
313505,2012,14,0,0,14,100.0
313505,2013,4,0,0,4,100.0
313505,2014,15,0,0,15,100.0
313505,2015,14,0,0,14,100.0
313505,2016,11,0,0,11,100.0
313505,2017,14,0,0,14,100.0
313505,2018,13,0,0,13,100.0
313505,2019,6,0,0,6,100.0
313505,2020,17,0,0,17,100.0
313507,2012,1,0,0,1,100.0
313507,2013,2,0,0,2,100.0
313507,2014,1,0,0,1,100.0
313507,2015,2,0,0,2,100.0
313507,2016,1,0,0,1,100.0
313507,2017,2,0,0,2,100.0
313507,2018,1,0,0,1,100.0
313507,2019,0,1,0,1,100.0
313507,2020,0,1,0,1,100.0
313510,2012,22,1,0,23,100.0
313510,2013,27,0,0,27,100.0
313510,2014,33,0,0,33,100.0
313510,2015,29,0,0,29,100.0
313510,2016,19,0,0,19,100.0
313510,2017,17,0,0,17,100.0
313510,2018,26,0,0,26,100.0
313510,2019,19,0,0,19,100.0
313510,2020,19,0,0,19,100.0
313520,2012,19,0,4,23,82.6086956521739
313520,2013,30,0,0,30,100.0
313520,2014,26,0,0,26,100.0
313520,2015,21,0,1,22,95.45454545454545
313520,2016,20,0,0,20,100.0
313520,2017,19,0,0,19,100.0
313520,2018,25,0,0,25,100.0
313520,2019,23,0,0,23,100.0
313520,2020,17,0,0,17,100.0
313530,2012,2,0,0,2,100.0
313530,2013,2,0,0,2,100.0
313530,2015,1,0,0,1,100.0
313530,2017,2,0,0,2,100.0
313530,2018,1,0,0,1,100.0
313530,2020,1,0,0,1,100.0
313535,2012,4,0,0,4,100.0
313535,2013,1,0,0,1,100.0
313535,2014,2,0,0,2,100.0
313535,2015,2,0,0,2,100.0
313535,2016,4,0,0,4,100.0
313535,2017,4,0,0,4,100.0
313535,2018,4,0,0,4,100.0
313535,2019,5,0,0,5,100.0
313535,2020,3,0,1,4,75.0
313540,2012,3,0,1,4,75.0
313540,2013,4,0,0,4,100.0
313540,2014,2,0,1,3,66.66666666666666
313540,2016,2,0,0,2,100.0
313540,2017,2,0,0,2,100.0
313540,2018,1,0,0,1,100.0
313540,2019,1,0,0,1,100.0
313540,2020,2,0,0,2,100.0
313545,2013,1,0,2,3,33.33333333333333
313545,2015,1,0,1,2,50.0
313545,2016,1,0,0,1,100.0
313545,2017,3,0,0,3,100.0
313545,2018,1,0,0,1,100.0
313545,2019,4,0,0,4,100.0
313545,2020,1,0,0,1,100.0
313550,2012,4,0,0,4,100.0
313550,2013,5,0,0,5,100.0
313550,2014,1,0,0,1,100.0
313550,2015,2,0,0,2,100.0
313550,2016,2,0,1,3,66.66666666666666
313550,2017,3,0,0,3,100.0
313550,2018,6,0,0,6,100.0
313550,2019,5,0,0,5,100.0
313550,2020,3,0,0,3,100.0
313560,2012,1,0,0,1,100.0
313560,2013,6,0,0,6,100.0
313560,2014,4,0,0,4,100.0
313560,2015,3,0,0,3,100.0
313560,2016,5,0,0,5,100.0
313560,2017,1,0,0,1,100.0
313560,2018,3,0,0,3,100.0
313560,2019,2,0,0,2,100.0
313570,2012,1,0,0,1,100.0
313570,2013,1,0,0,1,100.0
313570,2014,1,0,0,1,100.0
313570,2016,2,0,0,2,100.0
313570,2017,2,0,0,2,100.0
313570,2018,2,0,0,2,100.0
313570,2019,1,0,0,1,100.0
313570,2020,1,1,0,2,100.0
313580,2012,9,0,0,9,100.0
313580,2013,8,0,0,8,100.0
313580,2014,13,0,0,13,100.0
313580,2015,6,0,0,6,100.0
313580,2016,15,0,0,15,100.0
313580,2017,11,0,0,11,100.0
313580,2018,9,0,0,9,100.0
313580,2019,9,0,0,9,100.0
313580,2020,1,0,2,3,33.33333333333333
313590,2012,0,0,2,2,0.0
313590,2015,1,0,1,2,50.0
313590,2016,1,0,0,1,100.0
313590,2017,1,0,0,1,100.0
313590,2018,2,0,0,2,100.0
313590,2019,4,0,0,4,100.0
313590,2020,5,0,0,5,100.0
313600,2012,8,0,0,8,100.0
313600,2013,5,0,0,5,100.0
313600,2014,3,0,0,3,100.0
313600,2015,7,0,0,7,100.0
313600,2016,2,0,0,2,100.0
313600,2017,3,0,0,3,100.0
313600,2018,6,0,0,6,100.0
313600,2019,10,0,0,10,100.0
313600,2020,6,0,0,6,100.0
313610,2012,1,0,0,1,100.0
313610,2014,1,0,0,1,100.0
313610,2015,3,0,0,3,100.0
313610,2016,1,0,0,1,100.0
313610,2018,2,0,0,2,100.0
313610,2019,1,0,1,2,50.0
313610,2020,2,0,1,3,66.66666666666666
313620,2012,20,0,1,21,95.23809523809523
313620,2013,22,0,0,22,100.0
313620,2014,24,0,0,24,100.0
313620,2015,28,0,0,28,100.0
313620,2016,24,0,0,24,100.0
313620,2017,19,0,0,19,100.0
313620,2018,19,0,0,19,100.0
313620,2019,18,0,0,18,100.0
313620,2020,23,0,0,23,100.0
313630,2012,19,0,0,19,100.0
313630,2013,19,0,0,19,100.0
313630,2014,24,0,0,24,100.0
313630,2015,16,0,0,16,100.0
313630,2016,23,0,0,23,100.0
313630,2017,21,0,0,21,100.0
313630,2018,18,0,0,18,100.0
313630,2019,19,0,0,19,100.0
313630,2020,17,0,0,17,100.0
313640,2013,1,0,0,1,100.0
313640,2014,2,0,0,2,100.0
313640,2015,1,0,0,1,100.0
313640,2016,3,0,0,3,100.0
313640,2017,1,0,0,1,100.0
313640,2018,1,0,0,1,100.0
313640,2019,1,0,0,1,100.0
313650,2012,3,0,0,3,100.0
313650,2013,3,0,0,3,100.0
313650,2014,1,0,0,1,100.0
313650,2015,4,0,0,4,100.0
313650,2016,2,0,0,2,100.0
313650,2017,6,0,0,6,100.0
313650,2018,5,0,0,5,100.0
313650,2019,3,0,0,3,100.0
313650,2020,2,0,0,2,100.0
313652,2012,2,0,0,2,100.0
313652,2016,2,0,0,2,100.0
313652,2020,1,0,0,1,100.0
313655,2012,3,0,1,4,75.0
313655,2014,1,0,0,1,100.0
313655,2018,2,0,0,2,100.0
313655,2019,2,0,0,2,100.0
313655,2020,1,0,0,1,100.0
313657,2012,2,0,0,2,100.0
313657,2013,4,0,0,4,100.0
313657,2015,2,0,0,2,100.0
313657,2016,2,0,0,2,100.0
313657,2017,2,0,0,2,100.0
313657,2018,1,0,0,1,100.0
313657,2019,4,0,0,4,100.0
313657,2020,5,0,0,5,100.0
313660,2012,0,0,1,1,0.0
313660,2013,3,0,0,3,100.0
313660,2015,1,0,0,1,100.0
313660,2016,3,0,0,3,100.0
313660,2017,2,0,0,2,100.0
313660,2018,2,0,0,2,100.0
313660,2019,2,0,0,2,100.0
313660,2020,4,0,0,4,100.0
313665,2012,0,1,3,4,25.0
313665,2013,0,1,8,9,11.11111111111111
313665,2014,1,0,5,6,16.666666666666664
313665,2015,0,0,6,6,0.0
313665,2016,0,0,14,14,0.0
313665,2017,0,0,6,6,0.0
313665,2018,0,0,6,6,0.0
313665,2019,11,0,0,11,100.0
313665,2020,17,0,0,17,100.0
313670,2012,150,0,0,150,100.0
313670,2013,204,0,0,204,100.0
313670,2014,189,0,0,189,100.0
313670,2015,210,0,0,210,100.0
313670,2016,188,0,0,188,100.0
313670,2017,194,0,0,194,100.0
313670,2018,185,0,0,185,100.0
313670,2019,189,0,1,190,99.47368421052632
313670,2020,200,0,0,200,100.0
313680,2014,1,0,0,1,100.0
313680,2015,3,0,0,3,100.0
313680,2016,2,0,0,2,100.0
313680,2019,1,0,0,1,100.0
313680,2020,1,0,0,1,100.0
313690,2012,2,0,0,2,100.0
313690,2014,7,0,0,7,100.0
313690,2015,1,0,0,1,100.0
313690,2016,2,0,0,2,100.0
313690,2017,3,0,0,3,100.0
313690,2018,4,0,0,4,100.0
313690,2019,1,0,0,1,100.0
313690,2020,1,0,0,1,100.0
313695,2013,1,0,0,1,100.0
313695,2014,1,0,0,1,100.0
313695,2015,2,0,0,2,100.0
313695,2016,0,0,1,1,0.0
313695,2017,0,0,2,2,0.0
313695,2018,0,0,3,3,0.0
313695,2019,0,0,2,2,0.0
313695,2020,0,0,1,1,0.0
313700,2012,5,0,0,5,100.0
313700,2013,8,0,0,8,100.0
313700,2014,4,0,3,7,57.14285714285714
313700,2015,7,0,0,7,100.0
313700,2016,11,0,0,11,100.0
313700,2017,7,0,0,7,100.0
313700,2018,6,0,0,6,100.0
313700,2019,5,0,0,5,100.0
313700,2020,5,0,0,5,100.0
313710,2012,3,0,0,3,100.0
313710,2013,1,0,0,1,100.0
313710,2014,3,0,0,3,100.0
313710,2015,1,0,0,1,100.0
313710,2016,1,0,0,1,100.0
313710,2017,2,0,0,2,100.0
313710,2019,4,0,0,4,100.0
313710,2020,2,0,0,2,100.0
313720,2012,20,0,0,20,100.0
313720,2013,16,0,0,16,100.0
313720,2014,19,0,0,19,100.0
313720,2015,15,0,0,15,100.0
313720,2016,19,0,1,20,95.0
313720,2017,8,0,0,8,100.0
313720,2018,19,0,0,19,100.0
313720,2019,17,0,0,17,100.0
313720,2020,13,0,0,13,100.0
313730,2013,2,0,0,2,100.0
313730,2014,1,0,0,1,100.0
313730,2015,2,0,0,2,100.0
313730,2016,3,0,0,3,100.0
313730,2017,3,0,0,3,100.0
313730,2019,2,0,0,2,100.0
313730,2020,4,0,0,4,100.0
313740,2012,5,0,0,5,100.0
313740,2013,2,0,0,2,100.0
313740,2014,3,0,0,3,100.0
313740,2015,5,0,0,5,100.0
313740,2016,3,0,0,3,100.0
313740,2017,3,0,0,3,100.0
313740,2018,5,0,0,5,100.0
313740,2019,4,0,0,4,100.0
313740,2020,5,0,0,5,100.0
313750,2012,3,0,0,3,100.0
313750,2013,6,0,0,6,100.0
313750,2014,1,2,0,3,100.0
313750,2015,2,0,0,2,100.0
313750,2016,2,0,0,2,100.0
313750,2017,7,0,0,7,100.0
313750,2018,3,0,0,3,100.0
313750,2019,4,0,0,4,100.0
313750,2020,6,0,0,6,100.0
313753,2012,4,0,0,4,100.0
313753,2013,2,0,0,2,100.0
313753,2014,4,0,0,4,100.0
313753,2016,5,0,0,5,100.0
313753,2017,3,0,0,3,100.0
313753,2018,8,0,0,8,100.0
313753,2019,5,0,0,5,100.0
313753,2020,4,0,0,4,100.0
313760,2012,15,0,0,15,100.0
313760,2013,26,0,0,26,100.0
313760,2014,14,0,0,14,100.0
313760,2015,12,0,0,12,100.0
313760,2016,24,0,0,24,100.0
313760,2017,15,0,0,15,100.0
313760,2018,11,0,4,15,73.33333333333333
313760,2019,7,1,3,11,72.72727272727273
313760,2020,21,0,1,22,95.45454545454545
313770,2012,1,0,0,1,100.0
313770,2013,6,1,0,7,100.0
313770,2014,9,0,0,9,100.0
313770,2015,7,0,0,7,100.0
313770,2016,7,0,0,7,100.0
313770,2017,5,0,0,5,100.0
313770,2018,7,0,0,7,100.0
313770,2019,5,0,1,6,83.33333333333334
313770,2020,10,0,0,10,100.0
313780,2012,9,0,3,12,75.0
313780,2013,10,0,0,10,100.0
313780,2014,5,0,0,5,100.0
313780,2015,3,0,0,3,100.0
313780,2016,5,0,0,5,100.0
313780,2017,4,0,0,4,100.0
313780,2018,12,0,0,12,100.0
313780,2019,6,0,0,6,100.0
313780,2020,6,0,0,6,100.0
313790,2013,3,0,0,3,100.0
313790,2014,1,0,1,2,50.0
313790,2015,1,0,0,1,100.0
313790,2016,1,0,0,1,100.0
313790,2017,1,0,0,1,100.0
313790,2019,3,0,0,3,100.0
313800,2012,2,0,0,2,100.0
313800,2013,3,0,0,3,100.0
313800,2015,1,1,0,2,100.0
313800,2017,2,0,0,2,100.0
313800,2018,6,0,0,6,100.0
313800,2019,2,0,0,2,100.0
313800,2020,0,0,1,1,0.0
313810,2012,2,0,0,2,100.0
313810,2013,4,0,0,4,100.0
313810,2014,2,0,0,2,100.0
313810,2015,4,0,0,4,100.0
313810,2016,3,0,0,3,100.0
313810,2017,2,0,0,2,100.0
313810,2018,2,0,0,2,100.0
313810,2019,1,0,0,1,100.0
313810,2020,2,0,0,2,100.0
313820,2012,33,0,0,33,100.0
313820,2013,32,0,0,32,100.0
313820,2014,30,0,0,30,100.0
313820,2015,37,0,1,38,97.36842105263158
313820,2016,35,0,1,36,97.22222222222221
313820,2017,24,0,0,24,100.0
313820,2018,27,0,0,27,100.0
313820,2019,33,0,0,33,100.0
313820,2020,32,0,0,32,100.0
313830,2012,1,0,0,1,100.0
313830,2013,4,0,0,4,100.0
313830,2014,2,0,0,2,100.0
313830,2016,2,0,0,2,100.0
313830,2017,1,0,0,1,100.0
313835,2013,1,0,0,1,100.0
313835,2014,1,0,0,1,100.0
313835,2015,1,0,0,1,100.0
313835,2016,1,0,0,1,100.0
313835,2018,2,0,0,2,100.0
313840,2012,21,0,0,21,100.0
313840,2013,21,0,0,21,100.0
313840,2014,11,1,1,13,92.3076923076923
313840,2015,21,3,3,27,88.88888888888889
313840,2016,19,0,0,19,100.0
313840,2017,14,0,2,16,87.5
313840,2018,6,0,11,17,35.294117647058826
313840,2019,1,2,23,26,11.538461538461538
313840,2020,0,3,16,19,15.789473684210526
313850,2012,0,1,0,1,100.0
313850,2013,0,1,0,1,100.0
313850,2014,0,0,3,3,0.0
313850,2015,1,0,3,4,25.0
313850,2016,2,0,0,2,100.0
313850,2017,5,0,0,5,100.0
313850,2018,1,0,0,1,100.0
313850,2019,5,0,0,5,100.0
313850,2020,2,0,0,2,100.0
313860,2012,5,0,0,5,100.0
313860,2013,10,0,0,10,100.0
313860,2014,5,0,0,5,100.0
313860,2015,6,0,0,6,100.0
313860,2016,7,0,0,7,100.0
313860,2017,6,0,2,8,75.0
313860,2018,1,2,6,9,33.33333333333333
313860,2019,4,0,1,5,80.0
313860,2020,2,1,6,9,33.33333333333333
313862,2012,3,0,0,3,100.0
313862,2013,2,0,0,2,100.0
313862,2014,4,0,0,4,100.0
313862,2015,2,0,0,2,100.0
313862,2016,3,0,0,3,100.0
313862,2017,3,0,0,3,100.0
313862,2018,4,0,0,4,100.0
313862,2019,3,0,0,3,100.0
313862,2020,3,1,0,4,100.0
313865,2013,3,0,0,3,100.0
313865,2014,4,0,0,4,100.0
313865,2015,1,0,0,1,100.0
313865,2016,3,0,0,3,100.0
313865,2017,2,0,0,2,100.0
313865,2018,2,0,0,2,100.0
313865,2019,4,0,0,4,100.0
313865,2020,3,0,0,3,100.0
313867,2013,2,0,0,2,100.0
313867,2014,5,0,0,5,100.0
313867,2015,2,0,0,2,100.0
313867,2017,1,0,0,1,100.0
313867,2019,1,0,1,2,50.0
313867,2020,0,0,1,1,0.0
313868,2012,0,0,2,2,0.0
313868,2014,2,0,0,2,100.0
313868,2015,1,0,0,1,100.0
313868,2016,1,0,0,1,100.0
313868,2017,2,0,0,2,100.0
313868,2018,1,0,2,3,33.33333333333333
313868,2019,0,0,4,4,0.0
313868,2020,2,0,1,3,66.66666666666666
313870,2012,1,0,0,1,100.0
313870,2013,1,0,1,2,50.0
313870,2014,2,0,0,2,100.0
313870,2015,1,0,0,1,100.0
313870,2016,3,0,0,3,100.0
313870,2017,2,0,0,2,100.0
313870,2018,1,0,0,1,100.0
313870,2020,2,0,0,2,100.0
313880,2012,7,0,0,7,100.0
313880,2013,7,0,0,7,100.0
313880,2014,4,0,0,4,100.0
313880,2015,4,0,1,5,80.0
313880,2016,5,0,0,5,100.0
313880,2017,6,0,0,6,100.0
313880,2018,6,0,0,6,100.0
313880,2019,6,0,0,6,100.0
313880,2020,7,0,0,7,100.0
313890,2012,1,0,0,1,100.0
313890,2014,2,0,0,2,100.0
313890,2015,3,0,0,3,100.0
313890,2016,4,0,0,4,100.0
313890,2018,1,0,0,1,100.0
313890,2019,3,0,1,4,75.0
313890,2020,0,0,5,5,0.0
313900,2012,13,0,0,13,100.0
313900,2013,10,0,0,10,100.0
313900,2014,8,0,0,8,100.0
313900,2015,12,0,0,12,100.0
313900,2016,15,0,0,15,100.0
313900,2017,16,0,0,16,100.0
313900,2018,4,0,0,4,100.0
313900,2019,16,0,0,16,100.0
313900,2020,11,0,0,11,100.0
313910,2012,1,0,0,1,100.0
313910,2013,1,0,2,3,33.33333333333333
313910,2014,2,0,0,2,100.0
313910,2015,3,0,0,3,100.0
313910,2016,2,0,0,2,100.0
313910,2017,2,0,0,2,100.0
313910,2018,1,0,0,1,100.0
313910,2019,2,0,1,3,66.66666666666666
313910,2020,0,0,2,2,0.0
313920,2012,7,0,0,7,100.0
313920,2013,4,0,0,4,100.0
313920,2014,7,0,0,7,100.0
313920,2015,6,0,0,6,100.0
313920,2016,9,0,0,9,100.0
313920,2017,8,0,0,8,100.0
313920,2018,14,0,0,14,100.0
313920,2019,2,0,0,2,100.0
313920,2020,9,0,0,9,100.0
313925,2012,1,0,0,1,100.0
313925,2013,2,0,0,2,100.0
313925,2015,1,0,0,1,100.0
313925,2017,3,0,0,3,100.0
313925,2019,2,0,0,2,100.0
313925,2020,2,0,0,2,100.0
313930,2012,12,0,0,12,100.0
313930,2013,12,0,0,12,100.0
313930,2014,5,0,0,5,100.0
313930,2015,8,0,0,8,100.0
313930,2016,4,0,1,5,80.0
313930,2017,7,0,0,7,100.0
313930,2018,8,0,0,8,100.0
313930,2019,7,0,0,7,100.0
313930,2020,6,0,0,6,100.0
313940,2012,35,0,0,35,100.0
313940,2013,29,0,0,29,100.0
313940,2014,19,0,0,19,100.0
313940,2015,24,0,0,24,100.0
313940,2016,27,0,0,27,100.0
313940,2017,31,0,1,32,96.875
313940,2018,30,0,0,30,100.0
313940,2019,34,0,0,34,100.0
313940,2020,25,0,0,25,100.0
313950,2012,11,0,0,11,100.0
313950,2013,11,0,0,11,100.0
313950,2014,11,0,1,12,91.66666666666666
313950,2015,15,0,0,15,100.0
313950,2016,7,0,0,7,100.0
313950,2017,6,0,0,6,100.0
313950,2018,9,0,0,9,100.0
313950,2019,10,0,0,10,100.0
313950,2020,5,0,2,7,71.42857142857143
313960,2012,11,0,0,11,100.0
313960,2013,6,0,0,6,100.0
313960,2014,11,0,0,11,100.0
313960,2015,9,0,0,9,100.0
313960,2016,9,0,0,9,100.0
313960,2017,10,0,0,10,100.0
313960,2018,9,0,0,9,100.0
313960,2019,2,1,0,3,100.0
313960,2020,15,1,0,16,100.0
313970,2012,4,0,0,4,100.0
313970,2013,5,0,0,5,100.0
313970,2014,2,0,1,3,66.66666666666666
313970,2015,1,0,1,2,50.0
313970,2016,2,0,0,2,100.0
313970,2017,1,0,0,1,100.0
313970,2018,2,0,0,2,100.0
313970,2019,4,0,0,4,100.0
313970,2020,4,0,0,4,100.0
313980,2012,0,2,3,5,40.0
313980,2013,8,0,0,8,100.0
313980,2014,3,0,0,3,100.0
313980,2015,2,0,0,2,100.0
313980,2016,2,0,0,2,100.0
313980,2017,3,0,0,3,100.0
313980,2018,4,0,0,4,100.0
313980,2019,3,0,0,3,100.0
313980,2020,2,0,1,3,66.66666666666666
313990,2012,4,0,0,4,100.0
313990,2013,6,0,0,6,100.0
313990,2014,3,0,0,3,100.0
313990,2015,4,0,0,4,100.0
313990,2016,7,0,0,7,100.0
313990,2017,3,0,0,3,100.0
313990,2018,3,0,0,3,100.0
313990,2019,2,0,0,2,100.0
313990,2020,3,0,0,3,100.0
314000,2012,13,1,1,15,93.33333333333333
314000,2013,24,0,1,25,96.0
314000,2014,8,2,1,11,90.9090909090909
314000,2015,14,0,3,17,82.35294117647058
314000,2016,24,0,3,27,88.88888888888889
314000,2017,19,0,2,21,90.47619047619048
314000,2018,15,0,3,18,83.33333333333334
314000,2019,26,0,0,26,100.0
314000,2020,15,0,5,20,75.0
314010,2013,1,0,0,1,100.0
314010,2014,4,0,0,4,100.0
314010,2015,2,0,0,2,100.0
314010,2016,0,0,2,2,0.0
314010,2018,5,0,0,5,100.0
314010,2019,2,0,0,2,100.0
314010,2020,0,2,0,2,100.0
314015,2012,2,1,3,6,50.0
314015,2013,6,0,0,6,100.0
314015,2014,10,0,0,10,100.0
314015,2015,2,0,0,2,100.0
314015,2016,9,0,0,9,100.0
314015,2017,5,0,0,5,100.0
314015,2018,1,0,0,1,100.0
314015,2019,8,0,0,8,100.0
314015,2020,4,0,0,4,100.0
314020,2013,1,0,0,1,100.0
314020,2017,1,0,0,1,100.0
314020,2019,2,0,0,2,100.0
314020,2020,1,0,1,2,50.0
314030,2013,2,0,0,2,100.0
314030,2014,2,0,0,2,100.0
314030,2015,1,0,0,1,100.0
314030,2016,2,0,0,2,100.0
314030,2018,3,0,0,3,100.0
314030,2019,1,0,0,1,100.0
314030,2020,3,0,0,3,100.0
314040,2013,1,0,0,1,100.0
314040,2015,1,0,0,1,100.0
314040,2016,1,0,0,1,100.0
314040,2019,0,1,1,2,50.0
314040,2020,1,0,0,1,100.0
314050,2012,6,0,0,6,100.0
314050,2013,1,0,0,1,100.0
314050,2014,6,0,1,7,85.71428571428571
314050,2015,4,0,0,4,100.0
314050,2016,4,0,0,4,100.0
314050,2017,4,0,0,4,100.0
314050,2019,3,0,0,3,100.0
314050,2020,2,0,0,2,100.0
314053,2012,2,0,0,2,100.0
314053,2013,2,0,0,2,100.0
314053,2014,4,0,0,4,100.0
314053,2015,2,0,0,2,100.0
314053,2016,4,1,0,5,100.0
314053,2017,3,0,0,3,100.0
314053,2018,2,0,0,2,100.0
314053,2019,0,0,3,3,0.0
314053,2020,0,2,2,4,50.0
314055,2012,1,0,0,1,100.0
314055,2013,3,0,0,3,100.0
314055,2014,3,0,1,4,75.0
314055,2015,4,0,1,5,80.0
314055,2016,6,0,2,8,75.0
314055,2017,4,0,0,4,100.0
314055,2018,1,0,0,1,100.0
314055,2019,0,0,1,1,0.0
314055,2020,1,0,1,2,50.0
314060,2012,2,0,0,2,100.0
314060,2014,1,0,0,1,100.0
314060,2016,1,0,0,1,100.0
314060,2017,1,0,0,1,100.0
314060,2018,3,0,0,3,100.0
314060,2019,3,0,0,3,100.0
314060,2020,1,0,1,2,50.0
314070,2012,17,0,0,17,100.0
314070,2013,14,0,0,14,100.0
314070,2014,13,0,0,13,100.0
314070,2015,11,0,0,11,100.0
314070,2016,17,0,0,17,100.0
314070,2017,14,1,0,15,100.0
314070,2018,10,0,0,10,100.0
314070,2019,5,0,0,5,100.0
314070,2020,11,0,0,11,100.0
314080,2012,3,0,0,3,100.0
314080,2013,8,0,0,8,100.0
314080,2014,5,0,0,5,100.0
314080,2015,3,0,0,3,100.0
314080,2016,5,0,0,5,100.0
314080,2017,3,0,0,3,100.0
314080,2018,7,0,0,7,100.0
314080,2019,6,0,0,6,100.0
314080,2020,3,0,0,3,100.0
314085,2012,4,0,0,4,100.0
314085,2013,2,0,0,2,100.0
314085,2014,6,0,1,7,85.71428571428571
314085,2015,3,0,0,3,100.0
314085,2016,5,0,0,5,100.0
314085,2017,3,0,0,3,100.0
314085,2018,4,0,0,4,100.0
314085,2019,1,0,0,1,100.0
314085,2020,2,0,0,2,100.0
314090,2012,16,0,1,17,94.11764705882352
314090,2013,9,0,0,9,100.0
314090,2014,11,0,0,11,100.0
314090,2015,8,0,0,8,100.0
314090,2016,5,0,0,5,100.0
314090,2017,13,0,1,14,92.85714285714286
314090,2018,4,0,0,4,100.0
314090,2019,2,0,1,3,66.66666666666666
314090,2020,1,2,2,5,60.0
314100,2012,6,0,0,6,100.0
314100,2013,9,0,0,9,100.0
314100,2014,5,0,0,5,100.0
314100,2015,2,0,0,2,100.0
314100,2016,5,0,0,5,100.0
314100,2017,5,0,0,5,100.0
314100,2018,3,0,0,3,100.0
314100,2019,6,0,0,6,100.0
314100,2020,4,0,0,4,100.0
314110,2012,19,0,0,19,100.0
314110,2013,10,0,0,10,100.0
314110,2014,19,0,0,19,100.0
314110,2015,6,0,0,6,100.0
314110,2016,16,0,0,16,100.0
314110,2017,19,0,0,19,100.0
314110,2018,12,0,0,12,100.0
314110,2019,19,0,0,19,100.0
314110,2020,10,0,0,10,100.0
314120,2014,1,0,0,1,100.0
314120,2015,2,0,0,2,100.0
314120,2017,1,0,0,1,100.0
314130,2012,2,0,0,2,100.0
314130,2013,0,0,1,1,0.0
314130,2018,1,0,0,1,100.0
314130,2019,2,0,0,2,100.0
314140,2012,4,0,0,4,100.0
314140,2013,9,0,0,9,100.0
314140,2014,10,0,0,10,100.0
314140,2015,12,0,0,12,100.0
314140,2016,11,0,0,11,100.0
314140,2017,2,0,0,2,100.0
314140,2018,8,0,1,9,88.88888888888889
314140,2019,6,0,1,7,85.71428571428571
314140,2020,5,0,3,8,62.5
314150,2012,0,0,1,1,0.0
314150,2014,3,0,0,3,100.0
314150,2015,2,0,0,2,100.0
314150,2016,1,0,0,1,100.0
314150,2017,3,0,0,3,100.0
314150,2018,5,0,0,5,100.0
314150,2019,1,0,0,1,100.0
314150,2020,4,0,0,4,100.0
314160,2012,2,0,0,2,100.0
314160,2013,3,0,0,3,100.0
314160,2014,2,0,0,2,100.0
314160,2015,4,0,0,4,100.0
314160,2016,5,0,0,5,100.0
314160,2017,3,0,0,3,100.0
314160,2018,4,0,0,4,100.0
314160,2019,5,0,0,5,100.0
314160,2020,4,0,0,4,100.0
314170,2012,3,0,0,3,100.0
314170,2013,4,0,0,4,100.0
314170,2014,2,0,0,2,100.0
314170,2015,1,0,0,1,100.0
314170,2016,2,0,0,2,100.0
314170,2017,5,0,0,5,100.0
314170,2018,2,0,0,2,100.0
314170,2019,1,0,0,1,100.0
314170,2020,1,0,0,1,100.0
314180,2012,7,0,0,7,100.0
314180,2013,12,0,0,12,100.0
314180,2014,4,0,0,4,100.0
314180,2015,10,0,0,10,100.0
314180,2016,7,0,4,11,63.63636363636363
314180,2017,4,0,0,4,100.0
314180,2018,6,0,0,6,100.0
314180,2019,9,0,0,9,100.0
314180,2020,4,0,0,4,100.0
314190,2012,2,0,1,3,66.66666666666666
314190,2014,1,0,1,2,50.0
314190,2015,2,0,0,2,100.0
314190,2017,2,0,0,2,100.0
314190,2019,1,0,0,1,100.0
314190,2020,0,0,1,1,0.0
314200,2012,2,0,1,3,66.66666666666666
314200,2013,5,0,0,5,100.0
314200,2014,4,0,0,4,100.0
314200,2015,8,0,0,8,100.0
314200,2016,5,0,0,5,100.0
314200,2017,3,0,0,3,100.0
314200,2018,11,0,0,11,100.0
314200,2019,7,0,0,7,100.0
314200,2020,3,0,0,3,100.0
314210,2012,2,0,0,2,100.0
314210,2013,2,0,0,2,100.0
314210,2014,2,0,2,4,50.0
314210,2015,0,0,1,1,0.0
314210,2016,2,0,0,2,100.0
314210,2017,5,0,1,6,83.33333333333334
314210,2018,3,0,0,3,100.0
314210,2019,2,0,0,2,100.0
314210,2020,4,0,1,5,80.0
314220,2012,7,0,0,7,100.0
314220,2013,5,0,0,5,100.0
314220,2014,1,0,0,1,100.0
314220,2015,5,0,0,5,100.0
314220,2016,1,0,0,1,100.0
314220,2017,3,0,0,3,100.0
314220,2018,4,0,0,4,100.0
314220,2020,5,0,0,5,100.0
314225,2012,2,0,0,2,100.0
314225,2013,2,0,0,2,100.0
314225,2014,2,0,0,2,100.0
314225,2015,2,0,0,2,100.0
314225,2016,2,0,0,2,100.0
314225,2017,2,0,0,2,100.0
314225,2018,2,0,0,2,100.0
314225,2020,0,0,1,1,0.0
314230,2014,1,0,0,1,100.0
314230,2017,2,0,0,2,100.0
314230,2018,1,0,0,1,100.0
314230,2019,1,0,0,1,100.0
314230,2020,1,1,0,2,100.0
314240,2012,1,0,0,1,100.0
314240,2013,1,0,1,2,50.0
314240,2014,3,0,0,3,100.0
314240,2015,4,0,0,4,100.0
314240,2016,1,0,0,1,100.0
314240,2017,3,0,0,3,100.0
314240,2018,2,0,0,2,100.0
314240,2019,2,0,0,2,100.0
314240,2020,2,0,0,2,100.0
314250,2012,2,0,0,2,100.0
314250,2013,2,0,0,2,100.0
314250,2017,2,0,0,2,100.0
314250,2018,3,0,0,3,100.0
314260,2012,4,0,0,4,100.0
314260,2013,2,0,0,2,100.0
314260,2014,2,0,0,2,100.0
314260,2015,2,0,0,2,100.0
314260,2016,6,0,0,6,100.0
314260,2017,2,0,0,2,100.0
314260,2018,2,0,0,2,100.0
314260,2019,3,0,0,3,100.0
314270,2012,6,0,0,6,100.0
314270,2013,3,0,0,3,100.0
314270,2014,6,0,0,6,100.0
314270,2015,8,0,0,8,100.0
314270,2016,4,0,0,4,100.0
314270,2017,5,0,0,5,100.0
314270,2019,2,0,0,2,100.0
314270,2020,8,0,0,8,100.0
314280,2012,5,0,0,5,100.0
314280,2013,7,0,0,7,100.0
314280,2014,5,0,0,5,100.0
314280,2015,6,0,0,6,100.0
314280,2016,7,0,0,7,100.0
314280,2017,5,0,0,5,100.0
314280,2018,10,0,0,10,100.0
314280,2019,9,0,0,9,100.0
314280,2020,4,1,5,10,50.0
314290,2012,6,0,0,6,100.0
314290,2013,9,0,0,9,100.0
314290,2014,5,0,0,5,100.0
314290,2015,3,0,0,3,100.0
314290,2016,6,0,0,6,100.0
314290,2017,8,0,0,8,100.0
314290,2018,7,0,0,7,100.0
314290,2019,8,0,1,9,88.88888888888889
314290,2020,9,0,0,9,100.0
314300,2012,3,0,0,3,100.0
314300,2013,6,0,0,6,100.0
314300,2014,4,0,0,4,100.0
314300,2015,4,0,0,4,100.0
314300,2016,3,0,0,3,100.0
314300,2017,6,0,0,6,100.0
314300,2018,2,0,0,2,100.0
314300,2019,7,0,0,7,100.0
314300,2020,4,0,0,4,100.0
314310,2012,12,0,0,12,100.0
314310,2013,20,0,0,20,100.0
314310,2014,20,0,0,20,100.0
314310,2015,13,0,0,13,100.0
314310,2016,17,0,1,18,94.44444444444444
314310,2017,15,0,0,15,100.0
314310,2018,15,0,0,15,100.0
314310,2019,11,0,0,11,100.0
314310,2020,14,0,0,14,100.0
314315,2012,4,0,0,4,100.0
314315,2013,2,0,0,2,100.0
314315,2015,2,0,0,2,100.0
314315,2016,2,0,0,2,100.0
314315,2018,4,0,0,4,100.0
314315,2019,5,0,0,5,100.0
314315,2020,1,0,1,2,50.0
314320,2012,9,0,0,9,100.0
314320,2013,3,0,0,3,100.0
314320,2014,6,0,0,6,100.0
314320,2015,4,0,0,4,100.0
314320,2016,4,0,0,4,100.0
314320,2017,3,0,0,3,100.0
314320,2018,9,0,0,9,100.0
314320,2019,9,0,0,9,100.0
314320,2020,8,0,0,8,100.0
314330,2012,118,0,1,119,99.15966386554622
314330,2013,126,0,0,126,100.0
314330,2014,112,0,0,112,100.0
314330,2015,133,1,2,136,98.52941176470588
314330,2016,127,0,0,127,100.0
314330,2017,105,0,0,105,100.0
314330,2018,111,0,2,113,98.23008849557522
314330,2019,103,0,0,103,100.0
314330,2020,109,0,0,109,100.0
314340,2012,3,0,0,3,100.0
314340,2013,1,0,0,1,100.0
314340,2014,3,0,0,3,100.0
314340,2015,2,0,0,2,100.0
314340,2016,4,0,0,4,100.0
314340,2017,7,0,0,7,100.0
314340,2018,3,0,0,3,100.0
314340,2019,5,0,0,5,100.0
314340,2020,5,0,0,5,100.0
314345,2012,4,0,0,4,100.0
314345,2013,3,0,0,3,100.0
314345,2015,2,0,0,2,100.0
314345,2016,2,0,0,2,100.0
314345,2017,3,0,0,3,100.0
314345,2018,2,0,0,2,100.0
314345,2019,3,0,0,3,100.0
314345,2020,1,0,0,1,100.0
314350,2013,5,0,0,5,100.0
314350,2014,2,0,0,2,100.0
314350,2015,5,0,0,5,100.0
314350,2017,3,0,0,3,100.0
314350,2018,2,0,0,2,100.0
314350,2019,3,0,0,3,100.0
314350,2020,3,0,0,3,100.0
314360,2012,1,0,0,1,100.0
314360,2013,1,0,0,1,100.0
314360,2015,3,0,0,3,100.0
314360,2016,1,0,0,1,100.0
314360,2020,1,0,0,1,100.0
314370,2014,1,0,0,1,100.0
314370,2015,1,0,0,1,100.0
314370,2016,1,0,0,1,100.0
314370,2017,1,1,0,2,100.0
314370,2018,1,1,0,2,100.0
314370,2019,1,0,0,1,100.0
314370,2020,1,0,0,1,100.0
314380,2012,1,0,0,1,100.0
314380,2013,4,0,0,4,100.0
314380,2014,3,0,0,3,100.0
314380,2015,3,0,0,3,100.0
314380,2016,1,0,0,1,100.0
314380,2017,5,0,0,5,100.0
314380,2018,1,0,0,1,100.0
314380,2019,1,0,0,1,100.0
314380,2020,1,0,0,1,100.0
314390,2012,47,2,2,51,96.07843137254902
314390,2013,24,1,0,25,100.0
314390,2014,31,0,0,31,100.0
314390,2015,31,3,1,35,97.14285714285714
314390,2016,27,0,0,27,100.0
314390,2017,40,0,1,41,97.5609756097561
314390,2018,25,0,0,25,100.0
314390,2019,34,0,0,34,100.0
314390,2020,38,0,0,38,100.0
314400,2012,12,0,1,13,92.3076923076923
314400,2013,3,0,0,3,100.0
314400,2014,6,0,0,6,100.0
314400,2015,9,0,0,9,100.0
314400,2016,9,0,0,9,100.0
314400,2017,9,0,0,9,100.0
314400,2018,6,0,0,6,100.0
314400,2019,7,0,0,7,100.0
314400,2020,10,0,0,10,100.0
314410,2012,6,0,0,6,100.0
314410,2013,13,0,0,13,100.0
314410,2014,6,0,0,6,100.0
314410,2015,4,0,0,4,100.0
314410,2016,5,0,0,5,100.0
314410,2017,11,0,1,12,91.66666666666666
314410,2018,6,0,0,6,100.0
314410,2019,3,0,0,3,100.0
314410,2020,4,0,0,4,100.0
314420,2013,1,0,0,1,100.0
314420,2014,2,0,0,2,100.0
314420,2015,2,0,0,2,100.0
314420,2019,0,0,1,1,0.0
314430,2012,18,0,0,18,100.0
314430,2013,14,0,0,14,100.0
314430,2014,14,0,0,14,100.0
314430,2015,14,0,0,14,100.0
314430,2016,12,0,0,12,100.0
314430,2017,15,0,2,17,88.23529411764706
314430,2018,14,0,0,14,100.0
314430,2019,10,0,0,10,100.0
314430,2020,5,0,5,10,50.0
314435,2013,6,0,0,6,100.0
314435,2014,2,0,0,2,100.0
314435,2015,3,0,0,3,100.0
314435,2017,2,0,0,2,100.0
314435,2018,1,0,1,2,50.0
314435,2019,0,0,1,1,0.0
314435,2020,1,0,0,1,100.0
314437,2012,3,0,0,3,100.0
314437,2013,1,0,0,1,100.0
314437,2014,4,0,0,4,100.0
314437,2015,3,0,0,3,100.0
314437,2016,1,0,0,1,100.0
314437,2017,1,0,0,1,100.0
314437,2018,1,0,0,1,100.0
314437,2019,3,0,0,3,100.0
314440,2013,1,0,0,1,100.0
314440,2015,2,0,0,2,100.0
314440,2016,2,0,0,2,100.0
314440,2017,1,0,0,1,100.0
314440,2018,1,0,0,1,100.0
314440,2019,2,0,0,2,100.0
314440,2020,2,0,0,2,100.0
314450,2012,3,0,0,3,100.0
314450,2013,2,0,0,2,100.0
314450,2014,6,0,0,6,100.0
314450,2015,2,0,0,2,100.0
314450,2016,2,0,0,2,100.0
314450,2017,3,0,0,3,100.0
314450,2018,5,0,1,6,83.33333333333334
314450,2019,1,0,0,1,100.0
314450,2020,2,0,0,2,100.0
314460,2012,5,0,1,6,83.33333333333334
314460,2013,12,0,1,13,92.3076923076923
314460,2014,10,0,0,10,100.0
314460,2015,14,0,0,14,100.0
314460,2016,9,0,1,10,90.0
314460,2017,6,0,0,6,100.0
314460,2018,6,0,0,6,100.0
314460,2019,10,0,0,10,100.0
314460,2020,8,0,0,8,100.0
314465,2012,5,0,0,5,100.0
314465,2013,1,0,0,1,100.0
314465,2014,1,0,0,1,100.0
314465,2015,1,0,0,1,100.0
314465,2016,3,0,0,3,100.0
314465,2017,6,0,0,6,100.0
314465,2018,2,0,0,2,100.0
314465,2019,4,0,0,4,100.0
314465,2020,3,0,0,3,100.0
314467,2012,2,0,0,2,100.0
314467,2013,1,0,0,1,100.0
314467,2014,1,0,0,1,100.0
314467,2017,2,0,0,2,100.0
314467,2019,1,0,0,1,100.0
314467,2020,1,0,0,1,100.0
314470,2012,5,0,0,5,100.0
314470,2013,4,0,0,4,100.0
314470,2014,6,0,0,6,100.0
314470,2015,6,0,0,6,100.0
314470,2016,5,0,0,5,100.0
314470,2017,4,0,0,4,100.0
314470,2018,5,0,0,5,100.0
314470,2019,5,0,0,5,100.0
314470,2020,4,0,1,5,80.0
314480,2012,25,0,1,26,96.15384615384616
314480,2013,24,0,1,25,96.0
314480,2014,21,0,0,21,100.0
314480,2015,20,0,0,20,100.0
314480,2016,27,0,0,27,100.0
314480,2017,32,0,0,32,100.0
314480,2018,37,0,0,37,100.0
314480,2019,34,0,0,34,100.0
314480,2020,37,0,0,37,100.0
314490,2013,1,0,0,1,100.0
314490,2015,1,0,0,1,100.0
314490,2016,1,0,0,1,100.0
314490,2017,2,0,0,2,100.0
314490,2018,2,0,0,2,100.0
314490,2019,2,0,0,2,100.0
314490,2020,0,0,2,2,0.0
314500,2012,3,0,0,3,100.0
314500,2013,4,0,0,4,100.0
314500,2014,7,0,0,7,100.0
314500,2015,3,0,0,3,100.0
314500,2016,5,0,1,6,83.33333333333334
314500,2017,4,0,0,4,100.0
314500,2018,1,0,0,1,100.0
314500,2019,6,0,0,6,100.0
314500,2020,4,0,0,4,100.0
314505,2012,4,0,0,4,100.0
314505,2013,3,0,0,3,100.0
314505,2014,1,0,0,1,100.0
314505,2015,2,0,0,2,100.0
314505,2016,2,0,0,2,100.0
314505,2017,6,0,0,6,100.0
314505,2018,7,0,0,7,100.0
314505,2019,3,0,0,3,100.0
314505,2020,2,0,0,2,100.0
314510,2012,2,0,0,2,100.0
314510,2013,3,0,0,3,100.0
314510,2014,4,1,0,5,100.0
314510,2015,4,0,0,4,100.0
314510,2016,4,0,0,4,100.0
314510,2017,5,0,0,5,100.0
314510,2018,3,0,0,3,100.0
314510,2019,5,0,0,5,100.0
314510,2020,2,0,0,2,100.0
314520,2012,22,0,0,22,100.0
314520,2013,22,0,10,32,68.75
314520,2014,19,0,0,19,100.0
314520,2015,28,0,0,28,100.0
314520,2016,26,0,0,26,100.0
314520,2017,28,0,0,28,100.0
314520,2018,29,0,0,29,100.0
314520,2019,29,0,4,33,87.87878787878788
314520,2020,21,0,0,21,100.0
314530,2012,5,0,4,9,55.55555555555556
314530,2013,16,0,0,16,100.0
314530,2014,8,0,0,8,100.0
314530,2015,16,0,0,16,100.0
314530,2016,14,0,0,14,100.0
314530,2017,14,0,0,14,100.0
314530,2018,11,0,0,11,100.0
314530,2019,11,0,0,11,100.0
314530,2020,14,0,0,14,100.0
314535,2012,4,0,0,4,100.0
314535,2013,6,0,1,7,85.71428571428571
314535,2014,1,0,1,2,50.0
314535,2015,3,0,0,3,100.0
314535,2016,5,0,0,5,100.0
314535,2017,3,0,0,3,100.0
314535,2018,2,0,0,2,100.0
314535,2019,5,0,0,5,100.0
314535,2020,2,0,1,3,66.66666666666666
314537,2012,1,0,0,1,100.0
314537,2013,2,0,0,2,100.0
314537,2014,1,0,0,1,100.0
314537,2015,1,0,0,1,100.0
314537,2017,3,0,0,3,100.0
314537,2018,1,0,0,1,100.0
314537,2019,2,0,0,2,100.0
314537,2020,3,0,0,3,100.0
314540,2012,1,0,0,1,100.0
314540,2015,1,0,0,1,100.0
314540,2018,0,0,1,1,0.0
314540,2019,0,0,2,2,0.0
314540,2020,0,1,1,2,50.0
314545,2012,3,0,0,3,100.0
314545,2013,3,0,0,3,100.0
314545,2014,2,0,0,2,100.0
314545,2015,2,0,0,2,100.0
314545,2016,2,0,0,2,100.0
314545,2018,1,0,0,1,100.0
314545,2019,3,0,0,3,100.0
314545,2020,2,0,0,2,100.0
314550,2013,1,0,0,1,100.0
314550,2014,2,0,0,2,100.0
314550,2015,1,0,0,1,100.0
314550,2016,2,0,0,2,100.0
314550,2017,0,1,0,1,100.0
314550,2018,1,0,0,1,100.0
314550,2020,1,0,0,1,100.0
314560,2012,16,0,0,16,100.0
314560,2013,21,0,0,21,100.0
314560,2014,10,0,0,10,100.0
314560,2015,10,0,0,10,100.0
314560,2016,12,0,0,12,100.0
314560,2017,16,0,0,16,100.0
314560,2018,12,0,0,12,100.0
314560,2019,11,0,0,11,100.0
314560,2020,15,0,0,15,100.0
314570,2016,1,0,0,1,100.0
314570,2018,1,0,0,1,100.0
314570,2019,1,0,0,1,100.0
314580,2012,1,0,0,1,100.0
314580,2013,2,0,0,2,100.0
314580,2014,2,0,0,2,100.0
314580,2015,1,0,0,1,100.0
314580,2016,1,1,0,2,100.0
314580,2017,2,0,0,2,100.0
314580,2019,2,0,0,2,100.0
314585,2012,1,0,0,1,100.0
314585,2013,3,0,0,3,100.0
314585,2014,3,0,0,3,100.0
314585,2015,1,0,0,1,100.0
314585,2016,2,0,0,2,100.0
314585,2017,1,0,1,2,50.0
314585,2018,1,0,0,1,100.0
314585,2019,2,0,0,2,100.0
314585,2020,2,0,0,2,100.0
314587,2012,3,0,0,3,100.0
314587,2013,2,0,0,2,100.0
314587,2014,1,0,0,1,100.0
314587,2015,2,0,0,2,100.0
314587,2016,1,0,1,2,50.0
314587,2017,2,0,0,2,100.0
314587,2018,3,0,0,3,100.0
314587,2020,4,0,1,5,80.0
314590,2012,8,0,0,8,100.0
314590,2013,18,0,1,19,94.73684210526315
314590,2014,6,0,0,6,100.0
314590,2015,12,0,0,12,100.0
314590,2016,9,0,0,9,100.0
314590,2017,13,0,0,13,100.0
314590,2018,9,0,0,9,100.0
314590,2019,10,0,0,10,100.0
314590,2020,16,0,0,16,100.0
314600,2012,6,0,0,6,100.0
314600,2013,9,0,0,9,100.0
314600,2014,14,0,0,14,100.0
314600,2015,4,0,0,4,100.0
314600,2016,1,0,0,1,100.0
314600,2017,4,0,0,4,100.0
314600,2018,11,0,0,11,100.0
314600,2019,8,0,0,8,100.0
314600,2020,6,0,0,6,100.0
314610,2012,29,0,1,30,96.66666666666667
314610,2013,32,0,0,32,100.0
314610,2014,21,0,10,31,67.74193548387096
314610,2015,12,0,1,13,92.3076923076923
314610,2016,11,1,15,27,44.44444444444444
314610,2017,11,7,6,24,75.0
314610,2018,18,1,4,23,82.6086956521739
314610,2019,13,1,3,17,82.35294117647058
314610,2020,9,9,8,26,69.23076923076923
314620,2012,4,0,0,4,100.0
314620,2013,2,0,0,2,100.0
314620,2014,0,0,1,1,0.0
314620,2015,2,0,0,2,100.0
314620,2016,2,0,1,3,66.66666666666666
314620,2017,1,0,0,1,100.0
314620,2018,1,0,0,1,100.0
314620,2019,2,0,0,2,100.0
314620,2020,1,0,0,1,100.0
314625,2012,1,0,0,1,100.0
314625,2013,3,0,1,4,75.0
314625,2014,2,0,0,2,100.0
314625,2015,2,0,0,2,100.0
314625,2016,2,0,0,2,100.0
314625,2017,3,0,0,3,100.0
314625,2018,2,0,0,2,100.0
314625,2019,2,0,0,2,100.0
314625,2020,1,0,0,1,100.0
314630,2012,13,0,0,13,100.0
314630,2013,9,0,1,10,90.0
314630,2014,15,0,0,15,100.0
314630,2015,7,0,0,7,100.0
314630,2016,8,0,0,8,100.0
314630,2017,7,0,0,7,100.0
314630,2018,7,0,0,7,100.0
314630,2019,8,0,0,8,100.0
314630,2020,9,0,0,9,100.0
314640,2013,2,0,0,2,100.0
314640,2014,3,0,0,3,100.0
314640,2015,3,0,0,3,100.0
314640,2016,1,0,0,1,100.0
314640,2017,2,0,0,2,100.0
314640,2019,4,0,0,4,100.0
314640,2020,1,0,0,1,100.0
314650,2012,4,0,0,4,100.0
314650,2013,3,0,0,3,100.0
314650,2014,1,0,0,1,100.0
314650,2015,2,0,0,2,100.0
314650,2016,2,0,0,2,100.0
314650,2017,1,0,0,1,100.0
314650,2018,1,0,0,1,100.0
314650,2019,2,0,0,2,100.0
314650,2020,3,0,0,3,100.0
314655,2012,2,0,0,2,100.0
314655,2013,1,0,0,1,100.0
314655,2014,2,0,0,2,100.0
314655,2015,1,0,0,1,100.0
314655,2016,4,0,0,4,100.0
314655,2017,3,0,0,3,100.0
314655,2018,1,0,0,1,100.0
314655,2019,4,0,0,4,100.0
314660,2015,2,0,0,2,100.0
314660,2017,1,0,1,2,50.0
314670,2012,2,0,0,2,100.0
314670,2013,2,0,0,2,100.0
314670,2015,2,0,0,2,100.0
314670,2016,0,1,2,3,33.33333333333333
314670,2017,3,0,0,3,100.0
314670,2018,1,0,0,1,100.0
314670,2019,2,0,0,2,100.0
314670,2020,1,0,0,1,100.0
314675,2012,3,0,0,3,100.0
314675,2013,4,0,0,4,100.0
314675,2014,2,0,2,4,50.0
314675,2015,3,0,0,3,100.0
314675,2017,0,0,1,1,0.0
314675,2018,4,0,0,4,100.0
314675,2019,1,0,1,2,50.0
314675,2020,0,0,1,1,0.0
314690,2012,8,0,0,8,100.0
314690,2013,5,0,0,5,100.0
314690,2014,4,0,0,4,100.0
314690,2015,6,0,0,6,100.0
314690,2016,9,0,0,9,100.0
314690,2017,5,0,1,6,83.33333333333334
314690,2018,10,0,0,10,100.0
314690,2019,5,0,0,5,100.0
314690,2020,6,0,0,6,100.0
314700,2012,39,0,0,39,100.0
314700,2013,34,0,0,34,100.0
314700,2014,32,0,1,33,96.96969696969697
314700,2015,35,0,0,35,100.0
314700,2016,30,0,0,30,100.0
314700,2017,35,0,1,36,97.22222222222221
314700,2018,37,0,0,37,100.0
314700,2019,32,0,0,32,100.0
314700,2020,23,0,0,23,100.0
314710,2012,34,0,0,34,100.0
314710,2013,31,2,3,36,91.66666666666666
314710,2014,28,0,0,28,100.0
314710,2015,26,0,0,26,100.0
314710,2016,27,0,0,27,100.0
314710,2017,33,0,0,33,100.0
314710,2018,28,0,0,28,100.0
314710,2019,27,0,0,27,100.0
314710,2020,30,0,0,30,100.0
314720,2012,5,0,0,5,100.0
314720,2013,10,0,0,10,100.0
314720,2014,12,0,0,12,100.0
314720,2015,5,0,0,5,100.0
314720,2016,4,0,0,4,100.0
314720,2017,7,0,0,7,100.0
314720,2018,5,0,0,5,100.0
314720,2019,8,0,0,8,100.0
314720,2020,7,0,0,7,100.0
314730,2012,9,0,0,9,100.0
314730,2013,8,0,0,8,100.0
314730,2014,4,0,0,4,100.0
314730,2015,4,0,0,4,100.0
314730,2016,6,0,0,6,100.0
314730,2017,6,0,0,6,100.0
314730,2018,5,0,0,5,100.0
314730,2019,2,0,0,2,100.0
314730,2020,4,0,0,4,100.0
314740,2012,5,0,1,6,83.33333333333334
314740,2013,4,0,0,4,100.0
314740,2014,12,0,0,12,100.0
314740,2015,4,0,0,4,100.0
314740,2016,8,0,0,8,100.0
314740,2017,9,0,0,9,100.0
314740,2018,7,0,0,7,100.0
314740,2019,8,0,0,8,100.0
314740,2020,10,0,0,10,100.0
314750,2013,1,0,1,2,50.0
314750,2016,2,0,0,2,100.0
314750,2017,0,1,1,2,50.0
314750,2018,0,0,1,1,0.0
314750,2020,0,0,1,1,0.0
314760,2012,6,0,1,7,85.71428571428571
314760,2013,6,0,0,6,100.0
314760,2014,5,0,0,5,100.0
314760,2015,6,0,0,6,100.0
314760,2016,7,0,1,8,87.5
314760,2017,4,0,0,4,100.0
314760,2018,6,0,0,6,100.0
314760,2019,3,0,0,3,100.0
314760,2020,2,0,0,2,100.0
314770,2012,2,0,0,2,100.0
314770,2013,3,0,0,3,100.0
314770,2014,2,0,1,3,66.66666666666666
314770,2015,3,0,0,3,100.0
314770,2016,3,0,0,3,100.0
314770,2017,3,0,0,3,100.0
314770,2018,5,0,0,5,100.0
314770,2019,2,0,0,2,100.0
314770,2020,2,0,0,2,100.0
314780,2014,0,0,1,1,0.0
314780,2020,0,0,1,1,0.0
314790,2012,34,0,0,34,100.0
314790,2013,39,0,0,39,100.0
314790,2014,30,0,0,30,100.0
314790,2015,41,0,0,41,100.0
314790,2016,38,0,0,38,100.0
314790,2017,30,0,0,30,100.0
314790,2018,35,0,0,35,100.0
314790,2019,28,0,0,28,100.0
314790,2020,34,0,0,34,100.0
314795,2012,1,0,1,2,50.0
314795,2013,1,0,0,1,100.0
314795,2014,2,0,0,2,100.0
314795,2015,6,0,0,6,100.0
314795,2016,2,0,0,2,100.0
314795,2017,2,0,0,2,100.0
314795,2018,1,0,0,1,100.0
314795,2020,2,0,0,2,100.0
314800,2012,57,0,0,57,100.0
314800,2013,53,0,0,53,100.0
314800,2014,38,1,2,41,95.1219512195122
314800,2015,37,0,0,37,100.0
314800,2016,65,0,0,65,100.0
314800,2017,43,0,0,43,100.0
314800,2018,36,0,1,37,97.2972972972973
314800,2019,46,0,0,46,100.0
314800,2020,51,0,0,51,100.0
314810,2012,24,0,0,24,100.0
314810,2013,23,0,0,23,100.0
314810,2014,27,0,0,27,100.0
314810,2015,27,0,0,27,100.0
314810,2016,30,0,0,30,100.0
314810,2017,24,0,0,24,100.0
314810,2018,29,0,0,29,100.0
314810,2019,27,2,3,32,90.625
314810,2020,32,0,1,33,96.96969696969697
314820,2012,3,0,0,3,100.0
314820,2013,3,0,1,4,75.0
314820,2014,2,0,2,4,50.0
314820,2016,2,0,0,2,100.0
314820,2017,1,0,0,1,100.0
314820,2018,1,0,0,1,100.0
314820,2019,3,0,0,3,100.0
314820,2020,3,0,0,3,100.0
314830,2012,3,0,0,3,100.0
314830,2013,5,0,0,5,100.0
314830,2014,1,0,0,1,100.0
314830,2015,3,0,0,3,100.0
314830,2016,7,0,0,7,100.0
314830,2017,2,0,0,2,100.0
314830,2018,2,0,0,2,100.0
314830,2019,3,0,0,3,100.0
314830,2020,5,0,0,5,100.0
314840,2013,2,0,0,2,100.0
314840,2014,1,0,0,1,100.0
314840,2016,1,0,0,1,100.0
314840,2017,3,0,0,3,100.0
314840,2018,2,0,0,2,100.0
314840,2019,1,0,0,1,100.0
314850,2012,3,0,0,3,100.0
314850,2013,2,0,0,2,100.0
314850,2014,1,0,0,1,100.0
314850,2015,3,0,0,3,100.0
314850,2016,4,0,0,4,100.0
314850,2017,5,0,0,5,100.0
314850,2018,2,1,2,5,60.0
314850,2019,1,0,1,2,50.0
314850,2020,2,0,0,2,100.0
314860,2012,2,0,0,2,100.0
314860,2013,6,0,0,6,100.0
314860,2014,2,0,2,4,50.0
314860,2015,3,0,0,3,100.0
314860,2016,6,0,0,6,100.0
314860,2017,5,0,0,5,100.0
314860,2018,8,0,0,8,100.0
314860,2019,2,0,0,2,100.0
314860,2020,2,0,0,2,100.0
314870,2012,8,0,2,10,80.0
314870,2013,4,0,0,4,100.0
314870,2014,12,0,0,12,100.0
314870,2015,10,0,0,10,100.0
314870,2016,10,0,0,10,100.0
314870,2017,7,0,0,7,100.0
314870,2018,2,0,0,2,100.0
314870,2019,6,0,0,6,100.0
314870,2020,4,0,0,4,100.0
314875,2012,1,0,0,1,100.0
314875,2013,2,0,0,2,100.0
314875,2015,3,0,0,3,100.0
314875,2016,4,0,0,4,100.0
314875,2017,2,0,0,2,100.0
314875,2018,3,0,0,3,100.0
314875,2019,2,0,0,2,100.0
314875,2020,2,0,0,2,100.0
314880,2012,0,0,1,1,0.0
314880,2013,3,0,0,3,100.0
314880,2014,2,0,0,2,100.0
314880,2015,1,0,0,1,100.0
314880,2016,1,0,0,1,100.0
314880,2017,1,0,0,1,100.0
314880,2018,2,0,0,2,100.0
314890,2012,1,0,1,2,50.0
314890,2013,0,0,1,1,0.0
314890,2015,3,0,1,4,75.0
314890,2017,3,0,0,3,100.0
314890,2018,2,0,0,2,100.0
314890,2019,3,0,0,3,100.0
314890,2020,2,0,0,2,100.0
314900,2012,1,0,0,1,100.0
314900,2015,1,0,0,1,100.0
314900,2017,1,0,0,1,100.0
314900,2018,1,0,0,1,100.0
314900,2019,2,0,0,2,100.0
314900,2020,2,0,0,2,100.0
314910,2012,4,0,0,4,100.0
314910,2013,1,0,0,1,100.0
314910,2014,3,0,0,3,100.0
314910,2015,2,0,0,2,100.0
314910,2016,6,0,0,6,100.0
314910,2017,2,0,3,5,40.0
314910,2020,2,0,0,2,100.0
314915,2012,3,0,2,5,60.0
314915,2013,6,0,0,6,100.0
314915,2014,5,0,0,5,100.0
314915,2015,3,0,0,3,100.0
314915,2016,4,0,0,4,100.0
314915,2017,6,0,0,6,100.0
314915,2018,2,0,0,2,100.0
314915,2019,1,0,0,1,100.0
314915,2020,7,0,0,7,100.0
314920,2012,1,0,0,1,100.0
314920,2014,1,0,0,1,100.0
314920,2016,1,0,0,1,100.0
314920,2017,4,0,0,4,100.0
314920,2018,2,0,0,2,100.0
314930,2012,20,1,3,24,87.5
314930,2013,14,1,0,15,100.0
314930,2014,23,0,1,24,95.83333333333334
314930,2015,25,0,1,26,96.15384615384616
314930,2016,14,0,0,14,100.0
314930,2017,13,0,0,13,100.0
314930,2018,18,0,0,18,100.0
314930,2019,19,0,0,19,100.0
314930,2020,16,0,0,16,100.0
314940,2014,1,0,0,1,100.0
314940,2016,1,0,0,1,100.0
314940,2017,2,0,0,2,100.0
314940,2018,1,0,0,1,100.0
314940,2019,1,0,0,1,100.0
314940,2020,0,0,1,1,0.0
314950,2012,1,0,0,1,100.0
314950,2013,1,0,0,1,100.0
314950,2014,0,0,1,1,0.0
314950,2016,1,0,0,1,100.0
314950,2018,1,0,0,1,100.0
314950,2020,2,0,0,2,100.0
314960,2012,4,0,0,4,100.0
314960,2013,1,0,0,1,100.0
314960,2014,2,0,0,2,100.0
314960,2015,1,0,0,1,100.0
314960,2016,2,0,0,2,100.0
314960,2017,3,0,0,3,100.0
314960,2018,1,0,0,1,100.0
314960,2019,2,0,0,2,100.0
314960,2020,1,0,0,1,100.0
314970,2012,3,0,0,3,100.0
314970,2014,2,0,0,2,100.0
314970,2015,2,0,0,2,100.0
314970,2016,4,0,0,4,100.0
314970,2017,1,0,0,1,100.0
314970,2018,1,0,0,1,100.0
314970,2019,5,0,0,5,100.0
314970,2020,3,0,0,3,100.0
314980,2012,7,0,0,7,100.0
314980,2013,3,0,0,3,100.0
314980,2014,9,0,0,9,100.0
314980,2015,2,0,0,2,100.0
314980,2016,4,0,0,4,100.0
314980,2017,5,0,0,5,100.0
314980,2018,5,0,0,5,100.0
314980,2019,6,0,0,6,100.0
314980,2020,13,0,0,13,100.0
314990,2012,6,0,1,7,85.71428571428571
314990,2013,3,1,3,7,57.14285714285714
314990,2014,5,0,0,5,100.0
314990,2015,1,1,1,3,66.66666666666666
314990,2016,6,0,1,7,85.71428571428571
314990,2018,9,0,0,9,100.0
314990,2019,7,0,0,7,100.0
314990,2020,7,0,0,7,100.0
314995,2012,2,0,0,2,100.0
314995,2013,1,0,0,1,100.0
314995,2014,6,0,0,6,100.0
314995,2015,5,0,0,5,100.0
314995,2016,3,0,0,3,100.0
314995,2017,5,0,1,6,83.33333333333334
314995,2018,1,0,0,1,100.0
314995,2019,3,0,0,3,100.0
314995,2020,2,0,0,2,100.0
315000,2012,1,0,0,1,100.0
315000,2013,1,0,0,1,100.0
315000,2014,1,0,0,1,100.0
315000,2015,1,0,0,1,100.0
315000,2016,1,0,0,1,100.0
315000,2017,2,1,0,3,100.0
315000,2018,3,0,0,3,100.0
315000,2019,2,0,0,2,100.0
315000,2020,1,0,0,1,100.0
315010,2012,1,0,0,1,100.0
315010,2014,1,0,0,1,100.0
315010,2016,5,0,0,5,100.0
315010,2019,1,0,0,1,100.0
315010,2020,1,0,0,1,100.0
315015,2012,4,0,0,4,100.0
315015,2013,4,0,0,4,100.0
315015,2014,4,0,0,4,100.0
315015,2015,2,0,0,2,100.0
315015,2016,5,0,0,5,100.0
315015,2017,5,0,0,5,100.0
315015,2018,1,0,0,1,100.0
315015,2019,4,0,0,4,100.0
315015,2020,3,0,0,3,100.0
315020,2012,1,0,0,1,100.0
315020,2015,1,0,0,1,100.0
315020,2016,2,0,0,2,100.0
315020,2017,3,0,0,3,100.0
315020,2018,3,0,0,3,100.0
315020,2019,0,1,0,1,100.0
315020,2020,2,0,0,2,100.0
315030,2012,1,0,0,1,100.0
315030,2013,1,0,0,1,100.0
315030,2014,2,0,0,2,100.0
315030,2018,1,0,0,1,100.0
315030,2019,3,0,1,4,75.0
315040,2013,1,0,0,1,100.0
315040,2014,1,0,0,1,100.0
315040,2015,0,0,1,1,0.0
315040,2016,0,0,1,1,0.0
315040,2018,0,1,2,3,33.33333333333333
315040,2019,0,0,1,1,0.0
315050,2012,1,0,0,1,100.0
315050,2013,1,0,0,1,100.0
315050,2014,4,0,0,4,100.0
315050,2015,4,0,0,4,100.0
315050,2016,1,0,0,1,100.0
315050,2017,5,0,0,5,100.0
315050,2018,3,0,0,3,100.0
315050,2019,3,0,0,3,100.0
315050,2020,2,0,1,3,66.66666666666666
315053,2012,3,0,0,3,100.0
315053,2013,2,0,0,2,100.0
315053,2014,1,0,0,1,100.0
315053,2015,1,0,0,1,100.0
315053,2016,2,0,0,2,100.0
315053,2017,5,0,0,5,100.0
315053,2018,3,0,0,3,100.0
315053,2019,2,0,0,2,100.0
315053,2020,2,0,0,2,100.0
315057,2014,3,0,0,3,100.0
315057,2015,1,0,0,1,100.0
315057,2016,2,0,0,2,100.0
315057,2017,1,0,0,1,100.0
315057,2018,3,0,0,3,100.0
315057,2019,1,0,0,1,100.0
315057,2020,2,0,0,2,100.0
315060,2012,1,0,0,1,100.0
315060,2013,0,1,3,4,25.0
315060,2014,0,1,0,1,100.0
315060,2015,2,0,0,2,100.0
315060,2016,0,0,1,1,0.0
315060,2017,1,0,0,1,100.0
315060,2018,1,0,0,1,100.0
315060,2019,2,0,0,2,100.0
315070,2013,3,0,0,3,100.0
315070,2014,2,0,0,2,100.0
315070,2015,1,0,0,1,100.0
315070,2016,2,0,0,2,100.0
315070,2017,1,0,0,1,100.0
315070,2018,2,0,0,2,100.0
315070,2020,0,0,1,1,0.0
315080,2012,2,0,0,2,100.0
315080,2013,5,0,0,5,100.0
315080,2014,4,1,2,7,71.42857142857143
315080,2015,5,0,0,5,100.0
315080,2016,6,0,0,6,100.0
315080,2017,4,0,0,4,100.0
315080,2018,4,0,0,4,100.0
315080,2019,3,0,0,3,100.0
315080,2020,5,0,0,5,100.0
315090,2012,1,0,0,1,100.0
315090,2013,1,0,0,1,100.0
315090,2014,2,0,0,2,100.0
315090,2015,3,0,0,3,100.0
315090,2017,3,0,0,3,100.0
315090,2019,2,0,0,2,100.0
315090,2020,3,0,0,3,100.0
315100,2012,2,0,0,2,100.0
315100,2013,1,0,0,1,100.0
315100,2014,5,0,0,5,100.0
315100,2015,1,0,0,1,100.0
315100,2017,3,0,0,3,100.0
315100,2018,2,0,0,2,100.0
315100,2019,3,0,0,3,100.0
315100,2020,2,0,1,3,66.66666666666666
315110,2012,3,0,0,3,100.0
315110,2013,1,0,0,1,100.0
315110,2014,1,0,1,2,50.0
315110,2015,3,0,0,3,100.0
315110,2016,7,0,0,7,100.0
315110,2017,6,0,0,6,100.0
315110,2018,5,0,0,5,100.0
315110,2019,1,0,0,1,100.0
315110,2020,4,0,0,4,100.0
315120,2012,20,0,0,20,100.0
315120,2013,19,0,0,19,100.0
315120,2014,19,0,0,19,100.0
315120,2015,24,1,0,25,100.0
315120,2016,19,0,0,19,100.0
315120,2017,20,0,0,20,100.0
315120,2018,13,1,0,14,100.0
315120,2019,14,0,1,15,93.33333333333333
315120,2020,22,0,0,22,100.0
315130,2012,4,0,0,4,100.0
315130,2013,4,0,0,4,100.0
315130,2014,2,0,0,2,100.0
315130,2015,2,0,0,2,100.0
315130,2016,2,0,0,2,100.0
315130,2017,3,0,0,3,100.0
315130,2018,5,0,0,5,100.0
315130,2019,7,0,0,7,100.0
315130,2020,5,0,0,5,100.0
315140,2012,17,0,0,17,100.0
315140,2013,9,0,0,9,100.0
315140,2014,2,0,0,2,100.0
315140,2015,5,0,0,5,100.0
315140,2016,8,0,0,8,100.0
315140,2017,8,0,0,8,100.0
315140,2018,11,0,0,11,100.0
315140,2019,10,0,0,10,100.0
315140,2020,14,0,0,14,100.0
315150,2012,10,0,0,10,100.0
315150,2013,7,0,0,7,100.0
315150,2014,14,0,0,14,100.0
315150,2015,10,0,0,10,100.0
315150,2016,9,0,0,9,100.0
315150,2017,6,0,0,6,100.0
315150,2018,13,0,0,13,100.0
315150,2019,20,0,0,20,100.0
315150,2020,12,0,0,12,100.0
315160,2012,5,0,0,5,100.0
315160,2013,6,0,0,6,100.0
315160,2014,5,0,0,5,100.0
315160,2015,4,0,0,4,100.0
315160,2016,4,0,0,4,100.0
315160,2017,5,0,0,5,100.0
315160,2018,1,0,0,1,100.0
315160,2019,3,0,0,3,100.0
315160,2020,6,0,0,6,100.0
315170,2012,3,0,0,3,100.0
315170,2013,3,0,0,3,100.0
315170,2014,5,0,0,5,100.0
315170,2015,1,0,0,1,100.0
315170,2016,1,0,0,1,100.0
315170,2017,1,0,0,1,100.0
315170,2018,5,0,0,5,100.0
315170,2019,3,0,0,3,100.0
315170,2020,4,0,0,4,100.0
315180,2012,44,0,0,44,100.0
315180,2013,53,0,1,54,98.14814814814815
315180,2014,58,0,0,58,100.0
315180,2015,49,0,0,49,100.0
315180,2016,36,0,0,36,100.0
315180,2017,56,1,1,58,98.27586206896551
315180,2018,41,1,0,42,100.0
315180,2019,38,0,1,39,97.43589743589743
315180,2020,3,5,38,46,17.391304347826086
315190,2012,4,0,0,4,100.0
315190,2013,1,0,0,1,100.0
315190,2014,2,0,0,2,100.0
315190,2015,2,0,0,2,100.0
315190,2016,4,0,0,4,100.0
315190,2018,1,0,0,1,100.0
315190,2019,1,0,0,1,100.0
315190,2020,1,0,0,1,100.0
315200,2012,11,0,0,11,100.0
315200,2013,7,0,1,8,87.5
315200,2014,13,1,0,14,100.0
315200,2015,13,0,0,13,100.0
315200,2016,19,0,0,19,100.0
315200,2017,9,0,0,9,100.0
315200,2018,11,0,0,11,100.0
315200,2019,11,0,1,12,91.66666666666666
315200,2020,17,0,0,17,100.0
315210,2012,25,0,2,27,92.5925925925926
315210,2013,16,0,1,17,94.11764705882352
315210,2014,28,0,0,28,100.0
315210,2015,21,0,0,21,100.0
315210,2016,21,0,0,21,100.0
315210,2017,26,0,0,26,100.0
315210,2018,12,0,0,12,100.0
315210,2019,16,0,0,16,100.0
315210,2020,18,0,1,19,94.73684210526315
315213,2012,0,0,1,1,0.0
315213,2013,1,0,0,1,100.0
315213,2014,1,0,0,1,100.0
315213,2015,2,0,1,3,66.66666666666666
315213,2019,1,0,0,1,100.0
315213,2020,2,0,0,2,100.0
315217,2012,5,0,0,5,100.0
315217,2013,7,0,0,7,100.0
315217,2014,3,0,0,3,100.0
315217,2015,6,0,0,6,100.0
315217,2016,8,0,0,8,100.0
315217,2017,5,0,0,5,100.0
315217,2018,8,0,0,8,100.0
315217,2019,3,0,0,3,100.0
315217,2020,7,0,0,7,100.0
315220,2012,19,0,0,19,100.0
315220,2013,13,0,0,13,100.0
315220,2014,18,0,1,19,94.73684210526315
315220,2015,18,0,0,18,100.0
315220,2016,14,0,0,14,100.0
315220,2017,12,0,0,12,100.0
315220,2018,14,0,0,14,100.0
315220,2019,17,0,0,17,100.0
315220,2020,6,0,0,6,100.0
315230,2012,3,0,0,3,100.0
315230,2013,3,0,0,3,100.0
315230,2014,4,0,0,4,100.0
315230,2015,3,0,0,3,100.0
315230,2016,3,0,0,3,100.0
315230,2017,3,0,0,3,100.0
315230,2018,1,0,0,1,100.0
315230,2019,2,0,1,3,66.66666666666666
315230,2020,3,0,0,3,100.0
315240,2012,4,0,1,5,80.0
315240,2013,3,0,0,3,100.0
315240,2014,8,0,0,8,100.0
315240,2015,6,0,0,6,100.0
315240,2016,11,0,0,11,100.0
315240,2017,7,0,0,7,100.0
315240,2018,6,0,0,6,100.0
315240,2019,10,0,0,10,100.0
315240,2020,7,0,0,7,100.0
315250,2012,46,0,0,46,100.0
315250,2013,32,0,0,32,100.0
315250,2014,42,0,0,42,100.0
315250,2015,34,0,0,34,100.0
315250,2016,51,0,0,51,100.0
315250,2017,34,0,0,34,100.0
315250,2018,43,0,0,43,100.0
315250,2019,32,0,0,32,100.0
315250,2020,43,0,0,43,100.0
315260,2012,3,0,0,3,100.0
315260,2013,6,0,0,6,100.0
315260,2014,2,0,0,2,100.0
315260,2015,3,0,0,3,100.0
315260,2016,3,0,0,3,100.0
315260,2017,4,0,0,4,100.0
315260,2018,1,0,0,1,100.0
315260,2019,2,0,0,2,100.0
315260,2020,2,0,0,2,100.0
315270,2012,3,0,0,3,100.0
315270,2013,1,0,0,1,100.0
315270,2014,1,0,0,1,100.0
315270,2015,1,0,0,1,100.0
315270,2016,6,0,0,6,100.0
315270,2017,2,0,0,2,100.0
315270,2018,2,0,0,2,100.0
315270,2019,3,0,0,3,100.0
315270,2020,3,0,0,3,100.0
315280,2012,7,0,0,7,100.0
315280,2013,6,0,0,6,100.0
315280,2014,8,0,0,8,100.0
315280,2015,15,0,0,15,100.0
315280,2016,10,0,0,10,100.0
315280,2017,11,0,0,11,100.0
315280,2018,13,0,0,13,100.0
315280,2019,7,0,0,7,100.0
315280,2020,14,0,0,14,100.0
315290,2012,4,0,0,4,100.0
315290,2013,2,0,0,2,100.0
315290,2014,3,0,0,3,100.0
315290,2015,4,0,0,4,100.0
315290,2016,0,0,2,2,0.0
315290,2017,4,0,0,4,100.0
315290,2018,5,0,0,5,100.0
315290,2019,2,0,0,2,100.0
315290,2020,4,0,0,4,100.0
315300,2012,1,0,0,1,100.0
315300,2016,0,0,1,1,0.0
315300,2017,2,0,0,2,100.0
315300,2018,1,0,0,1,100.0
315300,2019,1,0,0,1,100.0
315300,2020,2,0,0,2,100.0
315310,2012,1,0,0,1,100.0
315310,2013,5,0,0,5,100.0
315310,2014,1,0,0,1,100.0
315310,2016,2,0,0,2,100.0
315310,2017,4,0,0,4,100.0
315310,2019,1,0,0,1,100.0
315310,2020,4,0,0,4,100.0
315320,2013,4,0,0,4,100.0
315320,2015,2,0,0,2,100.0
315320,2017,1,0,0,1,100.0
315320,2019,1,0,0,1,100.0
315320,2020,1,0,0,1,100.0
315330,2013,2,0,0,2,100.0
315330,2014,1,0,0,1,100.0
315330,2015,3,0,0,3,100.0
315330,2016,0,0,1,1,0.0
315330,2017,1,0,0,1,100.0
315330,2018,2,0,0,2,100.0
315330,2019,2,0,0,2,100.0
315330,2020,2,0,0,2,100.0
315340,2012,5,0,0,5,100.0
315340,2013,1,0,0,1,100.0
315340,2014,10,0,0,10,100.0
315340,2015,4,0,0,4,100.0
315340,2016,10,0,0,10,100.0
315340,2017,6,0,1,7,85.71428571428571
315340,2018,7,1,0,8,100.0
315340,2019,6,0,0,6,100.0
315340,2020,5,2,0,7,100.0
315350,2012,1,0,0,1,100.0
315350,2013,2,0,0,2,100.0
315350,2014,2,0,0,2,100.0
315350,2015,4,0,0,4,100.0
315350,2016,4,0,0,4,100.0
315350,2017,2,0,0,2,100.0
315350,2018,1,0,0,1,100.0
315350,2019,1,0,0,1,100.0
315350,2020,0,0,2,2,0.0
315360,2012,3,0,0,3,100.0
315360,2013,6,0,0,6,100.0
315360,2014,6,0,0,6,100.0
315360,2015,2,0,0,2,100.0
315360,2016,5,0,0,5,100.0
315360,2017,3,0,0,3,100.0
315360,2018,2,0,0,2,100.0
315360,2019,8,0,0,8,100.0
315360,2020,2,0,0,2,100.0
315370,2013,3,0,0,3,100.0
315370,2015,0,1,1,2,50.0
315370,2017,2,0,0,2,100.0
315370,2019,0,0,1,1,0.0
315370,2020,0,0,1,1,0.0
315380,2019,0,0,1,1,0.0
315390,2012,0,0,1,1,0.0
315390,2013,1,0,0,1,100.0
315390,2014,4,0,2,6,66.66666666666666
315390,2015,4,0,3,7,57.14285714285714
315390,2016,0,0,5,5,0.0
315390,2017,0,0,3,3,0.0
315390,2018,0,0,3,3,0.0
315390,2019,0,0,6,6,0.0
315390,2020,0,0,1,1,0.0
315400,2012,6,0,0,6,100.0
315400,2013,4,0,0,4,100.0
315400,2014,6,0,0,6,100.0
315400,2015,6,0,0,6,100.0
315400,2016,10,0,0,10,100.0
315400,2017,5,0,0,5,100.0
315400,2018,2,0,0,2,100.0
315400,2019,4,0,0,4,100.0
315400,2020,10,0,0,10,100.0
315410,2012,2,0,0,2,100.0
315410,2013,1,0,0,1,100.0
315410,2014,2,0,0,2,100.0
315410,2015,3,0,0,3,100.0
315410,2016,0,0,1,1,0.0
315410,2017,0,0,1,1,0.0
315410,2018,4,0,0,4,100.0
315410,2019,2,0,1,3,66.66666666666666
315410,2020,2,0,0,2,100.0
315415,2012,2,0,0,2,100.0
315415,2013,1,0,0,1,100.0
315415,2014,2,0,0,2,100.0
315415,2015,2,0,0,2,100.0
315415,2016,5,0,0,5,100.0
315415,2018,2,0,0,2,100.0
315415,2019,2,0,2,4,50.0
315415,2020,2,0,1,3,66.66666666666666
315420,2012,2,0,0,2,100.0
315420,2013,6,0,0,6,100.0
315420,2014,3,0,1,4,75.0
315420,2015,3,0,0,3,100.0
315420,2016,4,0,0,4,100.0
315420,2017,5,0,0,5,100.0
315420,2018,5,0,0,5,100.0
315420,2019,5,0,0,5,100.0
315420,2020,3,0,0,3,100.0
315430,2012,3,1,0,4,100.0
315430,2013,8,0,0,8,100.0
315430,2014,8,0,0,8,100.0
315430,2015,2,0,0,2,100.0
315430,2016,5,0,0,5,100.0
315430,2017,8,0,0,8,100.0
315430,2018,4,0,0,4,100.0
315430,2019,1,1,1,3,66.66666666666666
315430,2020,8,0,0,8,100.0
315440,2012,1,0,1,2,50.0
315440,2013,0,1,0,1,100.0
315440,2014,0,1,0,1,100.0
315440,2015,0,3,0,3,100.0
315440,2017,1,0,0,1,100.0
315440,2018,2,0,0,2,100.0
315440,2019,1,0,0,1,100.0
315440,2020,2,0,0,2,100.0
315445,2012,1,0,0,1,100.0
315445,2013,2,0,0,2,100.0
315445,2014,6,0,0,6,100.0
315445,2015,5,0,0,5,100.0
315445,2016,4,0,0,4,100.0
315445,2017,3,0,0,3,100.0
315445,2018,1,0,0,1,100.0
315445,2019,1,0,0,1,100.0
315445,2020,3,0,0,3,100.0
315450,2012,3,0,0,3,100.0
315450,2013,3,0,0,3,100.0
315450,2014,1,0,0,1,100.0
315450,2015,2,0,0,2,100.0
315450,2016,3,0,0,3,100.0
315450,2017,5,0,0,5,100.0
315450,2018,2,0,0,2,100.0
315450,2019,2,0,0,2,100.0
315450,2020,3,0,0,3,100.0
315460,2012,95,3,4,102,96.07843137254902
315460,2013,114,2,1,117,99.14529914529915
315460,2014,78,1,4,83,95.18072289156626
315460,2015,91,8,8,107,92.5233644859813
315460,2016,115,3,6,124,95.16129032258065
315460,2017,106,4,8,118,93.22033898305084
315460,2018,66,2,9,77,88.31168831168831
315460,2019,72,2,16,90,82.22222222222221
315460,2020,59,19,23,101,77.22772277227723
315470,2014,1,0,0,1,100.0
315470,2016,0,0,1,1,0.0
315470,2017,0,0,3,3,0.0
315470,2018,0,0,1,1,0.0
315470,2019,1,0,0,1,100.0
315470,2020,0,0,2,2,0.0
315480,2012,6,0,0,6,100.0
315480,2013,5,0,0,5,100.0
315480,2014,6,0,0,6,100.0
315480,2015,2,0,0,2,100.0
315480,2016,2,0,0,2,100.0
315480,2017,1,0,0,1,100.0
315480,2018,4,0,0,4,100.0
315480,2019,4,0,0,4,100.0
315480,2020,6,0,0,6,100.0
315490,2012,6,0,0,6,100.0
315490,2013,2,0,0,2,100.0
315490,2014,3,0,0,3,100.0
315490,2015,11,0,0,11,100.0
315490,2016,7,0,0,7,100.0
315490,2017,9,0,0,9,100.0
315490,2018,2,0,0,2,100.0
315490,2019,7,0,0,7,100.0
315490,2020,5,0,0,5,100.0
315500,2012,1,0,0,1,100.0
315500,2013,1,0,0,1,100.0
315500,2015,1,0,0,1,100.0
315510,2012,1,0,0,1,100.0
315510,2013,2,0,0,2,100.0
315510,2015,1,0,1,2,50.0
315510,2016,2,0,1,3,66.66666666666666
315510,2017,1,0,0,1,100.0
315510,2020,1,0,1,2,50.0
315520,2012,2,2,2,6,66.66666666666666
315520,2013,2,0,0,2,100.0
315520,2014,0,0,1,1,0.0
315520,2015,0,0,1,1,0.0
315520,2017,4,0,0,4,100.0
315520,2018,2,0,0,2,100.0
315520,2019,0,0,1,1,0.0
315530,2012,2,0,0,2,100.0
315530,2013,1,0,0,1,100.0
315530,2014,2,0,0,2,100.0
315530,2015,1,0,0,1,100.0
315530,2016,0,0,1,1,0.0
315530,2017,0,0,1,1,0.0
315530,2018,0,0,1,1,0.0
315530,2019,3,0,0,3,100.0
315530,2020,3,0,0,3,100.0
315540,2012,3,0,0,3,100.0
315540,2013,13,0,0,13,100.0
315540,2014,2,0,0,2,100.0
315540,2015,0,0,4,4,0.0
315540,2016,0,0,2,2,0.0
315540,2017,1,0,2,3,33.33333333333333
315540,2018,0,0,3,3,0.0
315540,2019,0,0,1,1,0.0
315540,2020,0,0,4,4,0.0
315550,2012,1,0,0,1,100.0
315550,2013,5,0,0,5,100.0
315550,2014,5,0,0,5,100.0
315550,2015,3,0,0,3,100.0
315550,2016,3,0,1,4,75.0
315550,2017,4,0,0,4,100.0
315550,2018,7,0,0,7,100.0
315550,2019,9,0,0,9,100.0
315550,2020,5,0,0,5,100.0
315560,2012,7,1,0,8,100.0
315560,2013,10,0,0,10,100.0
315560,2014,10,0,0,10,100.0
315560,2015,4,0,0,4,100.0
315560,2016,9,0,0,9,100.0
315560,2017,11,0,0,11,100.0
315560,2018,11,0,0,11,100.0
315560,2019,6,0,0,6,100.0
315560,2020,12,0,0,12,100.0
315570,2013,8,0,0,8,100.0
315570,2014,5,0,0,5,100.0
315570,2015,5,0,0,5,100.0
315570,2016,3,0,0,3,100.0
315570,2017,1,0,0,1,100.0
315570,2018,3,0,0,3,100.0
315570,2019,3,0,3,6,50.0
315570,2020,3,0,1,4,75.0
315580,2012,8,0,0,8,100.0
315580,2013,4,0,0,4,100.0
315580,2014,8,0,0,8,100.0
315580,2015,3,0,0,3,100.0
315580,2016,6,0,0,6,100.0
315580,2017,11,0,0,11,100.0
315580,2018,2,0,0,2,100.0
315580,2019,6,0,0,6,100.0
315580,2020,5,0,0,5,100.0
315590,2012,3,0,0,3,100.0
315590,2016,2,0,0,2,100.0
315590,2017,2,0,0,2,100.0
315590,2018,1,0,0,1,100.0
315590,2019,5,0,0,5,100.0
315590,2020,0,0,1,1,0.0
315600,2012,4,0,0,4,100.0
315600,2013,6,0,0,6,100.0
315600,2014,6,0,0,6,100.0
315600,2015,3,0,0,3,100.0
315600,2016,2,0,0,2,100.0
315600,2017,3,0,0,3,100.0
315600,2018,2,0,0,2,100.0
315600,2019,2,0,0,2,100.0
315600,2020,2,0,2,4,50.0
315610,2012,1,0,0,1,100.0
315610,2013,1,0,1,2,50.0
315610,2014,2,0,0,2,100.0
315610,2015,2,0,0,2,100.0
315610,2016,4,0,0,4,100.0
315610,2017,2,0,0,2,100.0
315610,2018,0,1,0,1,100.0
315610,2020,2,0,0,2,100.0
315620,2015,0,0,1,1,0.0
315620,2016,0,0,2,2,0.0
315620,2018,0,0,1,1,0.0
315620,2019,0,0,1,1,0.0
315620,2020,1,0,0,1,100.0
315630,2012,5,0,0,5,100.0
315630,2013,3,0,0,3,100.0
315630,2014,4,0,0,4,100.0
315630,2015,4,0,0,4,100.0
315630,2016,11,0,0,11,100.0
315630,2017,3,0,0,3,100.0
315630,2018,3,0,0,3,100.0
315630,2019,2,0,0,2,100.0
315630,2020,4,0,0,4,100.0
315640,2013,2,0,0,2,100.0
315640,2014,1,0,0,1,100.0
315640,2015,1,0,0,1,100.0
315640,2016,1,0,0,1,100.0
315640,2017,0,0,1,1,0.0
315640,2020,1,0,1,2,50.0
315645,2012,2,0,0,2,100.0
315645,2013,1,0,0,1,100.0
315645,2015,6,0,0,6,100.0
315645,2016,2,0,2,4,50.0
315645,2017,0,0,2,2,0.0
315645,2018,0,3,0,3,100.0
315645,2019,0,0,1,1,0.0
315645,2020,0,0,2,2,0.0
315650,2012,3,0,0,3,100.0
315650,2013,5,0,0,5,100.0
315650,2014,3,0,0,3,100.0
315650,2016,3,0,0,3,100.0
315650,2017,2,0,0,2,100.0
315650,2018,3,0,0,3,100.0
315650,2019,3,0,0,3,100.0
315650,2020,1,0,0,1,100.0
315660,2012,5,0,0,5,100.0
315660,2013,2,0,0,2,100.0
315660,2014,3,0,0,3,100.0
315660,2015,4,0,0,4,100.0
315660,2016,4,0,0,4,100.0
315660,2017,1,0,0,1,100.0
315660,2018,3,0,0,3,100.0
315660,2019,3,0,1,4,75.0
315660,2020,2,0,0,2,100.0
315670,2012,40,4,4,48,91.66666666666666
315670,2013,44,0,0,44,100.0
315670,2014,31,0,0,31,100.0
315670,2015,43,0,4,47,91.48936170212765
315670,2016,36,0,2,38,94.73684210526315
315670,2017,40,0,0,40,100.0
315670,2018,37,0,3,40,92.5
315670,2019,38,0,4,42,90.47619047619048
315670,2020,45,0,2,47,95.74468085106383
315680,2012,7,0,0,7,100.0
315680,2013,6,0,0,6,100.0
315680,2014,4,0,0,4,100.0
315680,2015,4,0,0,4,100.0
315680,2016,1,0,0,1,100.0
315680,2017,5,0,0,5,100.0
315680,2018,5,0,0,5,100.0
315680,2019,6,0,0,6,100.0
315680,2020,3,0,0,3,100.0
315690,2012,7,0,0,7,100.0
315690,2013,3,0,0,3,100.0
315690,2014,8,0,0,8,100.0
315690,2015,9,0,0,9,100.0
315690,2016,6,0,0,6,100.0
315690,2017,8,0,0,8,100.0
315690,2018,8,0,0,8,100.0
315690,2019,9,0,0,9,100.0
315690,2020,7,0,0,7,100.0
315700,2012,14,0,0,14,100.0
315700,2013,13,0,0,13,100.0
315700,2014,18,0,0,18,100.0
315700,2015,19,0,1,20,95.0
315700,2016,10,0,0,10,100.0
315700,2017,19,0,0,19,100.0
315700,2018,11,0,0,11,100.0
315700,2019,13,0,0,13,100.0
315700,2020,8,0,0,8,100.0
315710,2012,3,0,0,3,100.0
315710,2013,5,0,0,5,100.0
315710,2014,1,0,0,1,100.0
315710,2015,3,0,0,3,100.0
315710,2016,4,0,0,4,100.0
315710,2017,2,0,0,2,100.0
315710,2018,3,0,0,3,100.0
315710,2019,3,0,0,3,100.0
315710,2020,2,0,0,2,100.0
315720,2012,10,0,0,10,100.0
315720,2013,4,0,0,4,100.0
315720,2014,13,1,0,14,100.0
315720,2015,13,0,0,13,100.0
315720,2016,10,0,0,10,100.0
315720,2017,6,0,0,6,100.0
315720,2018,7,0,1,8,87.5
315720,2019,5,0,0,5,100.0
315720,2020,5,0,1,6,83.33333333333334
315725,2012,4,0,0,4,100.0
315725,2013,1,0,0,1,100.0
315725,2014,2,0,0,2,100.0
315725,2015,4,0,0,4,100.0
315725,2016,1,0,0,1,100.0
315725,2019,1,0,0,1,100.0
315725,2020,2,0,0,2,100.0
315727,2013,2,0,1,3,66.66666666666666
315727,2014,1,0,0,1,100.0
315727,2016,2,0,0,2,100.0
315727,2019,1,0,0,1,100.0
315727,2020,0,0,1,1,0.0
315730,2012,2,1,0,3,100.0
315730,2014,1,1,1,3,66.66666666666666
315730,2015,0,1,0,1,100.0
315730,2016,0,1,0,1,100.0
315730,2017,1,0,1,2,50.0
315730,2018,2,0,0,2,100.0
315730,2019,2,0,0,2,100.0
315730,2020,1,0,0,1,100.0
315733,2012,3,0,0,3,100.0
315733,2013,3,0,0,3,100.0
315733,2014,3,0,0,3,100.0
315733,2015,3,0,0,3,100.0
315733,2016,3,0,1,4,75.0
315733,2017,5,0,0,5,100.0
315733,2018,7,0,0,7,100.0
315733,2019,2,1,1,4,75.0
315733,2020,4,0,0,4,100.0
315737,2012,2,0,0,2,100.0
315737,2013,1,0,0,1,100.0
315737,2014,1,0,0,1,100.0
315737,2015,2,0,0,2,100.0
315737,2016,1,0,0,1,100.0
315737,2018,2,0,0,2,100.0
315737,2019,2,0,0,2,100.0
315737,2020,2,0,0,2,100.0
315740,2012,2,0,0,2,100.0
315740,2013,1,0,0,1,100.0
315740,2014,1,0,0,1,100.0
315740,2015,1,0,0,1,100.0
315740,2016,2,0,0,2,100.0
315740,2018,1,0,0,1,100.0
315740,2019,2,0,0,2,100.0
315750,2012,1,0,0,1,100.0
315750,2013,1,0,0,1,100.0
315750,2015,1,0,0,1,100.0
315750,2017,1,0,0,1,100.0
315750,2018,2,0,0,2,100.0
315750,2020,3,0,0,3,100.0
315760,2012,2,0,0,2,100.0
315760,2013,2,0,0,2,100.0
315760,2014,1,0,0,1,100.0
315760,2015,1,0,1,2,50.0
315760,2019,1,0,0,1,100.0
315760,2020,2,0,0,2,100.0
315765,2012,5,0,0,5,100.0
315765,2013,3,0,0,3,100.0
315765,2014,2,0,0,2,100.0
315765,2015,3,0,0,3,100.0
315765,2016,1,0,0,1,100.0
315765,2017,1,0,0,1,100.0
315765,2018,1,0,0,1,100.0
315765,2019,1,0,0,1,100.0
315765,2020,4,0,0,4,100.0
315770,2012,3,0,0,3,100.0
315770,2013,5,0,0,5,100.0
315770,2014,6,0,0,6,100.0
315770,2015,1,0,0,1,100.0
315770,2016,3,0,0,3,100.0
315770,2017,4,0,0,4,100.0
315770,2018,1,0,0,1,100.0
315770,2019,4,0,0,4,100.0
315770,2020,1,0,1,2,50.0
315780,2012,75,0,1,76,98.68421052631578
315780,2013,83,0,1,84,98.80952380952381
315780,2014,63,0,0,63,100.0
315780,2015,71,0,0,71,100.0
315780,2016,89,0,0,89,100.0
315780,2017,78,0,0,78,100.0
315780,2018,82,0,0,82,100.0
315780,2019,65,0,0,65,100.0
315780,2020,57,0,8,65,87.6923076923077
315790,2012,5,0,0,5,100.0
315790,2013,3,0,0,3,100.0
315790,2014,7,0,0,7,100.0
315790,2015,4,0,0,4,100.0
315790,2016,5,0,0,5,100.0
315790,2017,3,0,0,3,100.0
315790,2018,4,0,1,5,80.0
315790,2019,1,0,0,1,100.0
315790,2020,2,0,0,2,100.0
315800,2012,1,0,2,3,33.33333333333333
315800,2013,2,0,0,2,100.0
315800,2014,2,0,0,2,100.0
315800,2015,1,0,1,2,50.0
315800,2016,0,0,2,2,0.0
315800,2017,1,0,0,1,100.0
315800,2018,4,0,0,4,100.0
315800,2019,7,0,0,7,100.0
315800,2020,3,0,0,3,100.0
315810,2012,3,0,0,3,100.0
315810,2014,2,0,0,2,100.0
315810,2017,1,0,0,1,100.0
315810,2018,2,0,0,2,100.0
315810,2020,0,0,1,1,0.0
315820,2012,6,0,0,6,100.0
315820,2013,4,0,0,4,100.0
315820,2014,7,0,0,7,100.0
315820,2015,2,0,0,2,100.0
315820,2016,10,0,0,10,100.0
315820,2017,2,0,0,2,100.0
315820,2018,2,0,0,2,100.0
315820,2019,5,0,0,5,100.0
315820,2020,3,0,0,3,100.0
315830,2012,3,0,0,3,100.0
315830,2013,3,0,0,3,100.0
315830,2014,4,0,0,4,100.0
315830,2015,3,0,0,3,100.0
315830,2016,3,0,0,3,100.0
315830,2017,2,0,1,3,66.66666666666666
315830,2018,3,0,0,3,100.0
315830,2019,1,0,0,1,100.0
315840,2012,2,0,0,2,100.0
315840,2013,1,0,0,1,100.0
315840,2014,1,0,0,1,100.0
315840,2015,1,0,0,1,100.0
315840,2017,2,0,0,2,100.0
315840,2018,2,0,0,2,100.0
315840,2019,3,0,0,3,100.0
315850,2012,4,0,0,4,100.0
315850,2014,2,0,0,2,100.0
315850,2015,0,0,2,2,0.0
315850,2016,0,0,3,3,0.0
315850,2017,2,0,0,2,100.0
315850,2018,9,0,0,9,100.0
315850,2019,3,0,0,3,100.0
315850,2020,3,0,0,3,100.0
315860,2012,3,0,0,3,100.0
315860,2013,0,0,2,2,0.0
315860,2014,0,0,1,1,0.0
315860,2015,0,0,1,1,0.0
315860,2017,2,1,0,3,100.0
315860,2018,1,1,0,2,100.0
315860,2020,1,0,0,1,100.0
315870,2012,3,0,1,4,75.0
315870,2015,3,0,0,3,100.0
315870,2018,0,0,1,1,0.0
315870,2019,1,0,0,1,100.0
315880,2014,4,0,0,4,100.0
315880,2016,1,1,1,3,66.66666666666666
315880,2017,0,0,2,2,0.0
315880,2018,1,0,0,1,100.0
315880,2019,1,0,1,2,50.0
315880,2020,0,0,2,2,0.0
315890,2012,3,0,0,3,100.0
315890,2013,6,0,0,6,100.0
315890,2014,2,0,0,2,100.0
315890,2015,2,0,0,2,100.0
315890,2016,3,0,0,3,100.0
315890,2017,3,0,0,3,100.0
315890,2018,4,0,0,4,100.0
315890,2019,7,0,0,7,100.0
315890,2020,4,0,0,4,100.0
315895,2012,10,0,0,10,100.0
315895,2013,12,0,0,12,100.0
315895,2014,7,0,0,7,100.0
315895,2015,13,0,0,13,100.0
315895,2016,8,0,0,8,100.0
315895,2017,12,0,0,12,100.0
315895,2018,15,0,1,16,93.75
315895,2019,16,0,0,16,100.0
315895,2020,20,0,0,20,100.0
315900,2012,0,0,1,1,0.0
315900,2014,0,1,0,1,100.0
315900,2015,2,0,0,2,100.0
315900,2016,0,0,3,3,0.0
315900,2017,1,0,0,1,100.0
315900,2018,1,0,0,1,100.0
315900,2020,3,0,0,3,100.0
315910,2013,1,0,2,3,33.33333333333333
315910,2014,0,1,0,1,100.0
315910,2015,0,0,2,2,0.0
315910,2016,0,0,1,1,0.0
315910,2017,1,0,1,2,50.0
315910,2018,0,0,2,2,0.0
315910,2019,0,0,1,1,0.0
315920,2012,2,0,0,2,100.0
315920,2013,2,0,0,2,100.0
315920,2014,3,0,0,3,100.0
315920,2015,2,0,0,2,100.0
315920,2016,3,0,0,3,100.0
315920,2017,4,0,0,4,100.0
315920,2018,5,0,0,5,100.0
315920,2019,2,0,0,2,100.0
315920,2020,2,0,0,2,100.0
315930,2012,2,0,0,2,100.0
315930,2013,5,0,0,5,100.0
315930,2014,3,0,0,3,100.0
315930,2015,2,0,0,2,100.0
315930,2016,4,0,0,4,100.0
315930,2017,1,0,1,2,50.0
315930,2018,1,0,0,1,100.0
315930,2019,2,0,0,2,100.0
315930,2020,2,0,0,2,100.0
315935,2012,4,0,1,5,80.0
315935,2013,4,0,0,4,100.0
315935,2014,1,0,0,1,100.0
315935,2015,9,0,0,9,100.0
315935,2016,6,0,0,6,100.0
315935,2017,2,0,0,2,100.0
315935,2018,2,0,1,3,66.66666666666666
315935,2019,3,0,0,3,100.0
315935,2020,2,0,0,2,100.0
315940,2012,1,0,0,1,100.0
315940,2014,0,0,1,1,0.0
315940,2018,4,0,0,4,100.0
315950,2013,1,0,0,1,100.0
315950,2014,3,0,1,4,75.0
315950,2015,2,0,0,2,100.0
315950,2016,1,0,0,1,100.0
315950,2017,3,0,0,3,100.0
315950,2018,4,0,0,4,100.0
315950,2019,1,0,0,1,100.0
315950,2020,1,0,0,1,100.0
315960,2012,18,0,0,18,100.0
315960,2013,14,0,0,14,100.0
315960,2014,19,0,0,19,100.0
315960,2015,14,0,0,14,100.0
315960,2016,14,0,0,14,100.0
315960,2017,7,0,0,7,100.0
315960,2018,10,0,0,10,100.0
315960,2019,6,0,1,7,85.71428571428571
315960,2020,12,0,1,13,92.3076923076923
315970,2013,1,0,0,1,100.0
315970,2017,2,0,0,2,100.0
315970,2019,2,0,0,2,100.0
315970,2020,1,0,0,1,100.0
315980,2012,3,0,0,3,100.0
315980,2013,4,0,0,4,100.0
315980,2014,7,0,0,7,100.0
315980,2015,11,0,0,11,100.0
315980,2016,6,0,0,6,100.0
315980,2017,4,0,0,4,100.0
315980,2018,4,0,0,4,100.0
315980,2019,6,0,0,6,100.0
315980,2020,3,0,0,3,100.0
315990,2012,6,0,0,6,100.0
315990,2013,8,0,0,8,100.0
315990,2014,8,0,0,8,100.0
315990,2015,6,0,0,6,100.0
315990,2016,7,0,0,7,100.0
315990,2017,9,0,0,9,100.0
315990,2018,8,0,0,8,100.0
315990,2019,6,0,0,6,100.0
315990,2020,6,0,0,6,100.0
316000,2012,2,0,0,2,100.0
316000,2013,2,0,0,2,100.0
316000,2015,1,0,0,1,100.0
316000,2016,1,0,0,1,100.0
316000,2020,3,0,0,3,100.0
316010,2012,0,0,1,1,0.0
316010,2013,2,0,0,2,100.0
316010,2014,1,0,0,1,100.0
316010,2015,2,0,0,2,100.0
316010,2016,2,0,0,2,100.0
316010,2017,3,0,0,3,100.0
316010,2018,3,0,0,3,100.0
316020,2012,2,0,0,2,100.0
316020,2013,1,0,0,1,100.0
316020,2014,1,0,0,1,100.0
316020,2015,3,0,0,3,100.0
316020,2016,0,0,1,1,0.0
316020,2018,1,0,0,1,100.0
316020,2019,3,0,0,3,100.0
316020,2020,1,0,1,2,50.0
316030,2012,4,0,1,5,80.0
316030,2013,2,0,0,2,100.0
316030,2014,2,0,2,4,50.0
316030,2015,3,0,0,3,100.0
316030,2016,1,0,2,3,33.33333333333333
316030,2017,1,0,0,1,100.0
316030,2018,3,0,0,3,100.0
316030,2020,4,0,0,4,100.0
316040,2012,5,0,0,5,100.0
316040,2013,4,0,0,4,100.0
316040,2014,12,0,0,12,100.0
316040,2015,8,0,0,8,100.0
316040,2016,7,0,0,7,100.0
316040,2017,7,0,0,7,100.0
316040,2018,12,0,0,12,100.0
316040,2019,10,0,0,10,100.0
316040,2020,7,0,0,7,100.0
316045,2012,1,0,0,1,100.0
316045,2014,2,0,0,2,100.0
316045,2015,3,0,0,3,100.0
316045,2016,3,0,0,3,100.0
316045,2017,3,0,0,3,100.0
316045,2018,2,0,0,2,100.0
316045,2019,4,0,0,4,100.0
316045,2020,2,0,0,2,100.0
316050,2012,1,0,0,1,100.0
316050,2013,1,0,0,1,100.0
316050,2014,1,0,0,1,100.0
316050,2019,2,0,0,2,100.0
316050,2020,2,0,0,2,100.0
316060,2017,1,0,0,1,100.0
316060,2020,1,0,0,1,100.0
316070,2012,21,0,0,21,100.0
316070,2013,21,0,0,21,100.0
316070,2014,20,0,0,20,100.0
316070,2015,21,0,0,21,100.0
316070,2016,16,0,0,16,100.0
316070,2017,16,0,1,17,94.11764705882352
316070,2018,25,0,0,25,100.0
316070,2019,17,0,0,17,100.0
316070,2020,14,0,0,14,100.0
316080,2012,2,0,0,2,100.0
316080,2013,2,0,0,2,100.0
316080,2015,2,0,0,2,100.0
316080,2017,0,0,2,2,0.0
316080,2018,4,0,0,4,100.0
316080,2019,1,0,0,1,100.0
316080,2020,3,0,0,3,100.0
316090,2012,1,0,0,1,100.0
316090,2013,2,0,0,2,100.0
316090,2014,0,0,1,1,0.0
316090,2017,1,0,0,1,100.0
316090,2018,2,0,0,2,100.0
316090,2019,3,0,0,3,100.0
316090,2020,1,0,0,1,100.0
316095,2012,4,0,0,4,100.0
316095,2015,1,0,0,1,100.0
316095,2016,4,0,0,4,100.0
316095,2017,1,0,0,1,100.0
316095,2018,5,0,0,5,100.0
316095,2019,1,0,0,1,100.0
316095,2020,1,0,0,1,100.0
316100,2012,8,0,0,8,100.0
316100,2013,3,0,1,4,75.0
316100,2014,6,0,0,6,100.0
316100,2015,5,0,0,5,100.0
316100,2016,5,0,1,6,83.33333333333334
316100,2017,2,0,2,4,50.0
316100,2018,0,0,5,5,0.0
316100,2019,1,0,5,6,16.666666666666664
316100,2020,0,0,9,9,0.0
316105,2012,1,0,0,1,100.0
316105,2013,3,0,0,3,100.0
316105,2014,1,0,0,1,100.0
316105,2015,1,0,0,1,100.0
316105,2016,2,0,0,2,100.0
316105,2017,1,0,0,1,100.0
316105,2019,1,0,0,1,100.0
316110,2012,17,0,5,22,77.27272727272727
316110,2013,24,0,1,25,96.0
316110,2014,14,0,0,14,100.0
316110,2015,25,0,1,26,96.15384615384616
316110,2016,14,0,0,14,100.0
316110,2017,18,0,0,18,100.0
316110,2018,21,0,1,22,95.45454545454545
316110,2019,14,0,0,14,100.0
316110,2020,23,0,0,23,100.0
316120,2012,1,0,0,1,100.0
316120,2013,3,0,0,3,100.0
316120,2014,4,0,0,4,100.0
316120,2015,2,0,0,2,100.0
316120,2016,2,0,0,2,100.0
316120,2017,3,0,0,3,100.0
316120,2018,2,0,0,2,100.0
316120,2019,6,0,0,6,100.0
316120,2020,3,0,0,3,100.0
316130,2012,3,0,0,3,100.0
316130,2013,6,0,0,6,100.0
316130,2014,9,0,0,9,100.0
316130,2015,2,0,0,2,100.0
316130,2016,3,0,0,3,100.0
316130,2017,2,0,0,2,100.0
316130,2018,2,0,0,2,100.0
316130,2019,2,0,0,2,100.0
316130,2020,2,0,0,2,100.0
316140,2012,4,0,0,4,100.0
316140,2013,1,0,0,1,100.0
316140,2014,2,0,0,2,100.0
316140,2015,2,0,0,2,100.0
316140,2016,0,0,1,1,0.0
316140,2017,1,0,0,1,100.0
316140,2018,3,0,0,3,100.0
316140,2019,1,0,0,1,100.0
316140,2020,2,0,0,2,100.0
316150,2012,3,0,0,3,100.0
316150,2013,10,0,0,10,100.0
316150,2014,2,0,0,2,100.0
316150,2015,7,0,0,7,100.0
316150,2016,1,0,0,1,100.0
316150,2017,6,0,0,6,100.0
316150,2018,5,0,0,5,100.0
316150,2019,2,0,0,2,100.0
316150,2020,2,0,0,2,100.0
316160,2012,2,0,0,2,100.0
316160,2013,1,0,0,1,100.0
316160,2014,1,0,0,1,100.0
316160,2015,5,0,0,5,100.0
316160,2016,1,0,0,1,100.0
316160,2017,1,0,0,1,100.0
316160,2018,3,0,0,3,100.0
316160,2019,1,1,0,2,100.0
316165,2012,2,0,0,2,100.0
316165,2013,1,0,2,3,33.33333333333333
316165,2015,2,0,0,2,100.0
316165,2017,1,0,0,1,100.0
316165,2018,2,0,0,2,100.0
316165,2019,1,0,0,1,100.0
316165,2020,2,0,0,2,100.0
316170,2012,2,0,0,2,100.0
316170,2013,3,0,0,3,100.0
316170,2014,1,0,0,1,100.0
316170,2015,4,0,0,4,100.0
316170,2016,3,0,0,3,100.0
316170,2017,2,0,0,2,100.0
316170,2018,4,0,0,4,100.0
316170,2019,4,0,0,4,100.0
316170,2020,2,0,0,2,100.0
316180,2012,5,0,0,5,100.0
316180,2013,6,0,1,7,85.71428571428571
316180,2014,5,0,0,5,100.0
316180,2015,4,1,0,5,100.0
316180,2016,4,0,0,4,100.0
316180,2017,6,0,0,6,100.0
316180,2018,6,0,0,6,100.0
316180,2019,2,0,0,2,100.0
316180,2020,3,0,0,3,100.0
316190,2012,1,0,0,1,100.0
316190,2013,2,0,0,2,100.0
316190,2014,1,0,0,1,100.0
316190,2015,7,0,0,7,100.0
316190,2016,3,0,0,3,100.0
316190,2017,1,0,0,1,100.0
316190,2018,6,0,0,6,100.0
316190,2019,2,0,0,2,100.0
316190,2020,4,0,0,4,100.0
316200,2012,9,0,0,9,100.0
316200,2013,5,0,0,5,100.0
316200,2014,6,0,0,6,100.0
316200,2015,5,0,0,5,100.0
316200,2016,7,0,1,8,87.5
316200,2017,7,0,0,7,100.0
316200,2018,7,0,0,7,100.0
316200,2019,10,0,0,10,100.0
316200,2020,3,0,0,3,100.0
316210,2012,16,0,0,16,100.0
316210,2013,9,0,0,9,100.0
316210,2014,12,0,0,12,100.0
316210,2015,13,0,0,13,100.0
316210,2016,14,0,0,14,100.0
316210,2017,16,1,0,17,100.0
316210,2018,9,0,0,9,100.0
316210,2019,12,0,0,12,100.0
316210,2020,11,2,0,13,100.0
316220,2012,1,0,0,1,100.0
316220,2013,1,0,0,1,100.0
316220,2014,2,0,0,2,100.0
316220,2015,1,0,0,1,100.0
316220,2016,1,0,0,1,100.0
316220,2017,2,0,0,2,100.0
316220,2018,2,0,0,2,100.0
316220,2019,2,0,0,2,100.0
316220,2020,1,0,0,1,100.0
316225,2012,1,0,0,1,100.0
316225,2015,2,0,0,2,100.0
316225,2017,2,0,0,2,100.0
316225,2018,1,0,0,1,100.0
316225,2019,1,0,0,1,100.0
316225,2020,1,0,0,1,100.0
316230,2012,1,0,0,1,100.0
316230,2013,2,0,0,2,100.0
316230,2014,2,0,0,2,100.0
316230,2015,3,0,0,3,100.0
316230,2017,1,0,0,1,100.0
316240,2012,11,0,0,11,100.0
316240,2013,11,0,0,11,100.0
316240,2014,8,0,0,8,100.0
316240,2015,5,0,0,5,100.0
316240,2016,5,0,0,5,100.0
316240,2017,4,0,0,4,100.0
316240,2018,4,0,0,4,100.0
316240,2019,8,0,0,8,100.0
316240,2020,9,0,0,9,100.0
316245,2012,4,0,1,5,80.0
316245,2013,3,0,0,3,100.0
316245,2014,10,0,0,10,100.0
316245,2015,4,0,0,4,100.0
316245,2016,8,0,0,8,100.0
316245,2017,8,0,0,8,100.0
316245,2018,7,0,0,7,100.0
316245,2019,4,0,0,4,100.0
316245,2020,5,0,0,5,100.0
316250,2012,32,0,0,32,100.0
316250,2013,36,0,0,36,100.0
316250,2014,27,0,2,29,93.10344827586206
316250,2015,26,0,0,26,100.0
316250,2016,38,0,0,38,100.0
316250,2017,27,0,0,27,100.0
316250,2018,23,0,0,23,100.0
316250,2019,23,0,0,23,100.0
316250,2020,29,1,0,30,100.0
316255,2012,3,0,0,3,100.0
316255,2013,1,0,0,1,100.0
316255,2014,4,0,0,4,100.0
316255,2015,1,0,0,1,100.0
316255,2016,5,0,0,5,100.0
316255,2017,3,0,0,3,100.0
316255,2018,4,0,0,4,100.0
316255,2019,4,0,0,4,100.0
316255,2020,2,1,1,4,75.0
316257,2012,1,0,0,1,100.0
316257,2013,2,0,0,2,100.0
316257,2014,2,0,0,2,100.0
316257,2015,1,0,0,1,100.0
316257,2016,3,0,0,3,100.0
316257,2017,4,0,0,4,100.0
316257,2018,1,0,0,1,100.0
316257,2019,3,0,0,3,100.0
316257,2020,0,0,1,1,0.0
316260,2012,1,0,0,1,100.0
316260,2013,2,0,0,2,100.0
316260,2014,3,0,0,3,100.0
316260,2015,1,0,0,1,100.0
316260,2016,4,0,0,4,100.0
316260,2017,3,0,0,3,100.0
316260,2018,1,0,0,1,100.0
316260,2019,1,0,0,1,100.0
316260,2020,2,0,2,4,50.0
316265,2012,3,0,0,3,100.0
316265,2013,4,0,0,4,100.0
316265,2015,2,0,0,2,100.0
316265,2016,1,0,0,1,100.0
316265,2017,1,0,0,1,100.0
316265,2019,1,0,0,1,100.0
316265,2020,2,0,0,2,100.0
316270,2012,3,0,0,3,100.0
316270,2013,3,0,0,3,100.0
316270,2014,3,0,0,3,100.0
316270,2016,7,0,1,8,87.5
316270,2017,7,0,0,7,100.0
316270,2018,3,0,1,4,75.0
316270,2019,10,0,0,10,100.0
316270,2020,5,0,0,5,100.0
316280,2012,2,0,0,2,100.0
316280,2013,6,0,0,6,100.0
316280,2014,5,0,0,5,100.0
316280,2015,8,0,0,8,100.0
316280,2016,3,0,0,3,100.0
316280,2017,7,0,0,7,100.0
316280,2018,2,0,0,2,100.0
316280,2019,5,0,4,9,55.55555555555556
316280,2020,1,2,7,10,30.0
316290,2012,3,0,0,3,100.0
316290,2013,12,0,0,12,100.0
316290,2014,5,0,0,5,100.0
316290,2015,10,0,0,10,100.0
316290,2016,3,0,0,3,100.0
316290,2017,4,0,0,4,100.0
316290,2018,8,0,0,8,100.0
316290,2019,9,0,0,9,100.0
316290,2020,9,0,0,9,100.0
316292,2012,10,0,0,10,100.0
316292,2013,8,0,0,8,100.0
316292,2014,9,0,0,9,100.0
316292,2015,10,0,1,11,90.9090909090909
316292,2016,8,0,0,8,100.0
316292,2017,10,0,0,10,100.0
316292,2018,11,0,0,11,100.0
316292,2019,9,0,0,9,100.0
316292,2020,10,0,0,10,100.0
316294,2013,2,0,0,2,100.0
316294,2014,1,0,0,1,100.0
316294,2015,1,0,0,1,100.0
316294,2016,3,0,0,3,100.0
316294,2017,2,0,0,2,100.0
316294,2018,3,0,0,3,100.0
316294,2019,2,0,0,2,100.0
316295,2012,9,0,0,9,100.0
316295,2013,8,0,2,10,80.0
316295,2014,9,0,0,9,100.0
316295,2015,9,0,0,9,100.0
316295,2016,8,0,0,8,100.0
316295,2017,9,0,0,9,100.0
316295,2018,9,0,1,10,90.0
316295,2019,1,0,3,4,25.0
316295,2020,0,1,5,6,16.666666666666664
316300,2012,2,0,0,2,100.0
316300,2013,3,0,0,3,100.0
316300,2014,1,0,0,1,100.0
316300,2018,0,1,0,1,100.0
316300,2019,0,2,0,2,100.0
316300,2020,0,0,1,1,0.0
316310,2012,1,0,0,1,100.0
316310,2014,2,0,0,2,100.0
316310,2015,1,0,0,1,100.0
316310,2016,2,0,0,2,100.0
316310,2017,2,0,0,2,100.0
316320,2012,3,0,0,3,100.0
316320,2015,1,0,0,1,100.0
316320,2019,2,0,0,2,100.0
316320,2020,3,0,0,3,100.0
316330,2015,2,0,0,2,100.0
316330,2016,1,0,0,1,100.0
316330,2018,1,0,0,1,100.0
316330,2019,1,0,0,1,100.0
316330,2020,1,0,2,3,33.33333333333333
316340,2012,2,0,0,2,100.0
316340,2013,1,0,0,1,100.0
316340,2014,3,0,0,3,100.0
316340,2016,3,0,0,3,100.0
316340,2017,2,0,0,2,100.0
316340,2020,2,0,0,2,100.0
316350,2012,2,0,1,3,66.66666666666666
316350,2014,5,0,0,5,100.0
316350,2015,1,0,1,2,50.0
316350,2017,5,0,0,5,100.0
316350,2018,2,0,0,2,100.0
316350,2019,3,0,0,3,100.0
316350,2020,4,0,0,4,100.0
316360,2013,1,0,0,1,100.0
316360,2014,3,0,0,3,100.0
316360,2016,1,0,0,1,100.0
316360,2017,2,0,0,2,100.0
316370,2012,9,0,0,9,100.0
316370,2013,17,0,0,17,100.0
316370,2014,11,0,0,11,100.0
316370,2015,10,0,0,10,100.0
316370,2016,13,0,0,13,100.0
316370,2017,19,0,0,19,100.0
316370,2018,12,0,0,12,100.0
316370,2019,17,0,0,17,100.0
316370,2020,15,0,0,15,100.0
316380,2012,2,0,0,2,100.0
316380,2013,3,0,0,3,100.0
316380,2015,2,0,0,2,100.0
316380,2016,1,1,0,2,100.0
316380,2017,0,0,2,2,0.0
316380,2018,3,0,0,3,100.0
316380,2019,3,0,0,3,100.0
316380,2020,1,0,0,1,100.0
316390,2012,2,0,0,2,100.0
316390,2014,1,1,0,2,100.0
316390,2015,1,0,0,1,100.0
316390,2016,2,0,1,3,66.66666666666666
316390,2017,1,0,0,1,100.0
316390,2018,3,0,0,3,100.0
316390,2020,1,0,1,2,50.0
316400,2012,1,0,0,1,100.0
316400,2013,3,0,0,3,100.0
316400,2014,7,0,0,7,100.0
316400,2017,1,0,0,1,100.0
316400,2019,2,0,0,2,100.0
316400,2020,1,0,0,1,100.0
316410,2012,1,0,0,1,100.0
316410,2013,1,0,0,1,100.0
316410,2015,3,0,0,3,100.0
316410,2016,3,0,0,3,100.0
316410,2017,3,0,0,3,100.0
316410,2018,1,0,0,1,100.0
316410,2019,5,0,0,5,100.0
316410,2020,4,0,0,4,100.0
316420,2012,4,0,0,4,100.0
316420,2013,3,0,0,3,100.0
316420,2014,1,0,0,1,100.0
316420,2015,2,0,0,2,100.0
316420,2016,1,0,0,1,100.0
316420,2017,1,0,0,1,100.0
316420,2018,2,0,0,2,100.0
316420,2019,5,0,0,5,100.0
316420,2020,2,0,0,2,100.0
316430,2012,1,0,0,1,100.0
316430,2013,4,0,0,4,100.0
316430,2014,2,0,0,2,100.0
316430,2015,1,0,0,1,100.0
316430,2016,5,0,0,5,100.0
316430,2017,3,0,0,3,100.0
316430,2018,3,0,0,3,100.0
316430,2019,1,0,0,1,100.0
316430,2020,2,0,0,2,100.0
316440,2013,3,0,0,3,100.0
316440,2014,2,0,0,2,100.0
316440,2015,3,0,0,3,100.0
316440,2018,2,0,0,2,100.0
316440,2019,1,0,0,1,100.0
316440,2020,5,0,0,5,100.0
316443,2012,2,0,0,2,100.0
316443,2013,1,0,0,1,100.0
316443,2014,1,0,0,1,100.0
316443,2015,1,0,1,2,50.0
316443,2016,1,0,0,1,100.0
316443,2017,1,0,0,1,100.0
316443,2018,1,0,1,2,50.0
316443,2019,1,0,0,1,100.0
316443,2020,0,0,1,1,0.0
316447,2012,2,0,0,2,100.0
316447,2013,1,0,0,1,100.0
316447,2014,1,0,0,1,100.0
316447,2016,2,0,0,2,100.0
316447,2018,1,0,0,1,100.0
316447,2019,1,0,0,1,100.0
316447,2020,1,0,0,1,100.0
316450,2012,2,0,0,2,100.0
316450,2013,1,0,0,1,100.0
316450,2014,3,0,0,3,100.0
316450,2015,7,0,1,8,87.5
316450,2016,3,0,1,4,75.0
316450,2017,2,0,0,2,100.0
316450,2018,2,0,0,2,100.0
316450,2019,5,0,0,5,100.0
316450,2020,0,0,2,2,0.0
316460,2012,1,0,0,1,100.0
316460,2014,1,0,0,1,100.0
316460,2015,3,0,0,3,100.0
316460,2017,1,0,0,1,100.0
316460,2018,2,0,0,2,100.0
316460,2019,2,0,1,3,66.66666666666666
316470,2012,21,0,0,21,100.0
316470,2013,9,0,0,9,100.0
316470,2014,21,0,0,21,100.0
316470,2015,14,0,0,14,100.0
316470,2016,21,0,0,21,100.0
316470,2017,19,0,0,19,100.0
316470,2018,20,0,0,20,100.0
316470,2019,19,0,0,19,100.0
316470,2020,13,0,14,27,48.148148148148145
316480,2012,1,0,1,2,50.0
316480,2015,0,0,1,1,0.0
316480,2020,0,0,3,3,0.0
316490,2013,2,0,0,2,100.0
316490,2017,1,0,0,1,100.0
316490,2018,3,0,0,3,100.0
316490,2019,2,0,0,2,100.0
316490,2020,1,0,0,1,100.0
316500,2012,2,0,0,2,100.0
316500,2013,1,0,0,1,100.0
316500,2014,2,0,0,2,100.0
316500,2015,3,0,0,3,100.0
316500,2016,1,0,0,1,100.0
316500,2017,2,0,0,2,100.0
316500,2018,5,0,0,5,100.0
316500,2019,2,0,0,2,100.0
316500,2020,3,0,0,3,100.0
316510,2012,2,0,0,2,100.0
316510,2013,4,0,0,4,100.0
316510,2014,2,0,0,2,100.0
316510,2015,3,0,0,3,100.0
316510,2016,3,0,0,3,100.0
316510,2017,2,0,0,2,100.0
316510,2018,2,0,0,2,100.0
316510,2019,4,0,0,4,100.0
316510,2020,1,0,0,1,100.0
316520,2012,6,0,0,6,100.0
316520,2013,3,0,0,3,100.0
316520,2014,2,0,0,2,100.0
316520,2015,5,0,0,5,100.0
316520,2016,4,0,0,4,100.0
316520,2017,2,0,0,2,100.0
316520,2019,2,0,0,2,100.0
316520,2020,1,0,0,1,100.0
316530,2012,3,0,2,5,60.0
316530,2013,2,0,0,2,100.0
316530,2014,1,0,0,1,100.0
316530,2015,3,0,0,3,100.0
316530,2016,0,0,1,1,0.0
316530,2017,1,0,0,1,100.0
316530,2018,4,0,0,4,100.0
316530,2019,7,0,0,7,100.0
316530,2020,3,0,0,3,100.0
316540,2012,2,0,0,2,100.0
316540,2013,2,0,0,2,100.0
316540,2014,2,0,0,2,100.0
316540,2015,3,0,0,3,100.0
316540,2016,2,0,0,2,100.0
316540,2017,4,0,0,4,100.0
316540,2019,2,0,0,2,100.0
316550,2012,2,0,0,2,100.0
316550,2013,1,0,0,1,100.0
316550,2014,2,0,0,2,100.0
316550,2015,1,0,0,1,100.0
316550,2016,4,0,0,4,100.0
316550,2017,3,0,0,3,100.0
316550,2018,0,1,1,2,50.0
316550,2019,0,0,1,1,0.0
316550,2020,0,3,1,4,75.0
316553,2012,2,0,0,2,100.0
316553,2013,10,0,0,10,100.0
316553,2014,11,0,0,11,100.0
316553,2015,10,0,0,10,100.0
316553,2016,11,0,0,11,100.0
316553,2017,9,0,0,9,100.0
316553,2018,6,0,0,6,100.0
316553,2019,10,0,0,10,100.0
316553,2020,9,0,0,9,100.0
316555,2012,4,0,0,4,100.0
316555,2013,4,0,0,4,100.0
316555,2014,6,0,0,6,100.0
316555,2015,5,0,0,5,100.0
316555,2016,3,0,0,3,100.0
316555,2017,6,0,0,6,100.0
316555,2018,2,0,0,2,100.0
316555,2019,2,0,0,2,100.0
316555,2020,5,0,0,5,100.0
316556,2012,2,0,0,2,100.0
316556,2013,2,0,0,2,100.0
316556,2016,1,0,0,1,100.0
316556,2017,2,0,0,2,100.0
316557,2013,1,0,0,1,100.0
316557,2014,1,0,0,1,100.0
316557,2015,3,0,0,3,100.0
316557,2016,1,0,0,1,100.0
316557,2017,1,0,0,1,100.0
316557,2019,1,0,0,1,100.0
316557,2020,4,0,0,4,100.0
316560,2012,1,1,0,2,100.0
316560,2014,0,0,1,1,0.0
316560,2015,1,0,1,2,50.0
316560,2016,0,0,1,1,0.0
316560,2019,1,0,1,2,50.0
316560,2020,1,0,0,1,100.0
316570,2013,3,0,0,3,100.0
316570,2014,4,0,0,4,100.0
316570,2015,3,0,0,3,100.0
316570,2016,2,0,0,2,100.0
316570,2017,3,0,0,3,100.0
316570,2018,1,0,0,1,100.0
316570,2019,3,0,0,3,100.0
316570,2020,1,0,0,1,100.0
316580,2016,2,0,0,2,100.0
316590,2013,1,0,0,1,100.0
316590,2014,2,0,0,2,100.0
316590,2015,1,0,1,2,50.0
316590,2016,4,0,0,4,100.0
316590,2017,2,0,0,2,100.0
316590,2018,3,0,0,3,100.0
316590,2019,2,0,1,3,66.66666666666666
316590,2020,0,0,4,4,0.0
316600,2013,2,0,0,2,100.0
316600,2014,1,0,0,1,100.0
316600,2015,0,1,1,2,50.0
316600,2017,5,0,1,6,83.33333333333334
316600,2018,0,1,0,1,100.0
316600,2019,2,0,0,2,100.0
316600,2020,2,0,0,2,100.0
316610,2012,3,0,0,3,100.0
316610,2013,1,0,0,1,100.0
316610,2014,3,0,0,3,100.0
316610,2015,1,0,0,1,100.0
316610,2016,1,0,0,1,100.0
316610,2017,1,0,0,1,100.0
316610,2018,1,0,0,1,100.0
316610,2019,3,0,0,3,100.0
316610,2020,3,0,0,3,100.0
316620,2012,4,0,0,4,100.0
316620,2013,1,0,0,1,100.0
316620,2014,3,0,0,3,100.0
316620,2015,2,0,0,2,100.0
316620,2016,2,0,0,2,100.0
316620,2017,1,0,0,1,100.0
316620,2018,3,0,0,3,100.0
316620,2019,4,0,0,4,100.0
316620,2020,4,0,0,4,100.0
316630,2012,3,0,0,3,100.0
316630,2013,3,0,0,3,100.0
316630,2014,2,0,0,2,100.0
316630,2015,2,0,0,2,100.0
316630,2016,2,0,0,2,100.0
316630,2017,2,0,0,2,100.0
316630,2018,1,0,0,1,100.0
316630,2019,2,0,0,2,100.0
316630,2020,1,0,0,1,100.0
316640,2012,0,0,1,1,0.0
316640,2013,2,0,0,2,100.0
316640,2016,2,0,0,2,100.0
316640,2017,1,0,0,1,100.0
316640,2020,1,0,0,1,100.0
316650,2013,1,0,0,1,100.0
316650,2014,2,0,0,2,100.0
316650,2015,2,0,0,2,100.0
316650,2016,1,0,0,1,100.0
316650,2018,1,0,0,1,100.0
316660,2015,1,0,0,1,100.0
316670,2012,2,0,0,2,100.0
316670,2013,6,0,0,6,100.0
316670,2014,2,0,1,3,66.66666666666666
316670,2015,4,0,0,4,100.0
316670,2016,4,0,0,4,100.0
316670,2017,4,0,0,4,100.0
316670,2018,4,0,0,4,100.0
316670,2019,1,0,0,1,100.0
316670,2020,2,0,2,4,50.0
316680,2012,3,0,0,3,100.0
316680,2013,1,0,0,1,100.0
316680,2014,5,0,0,5,100.0
316680,2015,7,0,0,7,100.0
316680,2016,4,0,0,4,100.0
316680,2018,8,0,0,8,100.0
316680,2019,6,0,0,6,100.0
316680,2020,6,0,0,6,100.0
316690,2012,2,0,0,2,100.0
316690,2013,2,0,0,2,100.0
316690,2014,3,0,0,3,100.0
316690,2015,2,0,0,2,100.0
316690,2016,5,0,0,5,100.0
316690,2017,5,0,0,5,100.0
316690,2018,2,0,0,2,100.0
316690,2019,7,0,0,7,100.0
316690,2020,4,0,0,4,100.0
316695,2012,2,0,0,2,100.0
316695,2013,2,0,0,2,100.0
316695,2014,2,0,0,2,100.0
316695,2016,1,0,0,1,100.0
316695,2017,1,0,0,1,100.0
316695,2019,4,0,0,4,100.0
316695,2020,3,0,0,3,100.0
316700,2018,1,0,0,1,100.0
316710,2012,6,0,0,6,100.0
316710,2013,9,0,0,9,100.0
316710,2014,9,0,0,9,100.0
316710,2015,8,0,0,8,100.0
316710,2016,6,0,0,6,100.0
316710,2017,6,0,0,6,100.0
316710,2018,9,0,0,9,100.0
316710,2019,5,0,0,5,100.0
316710,2020,6,0,0,6,100.0
316720,2012,86,0,0,86,100.0
316720,2013,78,0,0,78,100.0
316720,2014,72,0,0,72,100.0
316720,2015,90,0,0,90,100.0
316720,2016,85,0,0,85,100.0
316720,2017,64,0,0,64,100.0
316720,2018,81,0,0,81,100.0
316720,2019,75,0,0,75,100.0
316720,2020,76,1,0,77,100.0
316730,2012,1,0,0,1,100.0
316730,2014,1,0,0,1,100.0
316730,2016,1,0,1,2,50.0
316730,2017,2,0,0,2,100.0
316730,2018,1,0,0,1,100.0
316730,2019,1,1,0,2,100.0
316730,2020,2,0,0,2,100.0
316740,2014,2,0,0,2,100.0
316740,2015,3,0,0,3,100.0
316740,2016,1,0,0,1,100.0
316740,2018,4,0,0,4,100.0
316740,2019,3,0,0,3,100.0
316740,2020,2,0,0,2,100.0
316750,2012,2,0,0,2,100.0
316750,2013,1,0,0,1,100.0
316750,2016,2,0,0,2,100.0
316750,2019,0,0,1,1,0.0
316750,2020,0,0,2,2,0.0
316760,2012,7,0,0,7,100.0
316760,2013,6,0,1,7,85.71428571428571
316760,2014,3,0,0,3,100.0
316760,2015,12,0,0,12,100.0
316760,2016,5,0,0,5,100.0
316760,2017,3,0,0,3,100.0
316760,2018,6,0,0,6,100.0
316760,2019,7,0,0,7,100.0
316760,2020,7,0,1,8,87.5
316770,2013,1,0,0,1,100.0
316770,2014,3,0,0,3,100.0
316770,2015,3,0,0,3,100.0
316770,2016,1,0,0,1,100.0
316770,2017,1,0,0,1,100.0
316770,2018,2,0,0,2,100.0
316770,2019,2,0,0,2,100.0
316770,2020,2,0,0,2,100.0
316780,2012,1,0,1,2,50.0
316780,2014,2,0,0,2,100.0
316780,2015,2,0,0,2,100.0
316780,2016,2,0,0,2,100.0
316780,2017,7,0,0,7,100.0
316780,2019,2,0,0,2,100.0
316780,2020,1,0,0,1,100.0
316790,2012,2,0,0,2,100.0
316790,2013,3,0,0,3,100.0
316790,2014,1,0,0,1,100.0
316790,2016,1,0,0,1,100.0
316790,2018,1,0,0,1,100.0
316790,2020,2,0,0,2,100.0
316800,2012,11,0,0,11,100.0
316800,2013,12,0,0,12,100.0
316800,2014,14,0,0,14,100.0
316800,2015,10,0,0,10,100.0
316800,2016,6,0,0,6,100.0
316800,2017,7,0,0,7,100.0
316800,2018,8,0,0,8,100.0
316800,2019,9,0,0,9,100.0
316800,2020,9,0,0,9,100.0
316805,2014,0,0,1,1,0.0
316805,2016,1,0,0,1,100.0
316805,2017,5,0,0,5,100.0
316805,2018,2,0,0,2,100.0
316805,2019,1,0,0,1,100.0
316805,2020,1,0,0,1,100.0
316810,2012,2,0,0,2,100.0
316810,2014,1,0,0,1,100.0
316810,2015,1,0,0,1,100.0
316810,2016,2,0,0,2,100.0
316810,2017,3,0,0,3,100.0
316810,2018,1,0,0,1,100.0
316810,2019,2,0,0,2,100.0
316810,2020,1,0,0,1,100.0
316820,2012,1,0,0,1,100.0
316820,2016,2,0,0,2,100.0
316820,2017,3,0,0,3,100.0
316820,2019,1,0,0,1,100.0
316830,2012,1,0,0,1,100.0
316830,2014,1,0,0,1,100.0
316830,2015,1,0,0,1,100.0
316830,2016,3,0,0,3,100.0
316830,2017,1,0,0,1,100.0
316840,2012,2,0,2,4,50.0
316840,2013,4,0,0,4,100.0
316840,2014,2,0,0,2,100.0
316840,2015,8,0,0,8,100.0
316840,2016,5,0,2,7,71.42857142857143
316840,2017,3,0,0,3,100.0
316840,2018,11,0,0,11,100.0
316840,2019,7,0,0,7,100.0
316840,2020,3,0,0,3,100.0
316850,2012,2,0,4,6,33.33333333333333
316850,2013,7,0,1,8,87.5
316850,2014,3,0,0,3,100.0
316850,2015,4,0,0,4,100.0
316850,2016,3,0,0,3,100.0
316850,2017,1,0,0,1,100.0
316850,2018,3,0,0,3,100.0
316850,2019,3,1,0,4,100.0
316850,2020,2,0,0,2,100.0
316860,2012,63,0,0,63,100.0
316860,2013,61,0,0,61,100.0
316860,2014,50,0,0,50,100.0
316860,2015,54,0,1,55,98.18181818181819
316860,2016,64,0,0,64,100.0
316860,2017,63,0,0,63,100.0
316860,2018,38,0,0,38,100.0
316860,2019,40,0,0,40,100.0
316860,2020,56,0,2,58,96.55172413793103
316870,2012,20,0,0,20,100.0
316870,2013,26,0,0,26,100.0
316870,2014,18,0,0,18,100.0
316870,2015,27,0,0,27,100.0
316870,2016,24,0,0,24,100.0
316870,2017,20,0,1,21,95.23809523809523
316870,2018,21,0,0,21,100.0
316870,2019,18,0,0,18,100.0
316870,2020,28,2,0,30,100.0
316880,2012,1,0,1,2,50.0
316880,2013,1,0,0,1,100.0
316880,2014,1,0,0,1,100.0
316880,2015,3,0,0,3,100.0
316880,2016,4,0,0,4,100.0
316880,2017,3,0,0,3,100.0
316880,2018,2,0,0,2,100.0
316880,2019,2,0,0,2,100.0
316880,2020,5,0,0,5,100.0
316890,2012,2,0,0,2,100.0
316890,2013,3,0,0,3,100.0
316890,2014,2,0,0,2,100.0
316890,2015,1,0,0,1,100.0
316890,2016,3,0,0,3,100.0
316890,2017,3,0,0,3,100.0
316890,2018,1,0,0,1,100.0
316890,2020,4,0,1,5,80.0
316900,2012,6,0,0,6,100.0
316900,2013,5,0,0,5,100.0
316900,2014,2,0,0,2,100.0
316900,2015,3,0,0,3,100.0
316900,2016,4,0,0,4,100.0
316900,2017,6,0,0,6,100.0
316900,2018,10,0,0,10,100.0
316900,2019,7,0,0,7,100.0
316900,2020,4,0,0,4,100.0
316905,2012,1,0,0,1,100.0
316905,2015,2,0,0,2,100.0
316905,2017,1,0,0,1,100.0
316905,2019,1,0,0,1,100.0
316905,2020,2,0,0,2,100.0
316910,2012,2,0,0,2,100.0
316910,2013,1,0,0,1,100.0
316910,2015,1,0,0,1,100.0
316910,2016,1,0,0,1,100.0
316910,2017,1,0,0,1,100.0
316910,2018,2,0,0,2,100.0
316910,2019,1,0,0,1,100.0
316910,2020,1,0,0,1,100.0
316920,2012,2,1,0,3,100.0
316920,2013,2,0,0,2,100.0
316920,2014,7,0,0,7,100.0
316920,2016,4,0,0,4,100.0
316920,2017,6,0,0,6,100.0
316920,2018,4,0,0,4,100.0
316920,2019,4,0,0,4,100.0
316920,2020,4,0,0,4,100.0
316930,2012,30,0,0,30,100.0
316930,2013,19,0,0,19,100.0
316930,2014,25,0,2,27,92.5925925925926
316930,2015,25,0,3,28,89.28571428571429
316930,2016,33,0,0,33,100.0
316930,2017,33,0,0,33,100.0
316930,2018,24,0,0,24,100.0
316930,2019,17,0,0,17,100.0
316930,2020,35,0,0,35,100.0
316935,2012,6,0,0,6,100.0
316935,2013,9,0,0,9,100.0
316935,2014,11,0,0,11,100.0
316935,2015,6,0,0,6,100.0
316935,2016,14,0,0,14,100.0
316935,2017,13,0,0,13,100.0
316935,2018,5,0,0,5,100.0
316935,2019,8,0,0,8,100.0
316935,2020,12,0,0,12,100.0
316940,2012,25,0,0,25,100.0
316940,2013,21,0,0,21,100.0
316940,2014,22,0,0,22,100.0
316940,2015,24,0,0,24,100.0
316940,2016,19,0,0,19,100.0
316940,2017,18,0,0,18,100.0
316940,2018,25,0,0,25,100.0
316940,2019,14,0,0,14,100.0
316940,2020,29,0,0,29,100.0
316950,2012,2,0,0,2,100.0
316950,2013,2,0,0,2,100.0
316950,2014,2,0,0,2,100.0
316950,2016,0,0,2,2,0.0
316950,2017,3,0,0,3,100.0
316950,2018,4,0,0,4,100.0
316950,2019,4,0,0,4,100.0
316950,2020,2,0,0,2,100.0
316960,2012,5,2,0,7,100.0
316960,2013,7,0,0,7,100.0
316960,2014,7,0,0,7,100.0
316960,2015,4,0,0,4,100.0
316960,2016,12,0,0,12,100.0
316960,2017,11,0,0,11,100.0
316960,2018,7,0,0,7,100.0
316960,2019,4,1,0,5,100.0
316960,2020,13,0,0,13,100.0
316970,2012,4,0,2,6,66.66666666666666
316970,2013,5,0,2,7,71.42857142857143
316970,2014,5,0,2,7,71.42857142857143
316970,2015,1,0,0,1,100.0
316970,2016,6,0,0,6,100.0
316970,2017,1,0,0,1,100.0
316970,2018,1,1,1,3,66.66666666666666
316970,2019,4,0,0,4,100.0
316970,2020,6,0,0,6,100.0
316980,2012,2,0,0,2,100.0
316980,2013,1,0,0,1,100.0
316980,2014,2,0,0,2,100.0
316980,2015,1,0,0,1,100.0
316980,2016,1,0,0,1,100.0
316980,2017,5,0,0,5,100.0
316980,2018,1,0,0,1,100.0
316980,2019,3,0,0,3,100.0
316990,2012,40,0,1,41,97.5609756097561
316990,2013,34,0,0,34,100.0
316990,2014,39,0,0,39,100.0
316990,2015,42,0,0,42,100.0
316990,2016,26,0,0,26,100.0
316990,2017,23,0,0,23,100.0
316990,2018,31,0,0,31,100.0
316990,2019,31,0,0,31,100.0
316990,2020,38,0,0,38,100.0
317000,2012,2,0,0,2,100.0
317000,2013,5,0,0,5,100.0
317000,2014,5,0,0,5,100.0
317000,2016,6,0,0,6,100.0
317000,2017,8,0,0,8,100.0
317000,2018,9,0,0,9,100.0
317000,2019,9,0,0,9,100.0
317000,2020,6,0,0,6,100.0
317005,2012,3,0,0,3,100.0
317005,2013,8,0,0,8,100.0
317005,2014,4,0,0,4,100.0
317005,2015,2,0,0,2,100.0
317005,2016,10,0,0,10,100.0
317005,2017,3,0,0,3,100.0
317005,2018,4,0,0,4,100.0
317005,2019,4,1,0,5,100.0
317005,2020,5,0,0,5,100.0
317010,2012,132,0,0,132,100.0
317010,2013,107,0,0,107,100.0
317010,2014,98,0,0,98,100.0
317010,2015,110,0,0,110,100.0
317010,2016,96,0,0,96,100.0
317010,2017,102,0,0,102,100.0
317010,2018,98,0,0,98,100.0
317010,2019,92,0,12,104,88.46153846153845
317010,2020,111,0,3,114,97.36842105263158
317020,2012,179,0,0,179,100.0
317020,2013,166,0,0,166,100.0
317020,2014,186,0,1,187,99.46524064171123
317020,2015,211,0,0,211,100.0
317020,2016,204,0,0,204,100.0
317020,2017,176,0,0,176,100.0
317020,2018,166,0,0,166,100.0
317020,2019,209,0,0,209,100.0
317020,2020,200,0,0,200,100.0
317030,2012,1,0,0,1,100.0
317030,2013,1,0,0,1,100.0
317030,2014,1,0,1,2,50.0
317030,2015,1,0,0,1,100.0
317030,2016,1,0,1,2,50.0
317030,2017,1,0,0,1,100.0
317030,2018,2,0,0,2,100.0
317030,2020,0,0,1,1,0.0
317040,2012,20,0,7,27,74.07407407407408
317040,2013,23,0,0,23,100.0
317040,2014,28,0,0,28,100.0
317040,2015,16,1,2,19,89.47368421052632
317040,2016,20,0,2,22,90.9090909090909
317040,2017,20,2,4,26,84.61538461538461
317040,2018,26,0,2,28,92.85714285714286
317040,2019,28,0,2,30,93.33333333333333
317040,2020,18,0,9,27,66.66666666666666
317043,2012,4,0,0,4,100.0
317043,2013,2,0,0,2,100.0
317043,2014,3,0,0,3,100.0
317043,2015,1,0,0,1,100.0
317043,2016,2,0,0,2,100.0
317043,2017,3,0,0,3,100.0
317043,2018,1,0,0,1,100.0
317043,2020,0,0,2,2,0.0
317047,2012,3,0,0,3,100.0
317047,2014,4,0,0,4,100.0
317047,2015,3,0,0,3,100.0
317047,2018,1,0,0,1,100.0
317047,2019,1,0,0,1,100.0
317047,2020,3,0,0,3,100.0
317050,2012,2,0,1,3,66.66666666666666
317050,2013,7,0,0,7,100.0
317050,2014,2,0,1,3,66.66666666666666
317050,2015,5,0,0,5,100.0
317050,2016,3,0,0,3,100.0
317050,2017,4,0,2,6,66.66666666666666
317050,2018,6,0,0,6,100.0
317050,2019,6,0,1,7,85.71428571428571
317050,2020,4,0,0,4,100.0
317052,2012,3,0,0,3,100.0
317052,2014,5,0,0,5,100.0
317052,2015,2,0,0,2,100.0
317052,2016,4,0,0,4,100.0
317052,2017,1,0,0,1,100.0
317052,2018,1,0,0,1,100.0
317052,2019,2,0,0,2,100.0
317052,2020,1,0,0,1,100.0
317057,2012,6,0,0,6,100.0
317057,2013,1,0,0,1,100.0
317057,2014,2,0,0,2,100.0
317057,2015,1,0,0,1,100.0
317057,2016,1,0,0,1,100.0
317057,2017,1,0,0,1,100.0
317057,2018,1,0,0,1,100.0
317057,2020,3,0,0,3,100.0
317060,2013,1,0,0,1,100.0
317060,2015,1,0,0,1,100.0
317060,2016,2,0,0,2,100.0
317060,2018,1,0,0,1,100.0
317065,2012,3,0,0,3,100.0
317065,2013,2,0,0,2,100.0
317065,2014,3,0,0,3,100.0
317065,2015,1,0,0,1,100.0
317065,2018,1,0,0,1,100.0
317065,2019,1,0,0,1,100.0
317065,2020,1,0,0,1,100.0
317070,2012,39,0,4,43,90.69767441860465
317070,2013,36,0,4,40,90.0
317070,2014,32,0,7,39,82.05128205128204
317070,2015,36,1,6,43,86.04651162790698
317070,2016,39,2,2,43,95.34883720930233
317070,2017,48,0,1,49,97.95918367346938
317070,2018,40,1,2,43,95.34883720930233
317070,2019,42,0,0,42,100.0
317070,2020,21,0,19,40,52.5
317075,2012,2,0,0,2,100.0
317075,2013,1,0,0,1,100.0
317075,2014,3,0,0,3,100.0
317075,2015,5,0,0,5,100.0
317075,2016,3,0,0,3,100.0
317075,2017,2,0,0,2,100.0
317075,2018,2,0,0,2,100.0
317075,2019,2,0,0,2,100.0
317075,2020,1,0,0,1,100.0
317080,2012,8,0,0,8,100.0
317080,2013,19,0,0,19,100.0
317080,2014,22,0,0,22,100.0
317080,2015,12,0,0,12,100.0
317080,2016,7,0,0,7,100.0
317080,2017,12,0,0,12,100.0
317080,2018,13,0,0,13,100.0
317080,2019,12,1,0,13,100.0
317080,2020,7,0,0,7,100.0
317090,2012,1,0,0,1,100.0
317090,2013,11,0,0,11,100.0
317090,2014,4,0,0,4,100.0
317090,2015,4,0,0,4,100.0
317090,2016,2,0,0,2,100.0
317090,2017,7,0,0,7,100.0
317090,2018,5,0,0,5,100.0
317090,2019,2,0,0,2,100.0
317090,2020,2,0,0,2,100.0
317100,2012,6,0,0,6,100.0
317100,2013,5,0,0,5,100.0
317100,2014,7,0,0,7,100.0
317100,2015,8,0,0,8,100.0
317100,2016,4,2,1,7,85.71428571428571
317100,2017,4,0,0,4,100.0
317100,2018,11,0,0,11,100.0
317100,2019,9,0,0,9,100.0
317100,2020,9,0,0,9,100.0
317103,2012,4,0,0,4,100.0
317103,2013,5,0,1,6,83.33333333333334
317103,2014,3,0,0,3,100.0
317103,2015,8,0,0,8,100.0
317103,2016,6,0,0,6,100.0
317103,2017,1,0,0,1,100.0
317103,2018,4,0,0,4,100.0
317103,2019,6,0,0,6,100.0
317103,2020,2,0,0,2,100.0
317107,2015,2,0,0,2,100.0
317107,2016,1,0,0,1,100.0
317107,2017,1,0,0,1,100.0
317107,2019,0,0,1,1,0.0
317110,2012,4,0,0,4,100.0
317110,2013,2,0,0,2,100.0
317110,2014,1,0,1,2,50.0
317110,2017,1,0,0,1,100.0
317110,2018,1,0,0,1,100.0
317110,2019,2,0,0,2,100.0
317115,2013,2,0,0,2,100.0
317115,2015,2,0,0,2,100.0
317115,2016,1,0,0,1,100.0
317115,2017,2,0,0,2,100.0
317115,2018,1,0,0,1,100.0
317115,2020,3,0,0,3,100.0
317120,2012,30,0,0,30,100.0
317120,2013,43,4,0,47,100.0
317120,2014,55,3,0,58,100.0
317120,2015,37,0,0,37,100.0
317120,2016,39,1,0,40,100.0
317120,2017,36,0,2,38,94.73684210526315
317120,2018,36,0,0,36,100.0
317120,2019,31,1,2,34,94.11764705882352
317120,2020,25,2,9,36,75.0
317130,2012,13,2,1,16,93.75
317130,2013,22,0,0,22,100.0
317130,2014,14,0,0,14,100.0
317130,2015,16,0,0,16,100.0
317130,2016,29,0,0,29,100.0
317130,2017,30,0,0,30,100.0
317130,2018,22,0,0,22,100.0
317130,2019,21,0,0,21,100.0
317130,2020,16,0,0,16,100.0
317140,2013,1,0,0,1,100.0
317140,2014,3,0,0,3,100.0
317140,2015,1,0,0,1,100.0
317140,2016,1,0,0,1,100.0
317140,2017,2,1,0,3,100.0
317140,2018,1,0,0,1,100.0
317150,2012,1,0,0,1,100.0
317150,2013,3,0,0,3,100.0
317150,2014,1,0,1,2,50.0
317150,2015,2,0,0,2,100.0
317150,2016,1,0,0,1,100.0
317150,2017,4,0,0,4,100.0
317150,2019,1,0,0,1,100.0
317150,2020,1,0,0,1,100.0
317160,2012,5,0,0,5,100.0
317160,2013,5,0,0,5,100.0
317160,2014,3,0,0,3,100.0
317160,2015,1,0,0,1,100.0
317160,2016,6,0,0,6,100.0
317160,2017,2,0,0,2,100.0
317160,2018,2,0,0,2,100.0
317160,2019,4,0,0,4,100.0
317160,2020,4,0,0,4,100.0
317170,2012,4,0,0,4,100.0
317170,2013,1,1,0,2,100.0
317170,2014,2,0,0,2,100.0
317170,2015,2,0,0,2,100.0
317170,2016,2,0,0,2,100.0
317170,2017,4,0,0,4,100.0
317170,2018,1,0,0,1,100.0
317170,2019,3,0,0,3,100.0
317170,2020,6,0,0,6,100.0
317180,2012,4,0,0,4,100.0
317180,2013,5,0,0,5,100.0
317180,2014,2,0,0,2,100.0
317180,2015,4,0,0,4,100.0
317180,2016,4,0,0,4,100.0
317180,2017,1,0,0,1,100.0
317180,2018,2,1,0,3,100.0
317180,2019,1,0,0,1,100.0
317180,2020,4,0,0,4,100.0
317190,2012,1,0,0,1,100.0
317190,2013,2,0,0,2,100.0
317190,2015,2,0,0,2,100.0
317190,2016,3,0,0,3,100.0
317190,2017,4,0,0,4,100.0
317190,2018,5,0,0,5,100.0
317200,2012,13,0,0,13,100.0
317200,2013,16,0,0,16,100.0
317200,2014,19,0,0,19,100.0
317200,2015,13,0,0,13,100.0
317200,2016,14,0,0,14,100.0
317200,2017,15,0,0,15,100.0
317200,2018,20,0,0,20,100.0
317200,2019,17,0,0,17,100.0
317200,2020,13,0,0,13,100.0
317210,2012,4,0,0,4,100.0
317210,2013,2,0,0,2,100.0
317210,2014,4,0,0,4,100.0
317210,2015,1,0,0,1,100.0
317210,2016,2,0,0,2,100.0
317210,2017,1,0,0,1,100.0
317210,2018,2,0,0,2,100.0
317210,2019,4,0,0,4,100.0
317210,2020,1,0,0,1,100.0
317220,2012,1,0,0,1,100.0
317220,2013,1,0,0,1,100.0
317220,2015,1,0,0,1,100.0
317220,2016,1,0,0,1,100.0
317220,2019,2,0,0,2,100.0
317220,2020,1,0,0,1,100.0
320000,2016,0,0,2,2,0.0
320000,2017,0,1,0,1,100.0
320000,2020,0,0,4,4,0.0
320010,2012,14,0,0,14,100.0
320010,2013,9,0,0,9,100.0
320010,2014,7,0,0,7,100.0
320010,2015,14,0,0,14,100.0
320010,2016,9,0,0,9,100.0
320010,2017,8,0,0,8,100.0
320010,2018,11,0,0,11,100.0
320010,2019,11,0,1,12,91.66666666666666
320010,2020,12,0,0,12,100.0
320013,2012,4,0,0,4,100.0
320013,2013,5,0,0,5,100.0
320013,2015,5,0,0,5,100.0
320013,2016,1,0,0,1,100.0
320013,2018,1,0,0,1,100.0
320013,2019,4,0,0,4,100.0
320013,2020,4,0,0,4,100.0
320016,2012,1,0,0,1,100.0
320016,2013,2,0,0,2,100.0
320016,2014,1,0,0,1,100.0
320016,2015,7,0,0,7,100.0
320016,2016,5,0,0,5,100.0
320016,2017,5,0,2,7,71.42857142857143
320016,2018,0,0,5,5,0.0
320016,2019,0,0,4,4,0.0
320016,2020,0,0,6,6,0.0
320020,2012,13,0,0,13,100.0
320020,2013,12,0,0,12,100.0
320020,2014,8,0,0,8,100.0
320020,2015,9,0,0,9,100.0
320020,2016,14,0,0,14,100.0
320020,2017,14,0,0,14,100.0
320020,2018,6,0,0,6,100.0
320020,2019,17,0,0,17,100.0
320020,2020,15,0,0,15,100.0
320030,2012,3,0,0,3,100.0
320030,2013,5,0,0,5,100.0
320030,2014,3,0,0,3,100.0
320030,2015,6,0,0,6,100.0
320030,2016,4,0,0,4,100.0
320030,2017,6,0,0,6,100.0
320030,2018,3,0,0,3,100.0
320030,2019,2,0,0,2,100.0
320030,2020,7,0,0,7,100.0
320035,2013,2,0,0,2,100.0
320035,2014,1,0,0,1,100.0
320035,2015,3,0,0,3,100.0
320035,2016,4,0,0,4,100.0
320035,2017,4,0,0,4,100.0
320035,2018,2,0,0,2,100.0
320035,2019,0,0,1,1,0.0
320035,2020,0,0,5,5,0.0
320040,2012,5,0,0,5,100.0
320040,2013,8,0,0,8,100.0
320040,2014,13,0,0,13,100.0
320040,2015,5,0,0,5,100.0
320040,2016,7,0,0,7,100.0
320040,2017,7,0,0,7,100.0
320040,2018,7,0,0,7,100.0
320040,2019,13,0,0,13,100.0
320040,2020,9,0,0,9,100.0
320050,2012,1,0,0,1,100.0
320050,2013,2,0,0,2,100.0
320050,2014,4,0,0,4,100.0
320050,2015,3,0,0,3,100.0
320050,2016,3,0,0,3,100.0
320050,2017,3,0,0,3,100.0
320050,2018,1,0,0,1,100.0
320050,2019,4,0,0,4,100.0
320050,2020,4,0,0,4,100.0
320060,2012,24,0,0,24,100.0
320060,2013,33,0,1,34,97.05882352941177
320060,2014,30,0,2,32,93.75
320060,2015,20,0,0,20,100.0
320060,2016,21,0,11,32,65.625
320060,2017,23,0,0,23,100.0
320060,2018,25,0,0,25,100.0
320060,2019,13,0,3,16,81.25
320060,2020,36,0,2,38,94.73684210526315
320070,2012,4,0,0,4,100.0
320070,2013,2,0,0,2,100.0
320070,2014,3,0,0,3,100.0
320070,2015,4,0,0,4,100.0
320070,2016,2,0,0,2,100.0
320070,2017,3,0,0,3,100.0
320070,2018,4,0,0,4,100.0
320070,2019,4,0,0,4,100.0
320070,2020,3,0,0,3,100.0
320080,2012,11,0,0,11,100.0
320080,2013,13,0,0,13,100.0
320080,2014,14,0,0,14,100.0
320080,2015,9,0,0,9,100.0
320080,2016,13,0,0,13,100.0
320080,2017,9,0,0,9,100.0
320080,2018,6,0,0,6,100.0
320080,2019,13,0,0,13,100.0
320080,2020,15,0,0,15,100.0
320090,2012,19,0,0,19,100.0
320090,2013,13,0,0,13,100.0
320090,2014,21,0,0,21,100.0
320090,2015,10,0,0,10,100.0
320090,2016,13,0,0,13,100.0
320090,2017,11,0,0,11,100.0
320090,2018,12,0,1,13,92.3076923076923
320090,2019,8,0,4,12,66.66666666666666
320090,2020,17,0,0,17,100.0
320100,2012,11,0,0,11,100.0
320100,2013,2,1,4,7,42.857142857142854
320100,2014,4,0,0,4,100.0
320100,2015,1,0,0,1,100.0
320100,2016,7,0,0,7,100.0
320100,2017,6,0,0,6,100.0
320100,2018,1,0,2,3,33.33333333333333
320100,2019,5,0,1,6,83.33333333333334
320100,2020,0,0,4,4,0.0
320110,2012,3,0,0,3,100.0
320110,2013,7,0,0,7,100.0
320110,2014,3,0,0,3,100.0
320110,2015,5,0,0,5,100.0
320110,2016,5,1,0,6,100.0
320110,2017,6,0,0,6,100.0
320110,2018,2,0,0,2,100.0
320110,2019,4,0,0,4,100.0
320110,2020,5,0,0,5,100.0
320115,2012,5,0,0,5,100.0
320115,2013,4,0,2,6,66.66666666666666
320115,2014,7,0,1,8,87.5
320115,2015,2,0,0,2,100.0
320115,2016,1,0,0,1,100.0
320115,2017,0,0,2,2,0.0
320115,2018,3,0,0,3,100.0
320115,2019,3,0,0,3,100.0
320115,2020,5,0,1,6,83.33333333333334
320120,2012,55,1,4,60,93.33333333333333
320120,2013,75,0,0,75,100.0
320120,2014,82,0,0,82,100.0
320120,2015,64,0,0,64,100.0
320120,2016,70,0,0,70,100.0
320120,2017,69,0,0,69,100.0
320120,2018,63,0,0,63,100.0
320120,2019,49,0,0,49,100.0
320120,2020,69,0,0,69,100.0
320130,2012,124,2,25,151,83.44370860927152
320130,2013,136,5,11,152,92.76315789473685
320130,2014,2,32,123,157,21.656050955414013
320130,2015,124,0,0,124,100.0
320130,2016,131,0,0,131,100.0
320130,2017,140,0,2,142,98.59154929577466
320130,2018,140,0,0,140,100.0
320130,2019,139,0,0,139,100.0
320130,2020,167,2,1,170,99.41176470588235
320140,2012,10,0,0,10,100.0
320140,2013,9,0,0,9,100.0
320140,2014,12,0,0,12,100.0
320140,2015,9,0,0,9,100.0
320140,2016,13,0,0,13,100.0
320140,2017,12,0,0,12,100.0
320140,2018,7,0,0,7,100.0
320140,2019,9,0,0,9,100.0
320140,2020,13,0,0,13,100.0
320150,2012,39,0,4,43,90.69767441860465
320150,2013,36,0,3,39,92.3076923076923
320150,2014,37,0,0,37,100.0
320150,2015,33,2,5,40,87.5
320150,2016,38,0,0,38,100.0
320150,2017,31,0,1,32,96.875
320150,2018,38,0,0,38,100.0
320150,2019,34,0,1,35,97.14285714285714
320150,2020,26,0,3,29,89.65517241379311
320160,2012,9,0,1,10,90.0
320160,2013,17,0,0,17,100.0
320160,2014,23,0,0,23,100.0
320160,2015,15,0,0,15,100.0
320160,2016,9,0,0,9,100.0
320160,2017,19,0,0,19,100.0
320160,2018,12,0,0,12,100.0
320160,2019,11,0,0,11,100.0
320160,2020,10,0,1,11,90.9090909090909
320170,2012,7,0,0,7,100.0
320170,2013,4,0,0,4,100.0
320170,2014,5,0,0,5,100.0
320170,2015,4,0,0,4,100.0
320170,2016,3,0,0,3,100.0
320170,2017,3,0,0,3,100.0
320170,2018,3,0,0,3,100.0
320170,2019,9,0,0,9,100.0
320170,2020,5,0,0,5,100.0
320180,2012,1,0,0,1,100.0
320180,2013,1,0,0,1,100.0
320180,2014,1,1,1,3,66.66666666666666
320180,2015,0,0,2,2,0.0
320180,2016,0,0,5,5,0.0
320180,2017,0,0,2,2,0.0
320180,2018,0,0,1,1,0.0
320180,2019,0,0,1,1,0.0
320190,2012,6,0,0,6,100.0
320190,2013,4,0,0,4,100.0
320190,2014,10,0,0,10,100.0
320190,2015,6,0,0,6,100.0
320190,2016,9,0,0,9,100.0
320190,2017,13,0,0,13,100.0
320190,2018,6,0,0,6,100.0
320190,2019,10,0,0,10,100.0
320190,2020,10,0,0,10,100.0
320200,2012,3,0,0,3,100.0
320200,2013,1,0,0,1,100.0
320200,2014,2,0,0,2,100.0
320200,2015,3,0,0,3,100.0
320200,2016,1,0,0,1,100.0
320200,2017,1,0,0,1,100.0
320200,2018,1,0,0,1,100.0
320200,2020,2,0,0,2,100.0
320210,2012,4,1,2,7,71.42857142857143
320210,2013,1,1,6,8,25.0
320210,2014,0,0,11,11,0.0
320210,2015,6,0,5,11,54.54545454545454
320210,2016,6,0,0,6,100.0
320210,2017,5,0,0,5,100.0
320210,2018,0,0,11,11,0.0
320210,2019,0,0,9,9,0.0
320210,2020,10,0,0,10,100.0
320220,2012,7,0,0,7,100.0
320220,2013,3,1,0,4,100.0
320220,2014,11,2,1,14,92.85714285714286
320220,2015,5,0,0,5,100.0
320220,2016,5,0,0,5,100.0
320220,2017,10,0,0,10,100.0
320220,2018,5,0,0,5,100.0
320220,2019,5,0,0,5,100.0
320220,2020,8,0,1,9,88.88888888888889
320225,2012,5,0,0,5,100.0
320225,2013,4,0,1,5,80.0
320225,2014,4,0,0,4,100.0
320225,2015,1,0,0,1,100.0
320225,2016,4,0,0,4,100.0
320225,2017,5,0,0,5,100.0
320225,2018,4,0,0,4,100.0
320225,2020,3,0,0,3,100.0
320230,2012,9,0,1,10,90.0
320230,2013,6,0,0,6,100.0
320230,2014,11,0,0,11,100.0
320230,2015,15,0,0,15,100.0
320230,2016,11,0,0,11,100.0
320230,2017,15,0,0,15,100.0
320230,2018,13,0,0,13,100.0
320230,2019,7,0,0,7,100.0
320230,2020,12,0,0,12,100.0
320240,2012,25,2,22,49,55.10204081632652
320240,2013,38,0,0,38,100.0
320240,2014,51,0,0,51,100.0
320240,2015,40,0,0,40,100.0
320240,2016,38,0,0,38,100.0
320240,2017,33,0,0,33,100.0
320240,2018,36,0,0,36,100.0
320240,2019,33,0,0,33,100.0
320240,2020,49,0,0,49,100.0
320245,2012,5,0,0,5,100.0
320245,2013,6,0,0,6,100.0
320245,2014,6,0,0,6,100.0
320245,2015,3,0,1,4,75.0
320245,2016,8,0,2,10,80.0
320245,2017,14,0,0,14,100.0
320245,2018,6,0,0,6,100.0
320245,2019,5,0,0,5,100.0
320245,2020,10,0,0,10,100.0
320250,2012,6,0,0,6,100.0
320250,2013,5,0,0,5,100.0
320250,2014,5,0,0,5,100.0
320250,2015,4,0,0,4,100.0
320250,2016,1,0,0,1,100.0
320250,2017,2,0,0,2,100.0
320250,2018,7,0,0,7,100.0
320250,2019,2,0,0,2,100.0
320250,2020,2,0,0,2,100.0
320255,2012,1,0,1,2,50.0
320255,2013,0,0,2,2,0.0
320255,2014,0,0,4,4,0.0
320255,2015,0,0,2,2,0.0
320255,2016,0,0,3,3,0.0
320255,2017,0,1,5,6,16.666666666666664
320255,2019,0,0,3,3,0.0
320255,2020,6,0,0,6,100.0
320260,2012,7,0,0,7,100.0
320260,2013,1,0,0,1,100.0
320260,2014,2,0,0,2,100.0
320260,2015,6,0,0,6,100.0
320260,2016,2,0,0,2,100.0
320260,2017,2,0,0,2,100.0
320260,2018,3,0,0,3,100.0
320260,2019,2,0,0,2,100.0
320260,2020,7,0,0,7,100.0
320265,2012,7,0,0,7,100.0
320265,2013,2,0,0,2,100.0
320265,2014,8,0,0,8,100.0
320265,2015,4,0,0,4,100.0
320265,2016,8,0,0,8,100.0
320265,2017,3,0,0,3,100.0
320265,2018,5,0,0,5,100.0
320265,2020,5,0,0,5,100.0
320270,2012,3,0,0,3,100.0
320270,2013,4,0,0,4,100.0
320270,2014,3,0,0,3,100.0
320270,2015,6,0,0,6,100.0
320270,2016,3,0,0,3,100.0
320270,2017,3,0,0,3,100.0
320270,2018,3,0,0,3,100.0
320270,2019,3,0,0,3,100.0
320270,2020,6,0,0,6,100.0
320280,2012,13,0,0,13,100.0
320280,2013,12,0,0,12,100.0
320280,2014,5,0,2,7,71.42857142857143
320280,2015,9,0,0,9,100.0
320280,2016,19,0,0,19,100.0
320280,2017,10,0,0,10,100.0
320280,2018,12,0,0,12,100.0
320280,2019,17,0,1,18,94.44444444444444
320280,2020,13,0,0,13,100.0
320290,2012,2,0,0,2,100.0
320290,2013,4,0,0,4,100.0
320290,2014,4,0,0,4,100.0
320290,2015,1,0,0,1,100.0
320290,2016,1,0,0,1,100.0
320290,2017,5,0,0,5,100.0
320290,2018,5,0,0,5,100.0
320290,2019,2,0,0,2,100.0
320290,2020,2,0,0,2,100.0
320300,2012,14,0,0,14,100.0
320300,2013,4,0,0,4,100.0
320300,2014,11,0,0,11,100.0
320300,2015,8,0,0,8,100.0
320300,2016,8,0,1,9,88.88888888888889
320300,2017,12,0,0,12,100.0
320300,2018,8,0,0,8,100.0
320300,2019,13,0,0,13,100.0
320300,2020,14,0,0,14,100.0
320305,2012,12,0,0,12,100.0
320305,2013,7,0,0,7,100.0
320305,2014,12,0,0,12,100.0
320305,2015,17,0,0,17,100.0
320305,2016,13,0,0,13,100.0
320305,2017,7,0,0,7,100.0
320305,2018,9,0,0,9,100.0
320305,2019,13,0,0,13,100.0
320305,2020,8,0,0,8,100.0
320310,2012,4,0,0,4,100.0
320310,2013,4,0,0,4,100.0
320310,2014,11,0,0,11,100.0
320310,2015,3,0,0,3,100.0
320310,2016,4,0,0,4,100.0
320310,2017,4,0,0,4,100.0
320310,2018,5,0,0,5,100.0
320310,2019,4,0,2,6,66.66666666666666
320310,2020,3,0,0,3,100.0
320313,2012,2,0,0,2,100.0
320313,2013,3,0,0,3,100.0
320313,2014,8,0,0,8,100.0
320313,2015,5,0,0,5,100.0
320313,2016,6,0,0,6,100.0
320313,2017,5,0,1,6,83.33333333333334
320313,2018,5,0,0,5,100.0
320313,2019,2,0,0,2,100.0
320313,2020,2,0,0,2,100.0
320316,2012,3,0,1,4,75.0
320316,2013,1,0,1,2,50.0
320316,2014,3,0,0,3,100.0
320316,2015,2,0,1,3,66.66666666666666
320316,2016,3,0,0,3,100.0
320316,2017,0,0,1,1,0.0
320316,2018,3,0,0,3,100.0
320316,2019,1,0,0,1,100.0
320316,2020,1,0,0,1,100.0
320320,2012,52,0,3,55,94.54545454545455
320320,2013,47,0,1,48,97.91666666666666
320320,2014,61,1,0,62,100.0
320320,2015,62,0,0,62,100.0
320320,2016,52,0,0,52,100.0
320320,2017,52,0,0,52,100.0
320320,2018,68,0,0,68,100.0
320320,2019,59,0,0,59,100.0
320320,2020,63,0,0,63,100.0
320330,2012,0,1,7,8,12.5
320330,2013,1,0,5,6,16.666666666666664
320330,2014,4,0,0,4,100.0
320330,2015,5,0,0,5,100.0
320330,2016,5,2,0,7,100.0
320330,2017,1,1,1,3,66.66666666666666
320330,2018,4,0,4,8,50.0
320330,2019,0,0,4,4,0.0
320330,2020,1,0,1,2,50.0
320332,2012,11,1,0,12,100.0
320332,2013,11,0,0,11,100.0
320332,2014,7,0,0,7,100.0
320332,2015,8,0,0,8,100.0
320332,2016,8,0,0,8,100.0
320332,2017,20,0,0,20,100.0
320332,2018,13,0,0,13,100.0
320332,2019,5,0,0,5,100.0
320332,2020,15,0,0,15,100.0
320334,2012,5,0,0,5,100.0
320334,2013,9,0,0,9,100.0
320334,2015,6,0,0,6,100.0
320334,2016,3,0,0,3,100.0
320334,2017,2,0,0,2,100.0
320334,2018,7,0,0,7,100.0
320334,2019,3,0,0,3,100.0
320334,2020,10,0,0,10,100.0
320335,2012,4,0,0,4,100.0
320335,2013,3,0,0,3,100.0
320335,2014,1,0,0,1,100.0
320335,2015,3,0,0,3,100.0
320335,2016,6,0,0,6,100.0
320335,2017,3,0,0,3,100.0
320335,2018,2,0,0,2,100.0
320335,2019,2,0,0,2,100.0
320335,2020,3,0,0,3,100.0
320340,2012,7,0,0,7,100.0
320340,2013,9,0,0,9,100.0
320340,2014,5,0,0,5,100.0
320340,2015,6,0,0,6,100.0
320340,2016,7,0,0,7,100.0
320340,2017,7,0,0,7,100.0
320340,2018,7,0,0,7,100.0
320340,2019,7,0,2,9,77.77777777777779
320340,2020,0,1,6,7,14.285714285714285
320350,2012,8,0,0,8,100.0
320350,2013,10,0,1,11,90.9090909090909
320350,2014,2,0,0,2,100.0
320350,2015,10,0,0,10,100.0
320350,2016,12,0,0,12,100.0
320350,2017,7,0,0,7,100.0
320350,2018,5,0,0,5,100.0
320350,2019,11,0,0,11,100.0
320350,2020,5,0,0,5,100.0
320360,2012,4,0,0,4,100.0
320360,2013,2,0,1,3,66.66666666666666
320360,2014,2,0,0,2,100.0
320360,2015,3,0,0,3,100.0
320360,2016,2,0,0,2,100.0
320360,2017,4,0,0,4,100.0
320360,2018,1,0,0,1,100.0
320360,2019,2,0,0,2,100.0
320360,2020,4,0,1,5,80.0
320370,2012,4,0,0,4,100.0
320370,2013,6,0,0,6,100.0
320370,2014,5,0,0,5,100.0
320370,2015,6,0,0,6,100.0
320370,2016,1,0,0,1,100.0
320370,2017,6,0,0,6,100.0
320370,2018,8,0,0,8,100.0
320370,2019,5,0,0,5,100.0
320370,2020,4,0,0,4,100.0
320380,2012,4,0,0,4,100.0
320380,2013,4,0,0,4,100.0
320380,2014,7,0,0,7,100.0
320380,2015,2,0,0,2,100.0
320380,2016,1,0,2,3,33.33333333333333
320380,2017,0,2,5,7,28.57142857142857
320380,2018,0,0,3,3,0.0
320380,2019,2,0,0,2,100.0
320380,2020,2,0,0,2,100.0
320390,2012,14,0,0,14,100.0
320390,2013,23,0,0,23,100.0
320390,2014,21,0,0,21,100.0
320390,2015,17,0,1,18,94.44444444444444
320390,2016,22,0,0,22,100.0
320390,2017,13,0,1,14,92.85714285714286
320390,2018,21,0,0,21,100.0
320390,2019,18,0,0,18,100.0
320390,2020,16,0,0,16,100.0
320400,2012,3,0,6,9,33.33333333333333
320400,2013,4,1,4,9,55.55555555555556
320400,2014,4,0,0,4,100.0
320400,2015,10,0,0,10,100.0
320400,2016,4,0,0,4,100.0
320400,2017,5,0,0,5,100.0
320400,2018,4,0,0,4,100.0
320400,2019,4,0,0,4,100.0
320400,2020,15,0,0,15,100.0
320405,2012,11,0,0,11,100.0
320405,2013,6,0,0,6,100.0
320405,2014,7,0,1,8,87.5
320405,2015,14,0,1,15,93.33333333333333
320405,2016,7,0,0,7,100.0
320405,2017,5,0,0,5,100.0
320405,2018,7,0,0,7,100.0
320405,2019,4,0,1,5,80.0
320405,2020,14,0,0,14,100.0
320410,2012,12,0,0,12,100.0
320410,2013,10,0,0,10,100.0
320410,2014,10,0,0,10,100.0
320410,2015,19,0,0,19,100.0
320410,2016,7,0,0,7,100.0
320410,2017,14,0,0,14,100.0
320410,2018,10,0,0,10,100.0
320410,2019,14,0,3,17,82.35294117647058
320410,2020,10,0,0,10,100.0
320420,2012,5,0,0,5,100.0
320420,2013,3,0,0,3,100.0
320420,2014,6,0,1,7,85.71428571428571
320420,2015,5,0,0,5,100.0
320420,2016,7,0,0,7,100.0
320420,2017,6,0,0,6,100.0
320420,2018,5,0,0,5,100.0
320420,2019,5,0,0,5,100.0
320420,2020,11,0,0,11,100.0
320425,2012,2,0,1,3,66.66666666666666
320425,2013,3,0,1,4,75.0
320425,2014,2,0,0,2,100.0
320425,2015,1,0,0,1,100.0
320425,2016,3,0,0,3,100.0
320425,2017,1,0,0,1,100.0
320425,2018,2,0,0,2,100.0
320425,2019,2,2,0,4,100.0
320425,2020,1,0,1,2,50.0
320430,2012,6,0,0,6,100.0
320430,2013,7,0,0,7,100.0
320430,2015,1,0,0,1,100.0
320430,2016,4,0,0,4,100.0
320430,2017,2,0,0,2,100.0
320430,2018,2,0,0,2,100.0
320430,2019,1,0,0,1,100.0
320430,2020,4,0,0,4,100.0
320435,2012,3,0,0,3,100.0
320435,2013,5,0,0,5,100.0
320435,2014,8,0,0,8,100.0
320435,2015,3,0,0,3,100.0
320435,2016,8,0,0,8,100.0
320435,2017,2,0,0,2,100.0
320435,2018,3,0,0,3,100.0
320435,2019,3,0,0,3,100.0
320435,2020,6,0,0,6,100.0
320440,2012,5,0,0,5,100.0
320440,2013,1,0,0,1,100.0
320440,2014,7,0,0,7,100.0
320440,2015,3,0,0,3,100.0
320440,2016,4,0,0,4,100.0
320440,2017,1,0,0,1,100.0
320440,2018,6,0,0,6,100.0
320440,2019,6,0,0,6,100.0
320440,2020,3,0,0,3,100.0
320450,2012,2,0,0,2,100.0
320450,2013,3,0,0,3,100.0
320450,2014,2,0,0,2,100.0
320450,2015,6,0,1,7,85.71428571428571
320450,2016,4,0,0,4,100.0
320450,2017,2,0,0,2,100.0
320450,2018,5,0,0,5,100.0
320450,2019,3,0,0,3,100.0
320450,2020,2,0,0,2,100.0
320455,2012,8,0,0,8,100.0
320455,2013,12,0,0,12,100.0
320455,2014,10,0,0,10,100.0
320455,2015,17,0,1,18,94.44444444444444
320455,2016,12,0,2,14,85.71428571428571
320455,2017,8,0,3,11,72.72727272727273
320455,2018,5,0,4,9,55.55555555555556
320455,2019,12,0,0,12,100.0
320455,2020,9,0,0,9,100.0
320460,2012,7,0,0,7,100.0
320460,2013,3,0,0,3,100.0
320460,2014,14,0,0,14,100.0
320460,2015,2,0,1,3,66.66666666666666
320460,2016,0,0,3,3,0.0
320460,2017,6,0,0,6,100.0
320460,2018,6,0,0,6,100.0
320460,2019,3,0,0,3,100.0
320460,2020,12,0,0,12,100.0
320465,2012,2,0,0,2,100.0
320465,2013,3,0,0,3,100.0
320465,2014,4,0,0,4,100.0
320465,2015,2,0,0,2,100.0
320465,2016,2,0,0,2,100.0
320465,2017,1,0,0,1,100.0
320465,2018,1,0,0,1,100.0
320465,2019,0,0,5,5,0.0
320465,2020,6,0,0,6,100.0
320470,2012,10,0,1,11,90.9090909090909
320470,2013,15,0,0,15,100.0
320470,2014,8,0,0,8,100.0
320470,2015,11,0,0,11,100.0
320470,2016,12,0,0,12,100.0
320470,2017,15,0,0,15,100.0
320470,2018,14,0,0,14,100.0
320470,2019,11,0,0,11,100.0
320470,2020,14,0,0,14,100.0
320480,2012,5,0,0,5,100.0
320480,2013,3,0,0,3,100.0
320480,2014,8,0,0,8,100.0
320480,2015,2,0,0,2,100.0
320480,2017,7,0,0,7,100.0
320480,2018,6,0,0,6,100.0
320480,2019,2,0,0,2,100.0
320480,2020,5,0,0,5,100.0
320490,2012,46,2,3,51,94.11764705882352
320490,2013,50,1,3,54,94.44444444444444
320490,2014,44,0,1,45,97.77777777777777
320490,2015,46,0,2,48,95.83333333333334
320490,2016,45,0,0,45,100.0
320490,2017,49,0,1,50,98.0
320490,2018,37,0,0,37,100.0
320490,2019,49,0,0,49,100.0
320490,2020,57,0,3,60,95.0
320495,2012,3,0,0,3,100.0
320495,2013,4,0,0,4,100.0
320495,2015,4,0,0,4,100.0
320495,2016,2,0,0,2,100.0
320495,2017,3,0,0,3,100.0
320495,2018,2,0,0,2,100.0
320495,2019,1,0,1,2,50.0
320495,2020,1,0,1,2,50.0
320500,2012,180,0,0,180,100.0
320500,2013,175,0,1,176,99.43181818181817
320500,2014,163,0,0,163,100.0
320500,2015,162,0,1,163,99.38650306748467
320500,2016,169,0,0,169,100.0
320500,2017,146,0,1,147,99.31972789115646
320500,2018,132,0,0,132,100.0
320500,2019,163,0,1,164,99.39024390243902
320500,2020,177,0,0,177,100.0
320501,2012,4,0,6,10,40.0
320501,2013,6,0,4,10,60.0
320501,2014,1,0,7,8,12.5
320501,2015,11,0,3,14,78.57142857142857
320501,2016,5,0,0,5,100.0
320501,2017,5,0,0,5,100.0
320501,2018,8,0,2,10,80.0
320501,2019,5,0,0,5,100.0
320501,2020,13,0,1,14,92.85714285714286
320503,2012,3,0,1,4,75.0
320503,2013,8,0,0,8,100.0
320503,2014,5,0,0,5,100.0
320503,2015,10,0,0,10,100.0
320503,2016,7,0,0,7,100.0
320503,2017,7,0,0,7,100.0
320503,2018,11,0,0,11,100.0
320503,2019,4,0,0,4,100.0
320503,2020,6,0,1,7,85.71428571428571
320506,2012,6,0,0,6,100.0
320506,2013,7,0,0,7,100.0
320506,2014,7,0,0,7,100.0
320506,2015,3,0,0,3,100.0
320506,2016,6,0,0,6,100.0
320506,2017,4,0,1,5,80.0
320506,2018,4,0,0,4,100.0
320506,2019,8,0,0,8,100.0
320506,2020,11,0,0,11,100.0
320510,2012,29,0,0,29,100.0
320510,2013,36,0,0,36,100.0
320510,2014,20,0,0,20,100.0
320510,2015,29,0,0,29,100.0
320510,2016,20,0,2,22,90.9090909090909
320510,2017,27,0,0,27,100.0
320510,2018,33,0,0,33,100.0
320510,2019,27,0,0,27,100.0
320510,2020,27,0,0,27,100.0
320515,2012,1,0,1,2,50.0
320515,2013,4,0,0,4,100.0
320515,2014,3,0,0,3,100.0
320515,2015,3,0,0,3,100.0
320515,2016,10,0,0,10,100.0
320515,2017,1,0,0,1,100.0
320515,2018,5,0,0,5,100.0
320515,2019,2,0,0,2,100.0
320515,2020,3,0,0,3,100.0
320517,2012,6,0,0,6,100.0
320517,2013,2,0,0,2,100.0
320517,2014,6,0,0,6,100.0
320517,2015,5,0,0,5,100.0
320517,2016,8,0,0,8,100.0
320517,2017,2,0,0,2,100.0
320517,2018,3,0,0,3,100.0
320517,2019,4,0,2,6,66.66666666666666
320517,2020,4,0,0,4,100.0
320520,2012,126,2,6,134,95.52238805970148
320520,2013,102,7,30,139,78.41726618705036
320520,2014,125,2,13,140,90.71428571428571
320520,2015,118,3,13,134,90.29850746268657
320520,2016,99,1,6,106,94.33962264150944
320520,2017,147,0,15,162,90.74074074074075
320520,2018,135,0,5,140,96.42857142857143
320520,2019,125,0,0,125,100.0
320520,2020,189,0,0,189,100.0
320530,2012,94,0,0,94,100.0
320530,2013,87,0,0,87,100.0
320530,2014,93,0,0,93,100.0
320530,2015,83,0,0,83,100.0
320530,2016,89,0,0,89,100.0
320530,2017,82,0,0,82,100.0
320530,2018,78,0,1,79,98.73417721518987
320530,2019,83,0,0,83,100.0
320530,2020,104,0,0,104,100.0
330000,2012,10,6,22,38,42.10526315789473
330000,2013,12,7,15,34,55.88235294117647
330000,2014,13,8,7,28,75.0
330000,2015,12,6,11,29,62.06896551724138
330000,2016,7,7,17,31,45.16129032258064
330000,2017,15,8,4,27,85.18518518518519
330000,2018,13,3,6,22,72.72727272727273
330000,2019,13,5,6,24,75.0
330000,2020,6,3,9,18,50.0
330010,2012,6,30,21,57,63.1578947368421
330010,2013,65,0,8,73,89.04109589041096
330010,2014,53,0,0,53,100.0
330010,2015,56,0,0,56,100.0
330010,2016,73,0,0,73,100.0
330010,2017,60,1,0,61,100.0
330010,2018,65,0,0,65,100.0
330010,2019,77,0,0,77,100.0
330010,2020,78,0,0,78,100.0
330015,2012,4,0,3,7,57.14285714285714
330015,2013,3,0,1,4,75.0
330015,2014,0,1,2,3,33.33333333333333
330015,2015,3,0,3,6,50.0
330015,2016,1,0,2,3,33.33333333333333
330015,2017,0,0,2,2,0.0
330015,2018,0,0,1,1,0.0
330015,2019,0,2,1,3,66.66666666666666
330015,2020,0,0,4,4,0.0
330020,2012,61,0,0,61,100.0
330020,2013,44,0,1,45,97.77777777777777
330020,2014,61,0,0,61,100.0
330020,2015,39,0,4,43,90.69767441860465
330020,2016,43,2,2,47,95.74468085106383
330020,2017,52,0,2,54,96.29629629629629
330020,2018,42,0,7,49,85.71428571428571
330020,2019,46,2,3,51,94.11764705882352
330020,2020,30,1,11,42,73.80952380952381
330022,2012,4,0,1,5,80.0
330022,2013,0,0,5,5,0.0
330022,2014,2,1,1,4,75.0
330022,2015,5,0,0,5,100.0
330022,2016,5,0,0,5,100.0
330022,2017,1,1,1,3,66.66666666666666
330022,2018,1,0,4,5,20.0
330022,2019,0,1,5,6,16.666666666666664
330022,2020,3,0,2,5,60.0
330023,2012,13,0,3,16,81.25
330023,2013,4,1,11,16,31.25
330023,2014,19,0,0,19,100.0
330023,2015,8,0,0,8,100.0
330023,2016,13,0,0,13,100.0
330023,2017,19,0,0,19,100.0
330023,2018,8,0,1,9,88.88888888888889
330023,2019,16,0,0,16,100.0
330023,2020,15,0,0,15,100.0
330025,2012,9,0,1,10,90.0
330025,2013,7,0,0,7,100.0
330025,2014,6,0,0,6,100.0
330025,2015,14,0,0,14,100.0
330025,2016,16,0,1,17,94.11764705882352
330025,2017,9,0,2,11,81.81818181818183
330025,2018,1,1,2,4,50.0
330025,2019,6,0,1,7,85.71428571428571
330025,2020,10,0,1,11,90.9090909090909
330030,2012,38,0,0,38,100.0
330030,2013,35,0,0,35,100.0
330030,2014,54,0,0,54,100.0
330030,2015,33,0,0,33,100.0
330030,2016,30,0,0,30,100.0
330030,2017,33,0,0,33,100.0
330030,2018,47,0,0,47,100.0
330030,2019,30,0,0,30,100.0
330030,2020,29,0,0,29,100.0
330040,2012,64,0,1,65,98.46153846153847
330040,2013,61,2,0,63,100.0
330040,2014,62,0,1,63,98.4126984126984
330040,2015,59,0,2,61,96.72131147540983
330040,2016,85,0,0,85,100.0
330040,2017,65,0,1,66,98.48484848484848
330040,2018,60,0,0,60,100.0
330040,2019,65,0,0,65,100.0
330040,2020,71,1,0,72,100.0
330045,2012,116,11,128,255,49.80392156862745
330045,2013,150,3,74,227,67.40088105726872
330045,2014,133,20,78,231,66.23376623376623
330045,2015,94,33,74,201,63.18407960199005
330045,2016,77,54,106,237,55.27426160337553
330045,2017,114,47,41,202,79.70297029702971
330045,2018,227,0,2,229,99.12663755458514
330045,2019,215,10,15,240,93.75
330045,2020,266,3,31,300,89.66666666666666
330050,2012,1,0,8,9,11.11111111111111
330050,2013,1,2,5,8,37.5
330050,2014,7,0,0,7,100.0
330050,2015,1,0,5,6,16.666666666666664
330050,2016,14,0,0,14,100.0
330050,2017,10,0,0,10,100.0
330050,2018,6,0,0,6,100.0
330050,2019,4,0,0,4,100.0
330050,2020,9,2,1,12,91.66666666666666
330060,2012,3,3,3,9,66.66666666666666
330060,2013,11,0,0,11,100.0
330060,2014,13,2,4,19,78.94736842105263
330060,2015,4,0,5,9,44.44444444444444
330060,2016,11,3,3,17,82.35294117647058
330060,2017,14,1,4,19,78.94736842105263
330060,2018,3,1,10,14,28.57142857142857
330060,2019,0,1,16,17,5.88235294117647
330060,2020,0,0,15,15,0.0
330070,2012,76,0,3,79,96.20253164556962
330070,2013,58,2,10,70,85.71428571428571
330070,2014,40,4,32,76,57.89473684210527
330070,2015,32,8,41,81,49.382716049382715
330070,2016,96,0,1,97,98.96907216494846
330070,2017,81,0,2,83,97.59036144578313
330070,2018,68,1,4,73,94.52054794520548
330070,2019,43,2,31,76,59.210526315789465
330070,2020,8,3,102,113,9.734513274336283
330080,2012,3,14,8,25,68.0
330080,2013,10,5,15,30,50.0
330080,2014,22,3,1,26,96.15384615384616
330080,2015,23,0,3,26,88.46153846153845
330080,2016,14,1,3,18,83.33333333333334
330080,2017,22,1,0,23,100.0
330080,2018,7,4,18,29,37.93103448275862
330080,2019,0,0,17,17,0.0
330080,2020,4,4,20,28,28.57142857142857
330090,2012,1,2,1,4,75.0
330090,2013,2,0,3,5,40.0
330090,2014,0,0,7,7,0.0
330090,2015,2,0,1,3,66.66666666666666
330090,2016,2,1,4,7,42.857142857142854
330090,2017,1,0,4,5,20.0
330090,2018,0,2,1,3,66.66666666666666
330090,2019,0,3,3,6,50.0
330090,2020,1,2,3,6,50.0
330093,2012,7,0,0,7,100.0
330093,2013,4,0,0,4,100.0
330093,2014,2,0,0,2,100.0
330093,2015,3,3,1,7,85.71428571428571
330093,2016,6,0,0,6,100.0
330093,2017,5,0,0,5,100.0
330093,2018,5,0,0,5,100.0
330093,2019,4,0,0,4,100.0
330093,2020,3,0,0,3,100.0
330095,2012,4,0,0,4,100.0
330095,2013,1,0,4,5,20.0
330095,2014,0,1,2,3,33.33333333333333
330095,2015,1,0,3,4,25.0
330095,2016,0,0,3,3,0.0
330095,2017,0,0,5,5,0.0
330095,2018,0,0,2,2,0.0
330095,2019,1,0,1,2,50.0
330095,2020,0,0,2,2,0.0
330100,2012,209,0,1,210,99.52380952380952
330100,2013,206,0,0,206,100.0
330100,2014,177,0,6,183,96.72131147540983
330100,2015,201,0,1,202,99.5049504950495
330100,2016,213,0,0,213,100.0
330100,2017,184,0,0,184,100.0
330100,2018,219,0,0,219,100.0
330100,2019,211,0,0,211,100.0
330100,2020,224,0,1,225,99.55555555555556
330110,2012,0,1,3,4,25.0
330110,2013,8,0,2,10,80.0
330110,2014,11,0,0,11,100.0
330110,2015,7,0,0,7,100.0
330110,2016,12,0,0,12,100.0
330110,2017,8,0,0,8,100.0
330110,2018,7,0,0,7,100.0
330110,2019,6,0,0,6,100.0
330110,2020,9,0,3,12,75.0
330115,2012,5,0,1,6,83.33333333333334
330115,2013,3,0,1,4,75.0
330115,2014,3,0,2,5,60.0
330115,2015,5,0,2,7,71.42857142857143
330115,2016,1,1,2,4,50.0
330115,2017,2,0,1,3,66.66666666666666
330115,2018,0,1,4,5,20.0
330115,2019,0,0,3,3,0.0
330115,2020,0,1,5,6,16.666666666666664
330120,2012,4,0,0,4,100.0
330120,2013,11,0,0,11,100.0
330120,2014,6,0,1,7,85.71428571428571
330120,2015,6,0,0,6,100.0
330120,2016,7,0,0,7,100.0
330120,2017,5,0,0,5,100.0
330120,2018,7,0,0,7,100.0
330120,2019,6,0,0,6,100.0
330120,2020,7,0,0,7,100.0
330130,2012,13,0,0,13,100.0
330130,2013,14,0,1,15,93.33333333333333
330130,2014,15,0,0,15,100.0
330130,2015,12,0,0,12,100.0
330130,2016,20,0,0,20,100.0
330130,2017,16,0,0,16,100.0
330130,2018,10,0,2,12,83.33333333333334
330130,2019,5,0,5,10,50.0
330130,2020,11,0,1,12,91.66666666666666
330140,2012,5,1,6,12,50.0
330140,2013,2,3,2,7,71.42857142857143
330140,2014,3,2,4,9,55.55555555555556
330140,2015,3,0,8,11,27.27272727272727
330140,2016,2,0,2,4,50.0
330140,2017,3,0,7,10,30.0
330140,2018,2,0,6,8,25.0
330140,2019,1,0,10,11,9.090909090909092
330140,2020,3,1,11,15,26.666666666666668
330150,2012,1,5,0,6,100.0
330150,2013,0,8,5,13,61.53846153846154
330150,2014,0,1,5,6,16.666666666666664
330150,2015,11,1,4,16,75.0
330150,2016,9,0,0,9,100.0
330150,2017,4,0,0,4,100.0
330150,2018,7,0,0,7,100.0
330150,2019,5,0,0,5,100.0
330150,2020,6,0,0,6,100.0
330160,2012,5,0,0,5,100.0
330160,2013,4,0,0,4,100.0
330160,2014,8,0,0,8,100.0
330160,2015,5,0,0,5,100.0
330160,2016,5,0,3,8,62.5
330160,2017,4,0,2,6,66.66666666666666
330160,2018,1,0,4,5,20.0
330160,2019,0,0,7,7,0.0
330160,2020,1,0,3,4,25.0
330170,2012,328,15,73,416,82.45192307692307
330170,2013,342,22,45,409,88.99755501222494
330170,2014,410,2,0,412,100.0
330170,2015,333,0,0,333,100.0
330170,2016,385,2,2,389,99.48586118251927
330170,2017,350,42,14,406,96.55172413793103
330170,2018,399,0,13,412,96.84466019417476
330170,2019,392,5,12,409,97.06601466992664
330170,2020,412,30,86,528,83.71212121212122
330180,2012,2,0,0,2,100.0
330180,2013,8,0,0,8,100.0
330180,2014,6,0,0,6,100.0
330180,2015,6,0,0,6,100.0
330180,2016,6,0,0,6,100.0
330180,2017,6,0,0,6,100.0
330180,2018,6,0,0,6,100.0
330180,2019,4,0,0,4,100.0
330180,2020,2,0,1,3,66.66666666666666
330185,2012,21,1,4,26,84.61538461538461
330185,2013,12,0,4,16,75.0
330185,2014,25,0,0,25,100.0
330185,2015,16,3,1,20,95.0
330185,2016,14,5,1,20,95.0
330185,2017,14,1,2,17,88.23529411764706
330185,2018,24,0,0,24,100.0
330185,2019,17,0,0,17,100.0
330185,2020,24,0,0,24,100.0
330187,2012,7,0,0,7,100.0
330187,2013,9,0,0,9,100.0
330187,2014,7,0,0,7,100.0
330187,2015,11,0,0,11,100.0
330187,2016,7,0,0,7,100.0
330187,2017,7,0,0,7,100.0
330187,2018,9,0,0,9,100.0
330187,2019,6,0,0,6,100.0
330187,2020,10,0,0,10,100.0
330190,2012,87,1,3,91,96.7032967032967
330190,2013,85,3,12,100,88.0
330190,2014,80,11,16,107,85.04672897196261
330190,2015,88,2,5,95,94.73684210526315
330190,2016,73,15,13,101,87.12871287128714
330190,2017,89,2,9,100,91.0
330190,2018,109,3,5,117,95.72649572649573
330190,2019,85,14,1,100,99.0
330190,2020,126,0,0,126,100.0
330200,2012,20,7,33,60,45.0
330200,2013,24,6,20,50,60.0
330200,2014,41,4,10,55,81.81818181818183
330200,2015,64,0,0,64,100.0
330200,2016,67,0,0,67,100.0
330200,2017,83,1,0,84,100.0
330200,2018,64,0,6,70,91.42857142857143
330200,2019,70,0,1,71,98.59154929577466
330200,2020,72,1,0,73,100.0
330205,2012,3,0,0,3,100.0
330205,2013,3,0,0,3,100.0
330205,2014,5,0,0,5,100.0
330205,2015,2,0,0,2,100.0
330205,2016,5,0,0,5,100.0
330205,2017,8,0,0,8,100.0
330205,2018,4,0,0,4,100.0
330205,2019,4,0,0,4,100.0
330205,2020,10,0,0,10,100.0
330210,2012,4,0,1,5,80.0
330210,2013,7,0,0,7,100.0
330210,2014,6,0,0,6,100.0
330210,2015,11,0,1,12,91.66666666666666
330210,2016,5,0,0,5,100.0
330210,2017,5,0,0,5,100.0
330210,2018,9,0,1,10,90.0
330210,2019,0,0,2,2,0.0
330210,2020,14,0,1,15,93.33333333333333
330220,2012,41,2,2,45,95.55555555555556
330220,2013,35,0,0,35,100.0
330220,2014,40,0,0,40,100.0
330220,2015,36,1,0,37,100.0
330220,2016,24,0,0,24,100.0
330220,2017,30,0,0,30,100.0
330220,2018,40,0,0,40,100.0
330220,2019,35,0,0,35,100.0
330220,2020,44,0,0,44,100.0
330225,2012,11,4,1,16,93.75
330225,2013,12,0,0,12,100.0
330225,2014,11,0,1,12,91.66666666666666
330225,2015,8,0,0,8,100.0
330225,2016,13,0,0,13,100.0
330225,2017,14,0,0,14,100.0
330225,2018,15,0,0,15,100.0
330225,2019,10,0,0,10,100.0
330225,2020,12,0,0,12,100.0
330227,2012,43,1,1,45,97.77777777777777
330227,2013,49,0,0,49,100.0
330227,2014,46,0,0,46,100.0
330227,2015,53,0,0,53,100.0
330227,2016,24,3,8,35,77.14285714285715
330227,2017,25,7,8,40,80.0
330227,2018,21,7,14,42,66.66666666666666
330227,2019,22,5,17,44,61.36363636363637
330227,2020,50,4,7,61,88.52459016393442
330230,2012,1,0,4,5,20.0
330230,2013,1,0,0,1,100.0
330230,2014,1,1,1,3,66.66666666666666
330230,2015,2,0,3,5,40.0
330230,2016,4,1,1,6,83.33333333333334
330230,2017,2,0,1,3,66.66666666666666
330230,2019,1,0,1,2,50.0
330230,2020,0,1,5,6,16.666666666666664
330240,2012,61,12,19,92,79.34782608695652
330240,2013,79,5,13,97,86.5979381443299
330240,2014,72,4,5,81,93.82716049382715
330240,2015,88,0,3,91,96.7032967032967
330240,2016,71,0,2,73,97.26027397260275
330240,2017,65,2,4,71,94.36619718309859
330240,2018,85,1,1,87,98.85057471264368
330240,2019,80,3,13,96,86.45833333333334
330240,2020,86,9,13,108,87.96296296296296
330245,2012,0,0,1,1,0.0
330245,2013,0,1,1,2,50.0
330245,2014,1,0,0,1,100.0
330245,2015,3,0,1,4,75.0
330245,2016,1,1,1,3,66.66666666666666
330245,2017,3,0,0,3,100.0
330245,2018,6,0,0,6,100.0
330245,2019,0,0,2,2,0.0
330245,2020,3,0,1,4,75.0
330250,2012,58,12,35,105,66.66666666666666
330250,2013,92,9,15,116,87.06896551724138
330250,2014,111,15,5,131,96.18320610687023
330250,2015,80,19,10,109,90.82568807339449
330250,2016,114,6,4,124,96.7741935483871
330250,2017,89,13,6,108,94.44444444444444
330250,2018,86,9,18,113,84.070796460177
330250,2019,104,2,4,110,96.36363636363636
330250,2020,90,11,42,143,70.62937062937063
330260,2012,6,1,8,15,46.666666666666664
330260,2013,11,0,6,17,64.70588235294117
330260,2014,17,0,0,17,100.0
330260,2015,15,0,0,15,100.0
330260,2016,19,0,0,19,100.0
330260,2017,22,0,0,22,100.0
330260,2018,12,0,1,13,92.3076923076923
330260,2019,18,0,0,18,100.0
330260,2020,25,0,0,25,100.0
330270,2012,40,0,0,40,100.0
330270,2013,39,0,0,39,100.0
330270,2014,54,1,1,56,98.21428571428571
330270,2015,42,5,3,50,94.0
330270,2016,34,11,5,50,90.0
330270,2017,33,7,3,43,93.02325581395348
330270,2018,42,2,5,49,89.79591836734694
330270,2019,53,7,8,68,88.23529411764706
330270,2020,41,4,7,52,86.53846153846155
330280,2012,8,0,0,8,100.0
330280,2013,5,0,0,5,100.0
330280,2014,2,1,4,7,42.857142857142854
330280,2015,2,0,4,6,33.33333333333333
330280,2016,1,0,6,7,14.285714285714285
330280,2017,3,0,5,8,37.5
330280,2018,1,0,6,7,14.285714285714285
330280,2019,3,0,2,5,60.0
330280,2020,3,0,8,11,27.27272727272727
330285,2012,64,2,5,71,92.95774647887323
330285,2013,69,2,4,75,94.66666666666667
330285,2014,63,9,14,86,83.72093023255815
330285,2015,73,0,1,74,98.64864864864865
330285,2016,83,0,0,83,100.0
330285,2017,56,0,0,56,100.0
330285,2018,74,0,0,74,100.0
330285,2019,79,0,0,79,100.0
330285,2020,82,0,0,82,100.0
330290,2012,13,0,1,14,92.85714285714286
330290,2013,9,0,0,9,100.0
330290,2014,5,0,0,5,100.0
330290,2015,11,0,0,11,100.0
330290,2016,12,0,0,12,100.0
330290,2017,8,1,0,9,100.0
330290,2018,9,0,0,9,100.0
330290,2019,7,0,0,7,100.0
330290,2020,13,0,0,13,100.0
330300,2012,0,0,10,10,0.0
330300,2013,5,0,8,13,38.46153846153847
330300,2014,2,2,5,9,44.44444444444444
330300,2015,6,1,7,14,50.0
330300,2016,2,1,11,14,21.428571428571427
330300,2017,2,2,9,13,30.76923076923077
330300,2018,0,3,7,10,30.0
330300,2019,0,3,18,21,14.285714285714285
330300,2020,0,1,14,15,6.666666666666667
330310,2012,2,2,0,4,100.0
330310,2013,6,1,0,7,100.0
330310,2014,6,0,0,6,100.0
330310,2015,4,0,0,4,100.0
330310,2016,7,0,0,7,100.0
330310,2017,8,0,0,8,100.0
330310,2018,8,0,0,8,100.0
330310,2019,8,0,0,8,100.0
330310,2020,4,1,2,7,71.42857142857143
330320,2012,45,13,18,76,76.31578947368422
330320,2013,61,8,17,86,80.23255813953489
330320,2014,53,9,35,97,63.91752577319587
330320,2015,60,15,5,80,93.75
330320,2016,54,19,8,81,90.12345679012346
330320,2017,49,8,6,63,90.47619047619048
330320,2018,44,15,10,69,85.5072463768116
330320,2019,35,18,28,81,65.4320987654321
330320,2020,25,26,56,107,47.66355140186916
330330,2012,55,10,95,160,40.625
330330,2013,144,13,14,171,91.81286549707602
330330,2014,129,13,36,178,79.7752808988764
330330,2015,97,22,18,137,86.86131386861314
330330,2016,107,23,21,151,86.09271523178808
330330,2017,94,18,20,132,84.84848484848484
330330,2018,111,20,18,149,87.91946308724832
330330,2019,115,16,11,142,92.25352112676056
330330,2020,126,19,26,171,84.7953216374269
330340,2012,49,6,17,72,76.38888888888889
330340,2013,58,2,11,71,84.50704225352112
330340,2014,43,4,22,69,68.11594202898551
330340,2015,23,6,27,56,51.78571428571429
330340,2016,8,8,49,65,24.615384615384617
330340,2017,10,22,28,60,53.333333333333336
330340,2018,5,5,54,64,15.625
330340,2019,1,5,46,52,11.538461538461538
330340,2020,1,5,65,71,8.450704225352112
330350,2012,290,18,103,411,74.93917274939173
330350,2013,250,35,104,389,73.26478149100257
330350,2014,261,39,71,371,80.86253369272237
330350,2015,230,63,69,362,80.93922651933701
330350,2016,195,95,88,378,76.71957671957672
330350,2017,195,64,94,353,73.37110481586402
330350,2018,260,70,59,389,84.83290488431876
330350,2019,247,57,58,362,83.97790055248619
330350,2020,394,47,79,520,84.8076923076923
330360,2012,25,0,0,25,100.0
330360,2013,18,0,1,19,94.73684210526315
330360,2014,20,1,0,21,100.0
330360,2015,20,0,0,20,100.0
330360,2016,19,0,0,19,100.0
330360,2017,16,0,0,16,100.0
330360,2018,24,0,0,24,100.0
330360,2019,20,0,0,20,100.0
330360,2020,12,0,10,22,54.54545454545454
330370,2012,13,0,0,13,100.0
330370,2013,19,0,0,19,100.0
330370,2014,21,0,1,22,95.45454545454545
330370,2015,19,0,0,19,100.0
330370,2016,17,0,0,17,100.0
330370,2017,11,0,0,11,100.0
330370,2018,14,0,0,14,100.0
330370,2019,19,0,0,19,100.0
330370,2020,17,0,0,17,100.0
330380,2012,5,1,8,14,42.857142857142854
330380,2013,7,1,4,12,66.66666666666666
330380,2014,13,1,2,16,87.5
330380,2015,15,1,2,18,88.88888888888889
330380,2016,13,0,2,15,86.66666666666667
330380,2017,14,0,1,15,93.33333333333333
330380,2018,16,0,1,17,94.11764705882352
330380,2019,0,1,16,17,5.88235294117647
330380,2020,3,0,9,12,25.0
330385,2012,8,0,0,8,100.0
330385,2013,13,0,0,13,100.0
330385,2014,18,0,0,18,100.0
330385,2015,15,0,0,15,100.0
330385,2016,13,0,0,13,100.0
330385,2017,9,0,0,9,100.0
330385,2018,10,0,0,10,100.0
330385,2019,5,0,0,5,100.0
330385,2020,12,0,0,12,100.0
330390,2012,111,1,8,120,93.33333333333333
330390,2013,109,1,2,112,98.21428571428571
330390,2014,96,2,1,99,98.98989898989899
330390,2015,89,2,8,99,91.91919191919192
330390,2016,120,6,5,131,96.18320610687023
330390,2017,95,3,0,98,100.0
330390,2018,105,3,3,111,97.2972972972973
330390,2019,96,3,10,109,90.82568807339449
330390,2020,98,4,9,111,91.8918918918919
330395,2012,8,0,0,8,100.0
330395,2013,9,0,0,9,100.0
330395,2014,9,0,0,9,100.0
330395,2015,8,0,0,8,100.0
330395,2016,4,0,0,4,100.0
330395,2017,11,0,0,11,100.0
330395,2018,6,0,0,6,100.0
330395,2019,12,0,1,13,92.3076923076923
330395,2020,11,0,0,11,100.0
330400,2012,16,0,0,16,100.0
330400,2013,7,0,0,7,100.0
330400,2014,8,0,0,8,100.0
330400,2015,8,0,0,8,100.0
330400,2016,10,0,0,10,100.0
330400,2017,1,0,0,1,100.0
330400,2018,14,0,0,14,100.0
330400,2019,9,0,0,9,100.0
330400,2020,8,0,0,8,100.0
330410,2012,0,3,0,3,100.0
330410,2013,5,3,1,9,88.88888888888889
330410,2014,11,3,2,16,87.5
330410,2015,7,0,1,8,87.5
330410,2016,2,0,0,2,100.0
330410,2017,6,0,0,6,100.0
330410,2018,8,0,0,8,100.0
330410,2019,6,0,0,6,100.0
330410,2020,8,0,0,8,100.0
330411,2012,3,0,0,3,100.0
330411,2013,6,0,0,6,100.0
330411,2014,9,0,0,9,100.0
330411,2015,6,0,0,6,100.0
330411,2016,6,0,0,6,100.0
330411,2017,12,0,0,12,100.0
330411,2018,8,0,0,8,100.0
330411,2019,5,0,0,5,100.0
330411,2020,4,0,0,4,100.0
330412,2012,1,1,1,3,66.66666666666666
330412,2013,4,0,0,4,100.0
330412,2014,8,0,0,8,100.0
330412,2015,2,0,3,5,40.0
330412,2016,2,0,0,2,100.0
330412,2017,2,0,1,3,66.66666666666666
330412,2018,6,0,1,7,85.71428571428571
330412,2019,1,0,2,3,33.33333333333333
330414,2012,44,4,24,72,66.66666666666666
330414,2013,39,3,17,59,71.1864406779661
330414,2014,56,3,11,70,84.28571428571429
330414,2015,45,10,24,79,69.62025316455697
330414,2016,70,8,8,86,90.69767441860465
330414,2017,47,11,11,69,84.05797101449275
330414,2018,73,7,14,94,85.1063829787234
330414,2019,49,7,23,79,70.88607594936708
330414,2020,80,0,15,95,84.21052631578947
330415,2012,8,1,1,10,90.0
330415,2013,2,0,3,5,40.0
330415,2014,13,0,1,14,92.85714285714286
330415,2015,3,0,0,3,100.0
330415,2016,9,0,0,9,100.0
330415,2017,11,0,0,11,100.0
330415,2018,10,0,0,10,100.0
330415,2019,6,0,0,6,100.0
330415,2020,11,0,0,11,100.0
330420,2012,46,0,0,46,100.0
330420,2013,47,0,0,47,100.0
330420,2014,54,0,0,54,100.0
330420,2015,39,3,0,42,100.0
330420,2016,58,0,0,58,100.0
330420,2017,51,0,0,51,100.0
330420,2018,41,0,1,42,97.61904761904762
330420,2019,40,1,1,42,97.61904761904762
330420,2020,56,1,0,57,100.0
330430,2012,21,0,3,24,87.5
330430,2013,17,0,0,17,100.0
330430,2014,16,0,0,16,100.0
330430,2015,28,0,1,29,96.55172413793103
330430,2016,21,0,0,21,100.0
330430,2017,11,0,3,14,78.57142857142857
330430,2018,22,0,0,22,100.0
330430,2019,23,0,0,23,100.0
330430,2020,20,0,0,20,100.0
330440,2012,4,0,0,4,100.0
330440,2013,10,0,0,10,100.0
330440,2014,11,0,0,11,100.0
330440,2015,5,0,0,5,100.0
330440,2016,5,0,0,5,100.0
330440,2017,4,0,0,4,100.0
330440,2018,5,0,3,8,62.5
330440,2019,6,0,0,6,100.0
330440,2020,3,1,4,8,50.0
330450,2012,5,0,0,5,100.0
330450,2013,2,0,1,3,66.66666666666666
330450,2014,1,0,0,1,100.0
330450,2015,4,0,0,4,100.0
330450,2016,1,1,0,2,100.0
330450,2017,5,0,0,5,100.0
330450,2018,2,0,0,2,100.0
330450,2019,2,0,0,2,100.0
330450,2020,3,0,0,3,100.0
330452,2012,56,0,0,56,100.0
330452,2013,33,0,0,33,100.0
330452,2014,43,0,3,46,93.47826086956522
330452,2015,37,1,2,40,95.0
330452,2016,48,6,13,67,80.59701492537313
330452,2017,28,5,10,43,76.74418604651163
330452,2018,29,2,3,34,91.17647058823529
330452,2019,38,1,7,46,84.78260869565217
330452,2020,35,4,17,56,69.64285714285714
330455,2012,1991,167,331,2489,86.70148654077943
330455,2013,2100,143,244,2487,90.18898271009247
330455,2014,2297,46,111,2454,95.47677261613691
330455,2015,2195,100,154,2449,93.71171906900776
330455,2016,2195,151,139,2485,94.40643863179075
330455,2017,2262,68,77,2407,96.80099709181553
330455,2018,2186,76,93,2355,96.05095541401273
330455,2019,2256,99,132,2487,94.69240048250904
330455,2020,2612,176,199,2987,93.33779712085705
330460,2012,2,0,0,2,100.0
330460,2013,2,0,0,2,100.0
330460,2014,3,1,0,4,100.0
330460,2015,2,0,1,3,66.66666666666666
330460,2016,1,0,2,3,33.33333333333333
330460,2017,0,0,1,1,0.0
330460,2018,0,0,2,2,0.0
330460,2019,1,0,2,3,33.33333333333333
330460,2020,0,0,6,6,0.0
330470,2012,26,0,0,26,100.0
330470,2013,17,0,0,17,100.0
330470,2014,12,0,0,12,100.0
330470,2015,14,1,0,15,100.0
330470,2016,13,0,0,13,100.0
330470,2017,13,0,1,14,92.85714285714286
330470,2018,16,0,1,17,94.11764705882352
330470,2019,10,0,0,10,100.0
330470,2020,18,0,0,18,100.0
330475,2012,15,0,0,15,100.0
330475,2013,13,0,1,14,92.85714285714286
330475,2014,20,0,0,20,100.0
330475,2015,7,0,7,14,50.0
330475,2016,6,2,6,14,57.14285714285714
330475,2017,7,0,6,13,53.84615384615385
330475,2018,7,1,11,19,42.10526315789473
330475,2019,7,0,6,13,53.84615384615385
330475,2020,9,0,12,21,42.857142857142854
330480,2012,16,1,3,20,85.0
330480,2013,9,0,0,9,100.0
330480,2014,5,0,2,7,71.42857142857143
330480,2015,14,0,2,16,87.5
330480,2016,15,0,0,15,100.0
330480,2017,9,1,0,10,100.0
330480,2018,17,0,0,17,100.0
330480,2019,9,0,7,16,56.25
330480,2020,13,0,2,15,86.66666666666667
330490,2012,359,0,8,367,97.82016348773843
330490,2013,367,2,5,374,98.66310160427807
330490,2014,367,0,0,367,100.0
330490,2015,376,4,16,396,95.95959595959596
330490,2016,362,0,2,364,99.45054945054946
330490,2017,334,0,0,334,100.0
330490,2018,328,0,1,329,99.69604863221885
330490,2019,312,16,25,353,92.91784702549575
330490,2020,410,0,2,412,99.51456310679612
330500,2012,16,0,0,16,100.0
330500,2013,10,0,2,12,83.33333333333334
330500,2014,14,0,2,16,87.5
330500,2015,21,0,1,22,95.45454545454545
330500,2016,8,0,0,8,100.0
330500,2017,13,0,0,13,100.0
330500,2018,5,0,5,10,50.0
330500,2019,14,0,3,17,82.35294117647058
330500,2020,15,0,0,15,100.0
330510,2012,154,10,53,217,75.57603686635944
330510,2013,145,8,64,217,70.50691244239631
330510,2014,139,12,32,183,82.5136612021858
330510,2015,108,45,37,190,80.52631578947368
330510,2016,120,53,52,225,76.88888888888889
330510,2017,190,4,5,199,97.48743718592965
330510,2018,200,0,0,200,100.0
330510,2019,204,0,0,204,100.0
330510,2020,228,9,25,262,90.45801526717557
330513,2012,1,0,2,3,33.33333333333333
330513,2013,0,1,0,1,100.0
330513,2014,1,0,0,1,100.0
330513,2015,1,0,0,1,100.0
330513,2016,2,0,2,4,50.0
330513,2017,0,0,1,1,0.0
330513,2018,1,0,0,1,100.0
330513,2019,0,1,4,5,20.0
330513,2020,0,1,6,7,14.285714285714285
330515,2012,1,1,4,6,33.33333333333333
330515,2013,5,1,0,6,100.0
330515,2014,4,5,0,9,100.0
330515,2015,2,0,0,2,100.0
330515,2016,9,1,0,10,100.0
330515,2017,6,0,0,6,100.0
330515,2018,9,0,0,9,100.0
330515,2019,4,0,0,4,100.0
330515,2020,12,0,0,12,100.0
330520,2012,17,2,6,25,76.0
330520,2013,18,2,7,27,74.07407407407408
330520,2014,5,1,18,24,25.0
330520,2015,2,2,23,27,14.814814814814813
330520,2016,2,5,26,33,21.21212121212121
330520,2017,3,3,34,40,15.0
330520,2018,6,2,31,39,20.51282051282051
330520,2019,34,0,1,35,97.14285714285714
330520,2020,47,0,8,55,85.45454545454545
330530,2012,1,0,2,3,33.33333333333333
330530,2013,0,0,3,3,0.0
330530,2014,1,0,3,4,25.0
330530,2016,0,1,3,4,25.0
330530,2017,0,0,1,1,0.0
330530,2018,0,1,3,4,25.0
330530,2019,0,0,1,1,0.0
330530,2020,1,0,7,8,12.5
330540,2012,16,0,0,16,100.0
330540,2013,5,0,0,5,100.0
330540,2014,11,0,0,11,100.0
330540,2015,7,0,2,9,77.77777777777779
330540,2016,6,0,0,6,100.0
330540,2017,5,0,1,6,83.33333333333334
330540,2018,8,0,0,8,100.0
330540,2019,8,0,0,8,100.0
330540,2020,8,0,0,8,100.0
330550,2012,16,1,8,25,68.0
330550,2013,9,0,20,29,31.03448275862069
330550,2014,35,0,1,36,97.22222222222221
330550,2015,25,0,1,26,96.15384615384616
330550,2016,20,0,1,21,95.23809523809523
330550,2017,29,0,0,29,100.0
330550,2018,24,0,2,26,92.3076923076923
330550,2019,27,0,1,28,96.42857142857143
330550,2020,23,1,2,26,92.3076923076923
330555,2012,31,1,1,33,96.96969696969697
330555,2013,25,0,2,27,92.5925925925926
330555,2014,33,3,4,40,90.0
330555,2015,38,0,1,39,97.43589743589743
330555,2016,44,0,0,44,100.0
330555,2017,41,0,0,41,100.0
330555,2018,25,0,2,27,92.5925925925926
330555,2019,18,6,11,35,68.57142857142857
330555,2020,25,1,21,47,55.319148936170215
330560,2012,8,1,0,9,100.0
330560,2013,7,0,0,7,100.0
330560,2014,9,0,0,9,100.0
330560,2015,9,0,0,9,100.0
330560,2016,16,0,0,16,100.0
330560,2017,1,0,1,2,50.0
330560,2018,4,0,5,9,44.44444444444444
330560,2019,8,1,4,13,69.23076923076923
330560,2020,2,2,8,12,33.33333333333333
330570,2012,1,0,6,7,14.285714285714285
330570,2013,2,1,2,5,60.0
330570,2014,1,2,3,6,50.0
330570,2015,0,1,4,5,20.0
330570,2016,0,0,2,2,0.0
330570,2017,0,0,5,5,0.0
330570,2018,1,0,2,3,33.33333333333333
330570,2019,0,0,6,6,0.0
330570,2020,0,0,7,7,0.0
330575,2012,6,0,5,11,54.54545454545454
330575,2013,12,0,4,16,75.0
330575,2014,4,2,4,10,60.0
330575,2015,19,0,5,24,79.16666666666666
330575,2016,13,0,0,13,100.0
330575,2017,8,0,0,8,100.0
330575,2018,16,0,0,16,100.0
330575,2019,22,0,0,22,100.0
330575,2020,24,0,0,24,100.0
330580,2012,21,1,47,69,31.88405797101449
330580,2013,13,3,59,75,21.333333333333336
330580,2014,42,9,12,63,80.95238095238095
330580,2015,37,6,6,49,87.75510204081633
330580,2016,58,7,7,72,90.27777777777779
330580,2017,54,6,3,63,95.23809523809523
330580,2018,47,3,8,58,86.20689655172413
330580,2019,9,3,60,72,16.666666666666664
330580,2020,3,1,59,63,6.349206349206349
330590,2012,1,0,4,5,20.0
330590,2013,3,0,1,4,75.0
330590,2014,7,0,0,7,100.0
330590,2015,4,0,1,5,80.0
330590,2016,1,1,6,8,25.0
330590,2017,1,0,3,4,25.0
330590,2018,1,1,2,4,50.0
330590,2019,0,0,3,3,0.0
330590,2020,0,0,2,2,0.0
330600,2012,37,0,0,37,100.0
330600,2013,37,0,1,38,97.36842105263158
330600,2014,37,0,0,37,100.0
330600,2015,27,0,0,27,100.0
330600,2016,32,0,0,32,100.0
330600,2017,46,0,0,46,100.0
330600,2018,32,0,0,32,100.0
330600,2019,34,0,0,34,100.0
330600,2020,46,0,0,46,100.0
330610,2012,25,0,0,25,100.0
330610,2013,41,0,0,41,100.0
330610,2014,27,0,0,27,100.0
330610,2015,33,0,1,34,97.05882352941177
330610,2016,18,0,0,18,100.0
330610,2017,27,0,0,27,100.0
330610,2018,24,0,0,24,100.0
330610,2019,20,0,0,20,100.0
330610,2020,32,0,0,32,100.0
330615,2012,1,0,5,6,16.666666666666664
330615,2013,3,0,0,3,100.0
330615,2014,2,0,1,3,66.66666666666666
330615,2015,0,0,1,1,0.0
330615,2016,3,1,0,4,100.0
330615,2017,2,0,2,4,50.0
330615,2018,0,0,6,6,0.0
330615,2019,0,0,3,3,0.0
330615,2020,0,0,3,3,0.0
330620,2012,8,1,12,21,42.857142857142854
330620,2013,22,0,0,22,100.0
330620,2014,19,0,2,21,90.47619047619048
330620,2015,14,0,0,14,100.0
330620,2016,13,1,2,16,87.5
330620,2017,12,0,2,14,85.71428571428571
330620,2018,10,0,0,10,100.0
330620,2019,6,0,2,8,75.0
330620,2020,11,0,1,12,91.66666666666666
330630,2012,92,0,0,92,100.0
330630,2013,83,8,5,96,94.79166666666666
330630,2014,83,3,9,95,90.52631578947368
330630,2015,88,0,0,88,100.0
330630,2016,113,0,0,113,100.0
330630,2017,85,0,2,87,97.70114942528735
330630,2018,92,1,0,93,100.0
330630,2019,97,0,1,98,98.9795918367347
330630,2020,99,0,1,100,99.0
350000,2012,6,6,8,20,60.0
350000,2013,2,2,8,12,33.33333333333333
350000,2014,10,1,13,24,45.83333333333333
350000,2015,10,1,7,18,61.111111111111114
350000,2016,9,0,10,19,47.368421052631575
350000,2017,5,2,4,11,63.63636363636363
350000,2018,3,2,6,11,45.45454545454545
350000,2019,0,2,4,6,33.33333333333333
350000,2020,3,1,5,9,44.44444444444444
350010,2012,18,0,1,19,94.73684210526315
350010,2013,11,0,0,11,100.0
350010,2014,7,0,0,7,100.0
350010,2015,7,0,0,7,100.0
350010,2016,2,0,0,2,100.0
350010,2017,10,0,0,10,100.0
350010,2018,9,0,0,9,100.0
350010,2019,18,0,0,18,100.0
350010,2020,9,0,0,9,100.0
350020,2012,1,0,0,1,100.0
350020,2014,1,0,0,1,100.0
350020,2015,1,0,0,1,100.0
350020,2017,3,0,0,3,100.0
350020,2018,2,0,0,2,100.0
350020,2020,0,0,1,1,0.0
350030,2012,12,0,0,12,100.0
350030,2013,7,0,0,7,100.0
350030,2014,9,0,0,9,100.0
350030,2015,12,0,0,12,100.0
350030,2016,8,0,0,8,100.0
350030,2017,8,0,0,8,100.0
350030,2018,6,0,0,6,100.0
350030,2019,8,0,0,8,100.0
350030,2020,9,0,0,9,100.0
350040,2012,2,0,0,2,100.0
350040,2013,1,0,2,3,33.33333333333333
350040,2014,0,2,1,3,66.66666666666666
350040,2016,1,0,0,1,100.0
350040,2018,3,0,0,3,100.0
350040,2019,3,0,0,3,100.0
350040,2020,2,0,0,2,100.0
350050,2012,6,0,0,6,100.0
350050,2013,8,0,0,8,100.0
350050,2014,3,0,1,4,75.0
350050,2015,6,0,0,6,100.0
350050,2016,6,0,0,6,100.0
350050,2017,2,0,0,2,100.0
350050,2018,5,0,0,5,100.0
350050,2019,5,0,0,5,100.0
350050,2020,4,0,1,5,80.0
350055,2012,0,0,4,4,0.0
350055,2013,3,0,0,3,100.0
350055,2014,1,0,1,2,50.0
350055,2015,1,0,0,1,100.0
350055,2016,1,0,0,1,100.0
350055,2019,0,2,1,3,66.66666666666666
350055,2020,4,0,0,4,100.0
350060,2012,0,2,0,2,100.0
350060,2014,2,0,0,2,100.0
350060,2015,1,0,0,1,100.0
350070,2012,4,1,1,6,83.33333333333334
350070,2013,14,0,7,21,66.66666666666666
350070,2014,7,0,6,13,53.84615384615385
350070,2015,13,0,0,13,100.0
350070,2016,1,2,7,10,30.0
350070,2017,1,3,12,16,25.0
350070,2018,5,7,8,20,60.0
350070,2019,0,4,8,12,33.33333333333333
350070,2020,0,3,7,10,30.0
350075,2013,0,0,2,2,0.0
350075,2015,0,0,1,1,0.0
350075,2016,0,0,2,2,0.0
350075,2017,0,1,1,2,50.0
350075,2019,1,0,1,2,50.0
350075,2020,0,0,5,5,0.0
350080,2016,1,0,0,1,100.0
350080,2018,1,0,0,1,100.0
350080,2019,1,0,0,1,100.0
350080,2020,4,0,0,4,100.0
350090,2014,1,0,0,1,100.0
350090,2015,3,0,0,3,100.0
350090,2018,3,0,0,3,100.0
350090,2020,1,0,0,1,100.0
350100,2012,2,0,0,2,100.0
350100,2013,10,0,0,10,100.0
350100,2014,5,0,0,5,100.0
350100,2015,4,0,0,4,100.0
350100,2016,5,0,0,5,100.0
350100,2017,5,0,0,5,100.0
350100,2018,3,0,0,3,100.0
350100,2019,2,0,0,2,100.0
350100,2020,2,0,0,2,100.0
350110,2012,2,0,0,2,100.0
350110,2013,2,0,0,2,100.0
350110,2015,2,0,0,2,100.0
350110,2016,1,0,0,1,100.0
350110,2017,1,0,0,1,100.0
350110,2019,1,0,0,1,100.0
350110,2020,0,0,1,1,0.0
350115,2012,5,0,0,5,100.0
350115,2013,4,0,1,5,80.0
350115,2014,4,0,0,4,100.0
350115,2015,7,0,0,7,100.0
350115,2016,5,0,1,6,83.33333333333334
350115,2017,0,0,6,6,0.0
350115,2018,1,0,0,1,100.0
350115,2019,1,0,5,6,16.666666666666664
350115,2020,2,0,2,4,50.0
350120,2012,2,0,0,2,100.0
350120,2013,2,0,0,2,100.0
350120,2015,1,0,0,1,100.0
350120,2016,4,0,0,4,100.0
350120,2017,2,0,0,2,100.0
350120,2018,2,0,0,2,100.0
350120,2019,1,0,0,1,100.0
350120,2020,2,0,0,2,100.0
350130,2012,8,0,0,8,100.0
350130,2013,6,0,0,6,100.0
350130,2014,1,1,8,10,20.0
350130,2015,5,0,1,6,83.33333333333334
350130,2016,9,0,0,9,100.0
350130,2017,5,0,0,5,100.0
350130,2018,9,0,0,9,100.0
350130,2019,10,0,0,10,100.0
350130,2020,9,0,0,9,100.0
350140,2012,3,0,0,3,100.0
350140,2013,4,0,0,4,100.0
350140,2015,1,0,0,1,100.0
350140,2016,1,0,0,1,100.0
350140,2017,1,0,0,1,100.0
350140,2018,1,0,0,1,100.0
350140,2019,1,0,0,1,100.0
350150,2012,1,0,0,1,100.0
350150,2013,2,0,0,2,100.0
350150,2015,3,0,0,3,100.0
350150,2016,1,0,0,1,100.0
350150,2017,1,0,0,1,100.0
350150,2018,1,0,0,1,100.0
350150,2020,1,0,0,1,100.0
350160,2012,53,0,0,53,100.0
350160,2013,54,0,0,54,100.0
350160,2014,54,0,0,54,100.0
350160,2015,44,0,0,44,100.0
350160,2016,47,0,0,47,100.0
350160,2017,56,0,0,56,100.0
350160,2018,43,0,0,43,100.0
350160,2019,60,2,2,64,96.875
350160,2020,61,0,0,61,100.0
350170,2012,9,0,0,9,100.0
350170,2013,15,0,0,15,100.0
350170,2014,9,0,0,9,100.0
350170,2015,7,0,0,7,100.0
350170,2016,18,0,0,18,100.0
350170,2017,13,0,0,13,100.0
350170,2018,6,0,0,6,100.0
350170,2019,5,2,0,7,100.0
350170,2020,11,0,0,11,100.0
350180,2012,2,0,0,2,100.0
350180,2013,2,0,0,2,100.0
350180,2014,3,0,0,3,100.0
350180,2017,3,0,0,3,100.0
350180,2018,1,0,0,1,100.0
350180,2019,5,0,0,5,100.0
350180,2020,4,0,0,4,100.0
350190,2012,13,0,0,13,100.0
350190,2013,30,0,0,30,100.0
350190,2014,20,0,1,21,95.23809523809523
350190,2015,25,0,1,26,96.15384615384616
350190,2016,19,2,2,23,91.30434782608695
350190,2017,21,0,0,21,100.0
350190,2018,13,0,0,13,100.0
350190,2019,21,0,0,21,100.0
350190,2020,10,0,1,11,90.9090909090909
350200,2012,0,0,1,1,0.0
350200,2013,0,0,2,2,0.0
350200,2014,0,1,0,1,100.0
350200,2016,3,0,0,3,100.0
350200,2018,0,1,1,2,50.0
350200,2019,0,0,2,2,0.0
350200,2020,1,0,0,1,100.0
350210,2012,14,0,0,14,100.0
350210,2013,24,0,0,24,100.0
350210,2014,14,0,0,14,100.0
350210,2015,16,0,0,16,100.0
350210,2016,17,0,0,17,100.0
350210,2017,21,0,0,21,100.0
350210,2018,14,0,0,14,100.0
350210,2019,10,0,0,10,100.0
350210,2020,16,0,0,16,100.0
350220,2012,5,0,1,6,83.33333333333334
350220,2013,8,0,1,9,88.88888888888889
350220,2014,4,2,1,7,85.71428571428571
350220,2015,6,0,0,6,100.0
350220,2016,4,0,3,7,57.14285714285714
350220,2017,7,0,1,8,87.5
350220,2018,10,0,0,10,100.0
350220,2019,3,0,0,3,100.0
350220,2020,4,1,2,7,71.42857142857143
350230,2012,1,0,0,1,100.0
350230,2013,4,0,0,4,100.0
350230,2014,1,0,0,1,100.0
350230,2015,3,0,0,3,100.0
350230,2016,3,0,0,3,100.0
350230,2017,2,0,0,2,100.0
350230,2018,2,0,0,2,100.0
350230,2019,1,0,0,1,100.0
350230,2020,2,0,0,2,100.0
350240,2012,3,0,0,3,100.0
350240,2014,0,0,1,1,0.0
350240,2015,1,0,0,1,100.0
350240,2018,1,0,0,1,100.0
350240,2020,1,0,0,1,100.0
350250,2012,2,13,3,18,83.33333333333334
350250,2013,1,3,2,6,66.66666666666666
350250,2014,15,0,0,15,100.0
350250,2015,10,0,2,12,83.33333333333334
350250,2016,18,0,0,18,100.0
350250,2017,5,0,0,5,100.0
350250,2018,4,0,2,6,66.66666666666666
350250,2019,10,0,0,10,100.0
350250,2020,6,0,0,6,100.0
350260,2012,0,0,1,1,0.0
350260,2014,2,0,0,2,100.0
350260,2015,1,0,0,1,100.0
350260,2016,2,0,0,2,100.0
350260,2017,4,0,0,4,100.0
350260,2018,2,0,0,2,100.0
350260,2019,2,0,0,2,100.0
350260,2020,2,0,0,2,100.0
350270,2012,1,0,0,1,100.0
350270,2013,8,0,0,8,100.0
350270,2014,9,0,0,9,100.0
350270,2015,12,0,0,12,100.0
350270,2016,9,0,0,9,100.0
350270,2017,11,0,0,11,100.0
350270,2018,11,0,0,11,100.0
350270,2019,10,0,2,12,83.33333333333334
350270,2020,6,0,0,6,100.0
350275,2012,5,0,0,5,100.0
350275,2013,10,0,0,10,100.0
350275,2014,8,0,0,8,100.0
350275,2015,5,0,1,6,83.33333333333334
350275,2016,3,0,1,4,75.0
350275,2017,5,0,0,5,100.0
350275,2018,3,0,0,3,100.0
350275,2019,9,0,0,9,100.0
350275,2020,7,0,0,7,100.0
350280,2012,72,0,0,72,100.0
350280,2013,60,0,0,60,100.0
350280,2014,66,0,0,66,100.0
350280,2015,70,0,0,70,100.0
350280,2016,65,0,0,65,100.0
350280,2017,42,0,0,42,100.0
350280,2018,57,0,0,57,100.0
350280,2019,71,0,0,71,100.0
350280,2020,60,0,0,60,100.0
350290,2012,1,1,6,8,25.0
350290,2013,0,0,5,5,0.0
350290,2014,0,0,9,9,0.0
350290,2015,0,1,7,8,12.5
350290,2016,1,2,10,13,23.076923076923077
350290,2017,0,1,6,7,14.285714285714285
350290,2018,11,0,1,12,91.66666666666666
350290,2019,13,0,0,13,100.0
350290,2020,8,0,0,8,100.0
350300,2012,1,0,0,1,100.0
350300,2013,0,1,0,1,100.0
350300,2015,1,0,0,1,100.0
350300,2016,2,0,0,2,100.0
350300,2018,3,0,0,3,100.0
350300,2019,5,0,0,5,100.0
350300,2020,2,0,0,2,100.0
350310,2012,1,0,0,1,100.0
350310,2013,3,0,0,3,100.0
350310,2014,1,0,0,1,100.0
350310,2015,4,0,0,4,100.0
350310,2016,3,0,0,3,100.0
350310,2017,2,0,0,2,100.0
350310,2018,3,0,0,3,100.0
350310,2019,3,0,0,3,100.0
350315,2012,0,1,2,3,33.33333333333333
350315,2019,0,1,1,2,50.0
350315,2020,0,0,1,1,0.0
350320,2012,62,1,0,63,100.0
350320,2013,68,0,0,68,100.0
350320,2014,55,0,0,55,100.0
350320,2015,77,0,0,77,100.0
350320,2016,80,0,0,80,100.0
350320,2017,70,0,0,70,100.0
350320,2018,65,0,0,65,100.0
350320,2019,63,0,0,63,100.0
350320,2020,58,1,0,59,100.0
350330,2012,44,0,0,44,100.0
350330,2013,28,0,0,28,100.0
350330,2014,28,0,0,28,100.0
350330,2015,48,0,0,48,100.0
350330,2016,35,0,0,35,100.0
350330,2017,39,0,1,40,97.5
350330,2018,36,0,0,36,100.0
350330,2019,37,0,0,37,100.0
350330,2020,48,0,0,48,100.0
350335,2012,2,0,0,2,100.0
350335,2017,1,0,0,1,100.0
350335,2018,1,0,0,1,100.0
350335,2020,1,0,0,1,100.0
350340,2012,0,0,1,1,0.0
350340,2013,0,2,1,3,66.66666666666666
350340,2014,2,2,1,5,80.0
350340,2015,3,0,0,3,100.0
350340,2016,4,0,1,5,80.0
350340,2017,1,0,0,1,100.0
350340,2018,1,0,0,1,100.0
350340,2019,1,0,0,1,100.0
350340,2020,0,2,3,5,40.0
350350,2012,0,0,1,1,0.0
350350,2014,1,1,1,3,66.66666666666666
350350,2015,0,1,0,1,100.0
350350,2016,1,0,3,4,25.0
350350,2017,0,0,1,1,0.0
350350,2018,0,0,1,1,0.0
350350,2019,0,0,1,1,0.0
350350,2020,1,1,0,2,100.0
350360,2012,5,0,0,5,100.0
350360,2013,2,0,1,3,66.66666666666666
350360,2015,3,0,1,4,75.0
350360,2016,4,0,0,4,100.0
350360,2017,1,0,0,1,100.0
350360,2018,4,0,0,4,100.0
350360,2019,5,0,0,5,100.0
350360,2020,1,0,0,1,100.0
350370,2012,2,0,0,2,100.0
350370,2013,5,0,0,5,100.0
350370,2014,1,0,0,1,100.0
350370,2015,2,0,0,2,100.0
350370,2018,2,0,0,2,100.0
350370,2019,3,0,0,3,100.0
350370,2020,7,0,0,7,100.0
350380,2012,10,0,0,10,100.0
350380,2013,3,1,12,16,25.0
350380,2014,0,8,11,19,42.10526315789473
350380,2015,14,0,0,14,100.0
350380,2016,9,0,0,9,100.0
350380,2017,11,0,0,11,100.0
350380,2018,13,0,0,13,100.0
350380,2019,14,0,0,14,100.0
350380,2020,24,0,0,24,100.0
350390,2012,28,0,0,28,100.0
350390,2013,32,0,0,32,100.0
350390,2014,31,0,0,31,100.0
350390,2015,24,0,0,24,100.0
350390,2016,32,0,2,34,94.11764705882352
350390,2017,21,0,0,21,100.0
350390,2018,30,0,0,30,100.0
350390,2019,27,0,0,27,100.0
350390,2020,28,1,1,30,96.66666666666667
350395,2013,1,0,0,1,100.0
350395,2020,1,0,0,1,100.0
350400,2012,38,0,0,38,100.0
350400,2013,30,0,0,30,100.0
350400,2014,32,0,0,32,100.0
350400,2015,28,0,0,28,100.0
350400,2016,25,0,0,25,100.0
350400,2017,36,0,0,36,100.0
350400,2018,36,0,0,36,100.0
350400,2019,28,0,0,28,100.0
350400,2020,31,0,0,31,100.0
350410,2012,47,0,0,47,100.0
350410,2013,41,0,2,43,95.34883720930233
350410,2014,40,0,0,40,100.0
350410,2015,34,0,0,34,100.0
350410,2016,34,0,0,34,100.0
350410,2017,43,0,0,43,100.0
350410,2018,46,0,0,46,100.0
350410,2019,40,0,0,40,100.0
350410,2020,48,0,0,48,100.0
350420,2012,4,0,0,4,100.0
350420,2013,2,0,0,2,100.0
350420,2014,2,0,0,2,100.0
350420,2015,7,0,0,7,100.0
350420,2016,3,0,0,3,100.0
350420,2017,4,0,0,4,100.0
350420,2018,2,0,0,2,100.0
350420,2019,5,0,0,5,100.0
350430,2012,0,0,1,1,0.0
350430,2013,2,1,2,5,60.0
350430,2014,3,0,0,3,100.0
350430,2016,0,2,1,3,66.66666666666666
350430,2017,1,1,0,2,100.0
350430,2018,0,0,1,1,0.0
350430,2019,1,0,1,2,50.0
350430,2020,0,1,1,2,50.0
350440,2012,5,0,1,6,83.33333333333334
350440,2013,3,1,5,9,44.44444444444444
350440,2014,3,0,0,3,100.0
350440,2015,6,0,0,6,100.0
350440,2016,2,0,0,2,100.0
350440,2017,5,0,0,5,100.0
350440,2018,1,0,0,1,100.0
350440,2019,0,2,3,5,40.0
350440,2020,4,1,0,5,100.0
350450,2012,27,0,0,27,100.0
350450,2013,24,0,0,24,100.0
350450,2014,28,0,0,28,100.0
350450,2015,28,0,0,28,100.0
350450,2016,25,0,0,25,100.0
350450,2017,27,0,1,28,96.42857142857143
350450,2018,33,0,0,33,100.0
350450,2019,3,1,19,23,17.391304347826086
350450,2020,23,1,0,24,100.0
350460,2012,3,0,0,3,100.0
350460,2013,5,0,0,5,100.0
350460,2014,7,0,0,7,100.0
350460,2015,3,0,0,3,100.0
350460,2016,2,0,0,2,100.0
350460,2017,6,0,0,6,100.0
350460,2018,3,0,0,3,100.0
350460,2019,5,0,0,5,100.0
350460,2020,4,0,0,4,100.0
350470,2016,1,0,0,1,100.0
350470,2020,0,1,1,2,50.0
350480,2012,4,0,0,4,100.0
350480,2013,2,0,0,2,100.0
350480,2014,1,0,0,1,100.0
350480,2015,2,0,1,3,66.66666666666666
350480,2016,2,0,0,2,100.0
350480,2017,1,0,0,1,100.0
350480,2018,3,0,0,3,100.0
350480,2019,3,0,0,3,100.0
350480,2020,3,0,0,3,100.0
350490,2012,0,0,3,3,0.0
350490,2013,0,0,1,1,0.0
350490,2014,0,2,1,3,66.66666666666666
350490,2015,0,0,3,3,0.0
350490,2016,0,1,5,6,16.666666666666664
350490,2017,2,0,1,3,66.66666666666666
350490,2018,3,0,0,3,100.0
350490,2020,0,0,1,1,0.0
350500,2013,1,0,0,1,100.0
350500,2015,1,0,0,1,100.0
350500,2017,2,0,0,2,100.0
350500,2018,2,0,0,2,100.0
350500,2019,0,0,1,1,0.0
350500,2020,2,0,0,2,100.0
350510,2012,3,0,0,3,100.0
350510,2013,3,0,0,3,100.0
350510,2014,5,0,0,5,100.0
350510,2015,5,0,0,5,100.0
350510,2016,2,0,0,2,100.0
350510,2017,1,0,0,1,100.0
350510,2018,1,0,0,1,100.0
350510,2019,0,0,1,1,0.0
350520,2012,11,0,1,12,91.66666666666666
350520,2013,12,0,0,12,100.0
350520,2014,6,0,1,7,85.71428571428571
350520,2015,16,0,0,16,100.0
350520,2016,5,1,0,6,100.0
350520,2017,11,0,1,12,91.66666666666666
350520,2018,7,0,0,7,100.0
350520,2019,5,1,4,10,60.0
350520,2020,4,4,5,13,61.53846153846154
350530,2012,13,0,0,13,100.0
350530,2013,15,1,0,16,100.0
350530,2014,0,3,8,11,27.27272727272727
350530,2015,13,1,1,15,93.33333333333333
350530,2016,13,1,1,15,93.33333333333333
350530,2017,13,0,0,13,100.0
350530,2018,17,0,0,17,100.0
350530,2019,7,0,0,7,100.0
350530,2020,12,1,1,14,92.85714285714286
350535,2014,3,0,0,3,100.0
350535,2017,4,0,0,4,100.0
350535,2018,2,0,0,2,100.0
350535,2019,2,0,0,2,100.0
350535,2020,1,0,1,2,50.0
350540,2012,6,0,0,6,100.0
350540,2013,1,0,2,3,33.33333333333333
350540,2014,5,0,0,5,100.0
350540,2015,2,0,0,2,100.0
350540,2017,1,0,1,2,50.0
350540,2018,0,1,0,1,100.0
350540,2019,0,1,2,3,33.33333333333333
350540,2020,1,1,2,4,50.0
350550,2012,50,0,2,52,96.15384615384616
350550,2013,60,1,0,61,100.0
350550,2014,60,0,0,60,100.0
350550,2015,50,0,2,52,96.15384615384616
350550,2016,71,0,4,75,94.66666666666667
350550,2017,38,0,0,38,100.0
350550,2018,43,0,0,43,100.0
350550,2019,37,1,5,43,88.37209302325581
350550,2020,21,14,6,41,85.36585365853658
350560,2012,8,0,0,8,100.0
350560,2013,6,0,2,8,75.0
350560,2014,13,0,0,13,100.0
350560,2015,10,0,0,10,100.0
350560,2016,13,0,0,13,100.0
350560,2017,8,0,1,9,88.88888888888889
350560,2018,13,0,0,13,100.0
350560,2019,7,0,0,7,100.0
350560,2020,13,0,0,13,100.0
350570,2012,115,0,0,115,100.0
350570,2013,112,0,0,112,100.0
350570,2014,127,0,5,132,96.21212121212122
350570,2015,91,4,24,119,79.83193277310924
350570,2016,121,0,1,122,99.18032786885246
350570,2017,132,0,1,133,99.24812030075188
350570,2018,109,0,1,110,99.0909090909091
350570,2019,115,0,1,116,99.13793103448276
350570,2020,113,1,9,123,92.6829268292683
350580,2012,12,0,0,12,100.0
350580,2013,4,0,0,4,100.0
350580,2014,8,0,0,8,100.0
350580,2015,7,0,1,8,87.5
350580,2016,9,0,0,9,100.0
350580,2017,6,0,0,6,100.0
350580,2018,1,0,0,1,100.0
350580,2019,7,0,0,7,100.0
350580,2020,8,0,0,8,100.0
350590,2012,17,0,2,19,89.47368421052632
350590,2013,14,0,2,16,87.5
350590,2014,16,0,1,17,94.11764705882352
350590,2015,18,0,0,18,100.0
350590,2016,20,0,0,20,100.0
350590,2017,16,0,0,16,100.0
350590,2018,19,0,0,19,100.0
350590,2019,18,0,0,18,100.0
350590,2020,13,0,0,13,100.0
350600,2012,108,12,6,126,95.23809523809523
350600,2013,119,1,0,120,100.0
350600,2014,108,1,2,111,98.1981981981982
350600,2015,84,13,11,108,89.81481481481481
350600,2016,100,0,0,100,100.0
350600,2017,105,0,0,105,100.0
350600,2018,90,6,7,103,93.20388349514563
350600,2019,87,5,12,104,88.46153846153845
350600,2020,110,0,0,110,100.0
350610,2012,33,0,0,33,100.0
350610,2013,27,0,0,27,100.0
350610,2014,24,0,0,24,100.0
350610,2015,24,0,1,25,96.0
350610,2016,20,0,0,20,100.0
350610,2017,12,1,10,23,56.52173913043478
350610,2018,5,1,17,23,26.08695652173913
350610,2019,9,0,9,18,50.0
350610,2020,30,0,0,30,100.0
350620,2012,1,0,0,1,100.0
350620,2013,1,0,0,1,100.0
350620,2016,1,0,0,1,100.0
350620,2018,0,0,2,2,0.0
350620,2019,0,0,1,1,0.0
350620,2020,1,0,0,1,100.0
350630,2012,5,0,0,5,100.0
350630,2013,6,3,1,10,90.0
350630,2014,2,0,0,2,100.0
350630,2015,3,0,0,3,100.0
350630,2016,3,0,0,3,100.0
350630,2017,6,0,0,6,100.0
350630,2018,1,0,0,1,100.0
350630,2019,2,0,0,2,100.0
350630,2020,0,0,2,2,0.0
350635,2012,4,1,11,16,31.25
350635,2013,6,0,11,17,35.294117647058826
350635,2014,5,1,8,14,42.857142857142854
350635,2015,17,2,4,23,82.6086956521739
350635,2016,27,0,0,27,100.0
350635,2017,15,0,3,18,83.33333333333334
350635,2018,8,3,1,12,91.66666666666666
350635,2019,14,0,0,14,100.0
350635,2020,24,0,0,24,100.0
350640,2012,2,0,0,2,100.0
350640,2013,2,0,0,2,100.0
350640,2014,3,0,0,3,100.0
350640,2015,3,0,0,3,100.0
350640,2016,2,0,0,2,100.0
350640,2017,0,1,0,1,100.0
350640,2018,1,0,0,1,100.0
350640,2019,1,0,0,1,100.0
350640,2020,3,0,0,3,100.0
350650,2012,34,0,0,34,100.0
350650,2013,26,0,0,26,100.0
350650,2014,22,0,0,22,100.0
350650,2015,36,0,0,36,100.0
350650,2016,28,0,0,28,100.0
350650,2017,28,0,0,28,100.0
350650,2018,33,0,0,33,100.0
350650,2019,33,0,0,33,100.0
350650,2020,36,0,0,36,100.0
350660,2012,8,0,0,8,100.0
350660,2013,7,0,0,7,100.0
350660,2014,12,0,0,12,100.0
350660,2015,9,0,0,9,100.0
350660,2016,12,0,0,12,100.0
350660,2017,7,0,0,7,100.0
350660,2018,13,0,0,13,100.0
350660,2019,5,0,0,5,100.0
350660,2020,11,0,0,11,100.0
350670,2012,2,0,1,3,66.66666666666666
350670,2013,0,1,4,5,20.0
350670,2014,1,0,4,5,20.0
350670,2015,5,0,0,5,100.0
350670,2017,4,0,0,4,100.0
350670,2018,2,0,0,2,100.0
350670,2019,8,0,0,8,100.0
350670,2020,7,0,0,7,100.0
350680,2012,0,1,4,5,20.0
350680,2013,0,0,1,1,0.0
350680,2014,0,0,1,1,0.0
350680,2015,0,3,0,3,100.0
350680,2016,0,3,2,5,60.0
350680,2017,0,1,0,1,100.0
350680,2018,1,0,0,1,100.0
350680,2019,3,4,0,7,100.0
350680,2020,3,0,1,4,75.0
350690,2012,1,0,0,1,100.0
350690,2013,4,0,0,4,100.0
350690,2016,3,0,0,3,100.0
350690,2017,4,0,0,4,100.0
350690,2018,3,0,0,3,100.0
350690,2019,3,0,0,3,100.0
350690,2020,2,0,0,2,100.0
350700,2012,13,0,0,13,100.0
350700,2013,19,0,0,19,100.0
350700,2014,22,0,0,22,100.0
350700,2015,14,0,0,14,100.0
350700,2016,10,0,0,10,100.0
350700,2017,22,0,0,22,100.0
350700,2018,8,0,0,8,100.0
350700,2019,11,0,0,11,100.0
350700,2020,21,0,0,21,100.0
350710,2012,5,0,0,5,100.0
350710,2013,6,0,0,6,100.0
350710,2014,6,0,0,6,100.0
350710,2015,7,0,0,7,100.0
350710,2016,8,0,0,8,100.0
350710,2017,2,0,0,2,100.0
350710,2018,7,0,0,7,100.0
350710,2019,7,0,0,7,100.0
350710,2020,9,0,0,9,100.0
350715,2012,0,0,3,3,0.0
350715,2013,3,0,0,3,100.0
350715,2014,2,0,0,2,100.0
350715,2015,2,0,0,2,100.0
350715,2016,1,0,0,1,100.0
350715,2017,1,0,0,1,100.0
350715,2018,3,0,0,3,100.0
350715,2019,1,0,0,1,100.0
350715,2020,2,0,0,2,100.0
350720,2012,0,0,1,1,0.0
350730,2013,2,0,0,2,100.0
350730,2014,2,0,0,2,100.0
350730,2015,1,0,0,1,100.0
350730,2018,0,0,1,1,0.0
350730,2019,1,0,0,1,100.0
350740,2012,6,0,2,8,75.0
350740,2013,5,0,0,5,100.0
350740,2014,15,0,0,15,100.0
350740,2015,3,0,0,3,100.0
350740,2016,5,0,0,5,100.0
350740,2017,2,0,0,2,100.0
350740,2018,1,0,0,1,100.0
350740,2019,3,0,0,3,100.0
350740,2020,6,0,0,6,100.0
350745,2012,0,0,1,1,0.0
350745,2013,1,0,0,1,100.0
350745,2016,0,1,0,1,100.0
350745,2017,1,0,0,1,100.0
350745,2018,1,0,0,1,100.0
350750,2012,39,0,0,39,100.0
350750,2013,33,0,0,33,100.0
350750,2014,21,0,0,21,100.0
350750,2015,52,0,0,52,100.0
350750,2016,40,0,0,40,100.0
350750,2017,29,0,0,29,100.0
350750,2018,44,0,0,44,100.0
350750,2019,36,0,0,36,100.0
350750,2020,45,0,0,45,100.0
350760,2012,45,0,0,45,100.0
350760,2013,46,0,1,47,97.87234042553192
350760,2014,53,0,0,53,100.0
350760,2015,45,0,0,45,100.0
350760,2016,55,0,0,55,100.0
350760,2017,47,0,0,47,100.0
350760,2018,53,0,1,54,98.14814814814815
350760,2019,40,0,0,40,100.0
350760,2020,37,0,2,39,94.87179487179486
350770,2014,2,0,1,3,66.66666666666666
350770,2015,1,0,0,1,100.0
350770,2017,1,0,0,1,100.0
350770,2020,0,0,4,4,0.0
350775,2012,0,0,1,1,0.0
350775,2013,0,0,3,3,0.0
350775,2014,2,0,0,2,100.0
350775,2016,1,0,0,1,100.0
350775,2019,0,0,1,1,0.0
350780,2012,8,0,0,8,100.0
350780,2013,7,0,0,7,100.0
350780,2014,5,0,0,5,100.0
350780,2015,6,0,0,6,100.0
350780,2016,7,0,0,7,100.0
350780,2017,6,0,0,6,100.0
350780,2018,3,1,0,4,100.0
350780,2019,8,0,0,8,100.0
350780,2020,11,0,0,11,100.0
350790,2012,5,0,1,6,83.33333333333334
350790,2013,10,0,0,10,100.0
350790,2014,5,0,3,8,62.5
350790,2015,5,0,0,5,100.0
350790,2016,6,0,0,6,100.0
350790,2017,7,0,0,7,100.0
350790,2018,8,0,0,8,100.0
350790,2019,3,0,0,3,100.0
350790,2020,7,0,0,7,100.0
350800,2012,7,0,0,7,100.0
350800,2013,3,0,0,3,100.0
350800,2014,9,0,0,9,100.0
350800,2015,13,0,0,13,100.0
350800,2016,6,0,0,6,100.0
350800,2017,8,0,0,8,100.0
350800,2018,5,0,0,5,100.0
350800,2019,6,0,0,6,100.0
350800,2020,2,0,0,2,100.0
350810,2012,7,0,0,7,100.0
350810,2013,5,0,0,5,100.0
350810,2014,2,0,0,2,100.0
350810,2015,8,0,0,8,100.0
350810,2016,6,0,0,6,100.0
350810,2017,4,0,0,4,100.0
350810,2018,9,0,0,9,100.0
350810,2019,5,0,0,5,100.0
350810,2020,11,0,0,11,100.0
350820,2012,1,0,1,2,50.0
350820,2014,4,0,0,4,100.0
350820,2015,2,0,0,2,100.0
350820,2016,1,0,0,1,100.0
350820,2017,1,0,0,1,100.0
350820,2018,2,0,0,2,100.0
350820,2020,1,0,0,1,100.0
350830,2012,0,0,3,3,0.0
350830,2014,3,0,0,3,100.0
350830,2015,1,0,0,1,100.0
350830,2018,1,0,0,1,100.0
350830,2019,1,2,0,3,100.0
350830,2020,2,1,0,3,100.0
350840,2012,11,1,0,12,100.0
350840,2013,11,0,4,15,73.33333333333333
350840,2014,8,0,3,11,72.72727272727273
350840,2015,10,0,0,10,100.0
350840,2016,9,0,1,10,90.0
350840,2017,8,1,0,9,100.0
350840,2018,9,0,0,9,100.0
350840,2019,13,0,2,15,86.66666666666667
350840,2020,16,0,3,19,84.21052631578947
350850,2012,28,0,0,28,100.0
350850,2013,30,0,0,30,100.0
350850,2014,25,0,0,25,100.0
350850,2015,34,0,0,34,100.0
350850,2016,18,0,4,22,81.81818181818183
350850,2017,2,1,26,29,10.344827586206897
350850,2018,7,2,14,23,39.130434782608695
350850,2019,5,4,11,20,45.0
350850,2020,18,1,3,22,86.36363636363636
350860,2012,10,2,0,12,100.0
350860,2013,10,0,0,10,100.0
350860,2014,7,0,0,7,100.0
350860,2015,8,0,0,8,100.0
350860,2016,10,0,0,10,100.0
350860,2017,10,0,0,10,100.0
350860,2018,9,0,1,10,90.0
350860,2019,0,1,7,8,12.5
350860,2020,7,0,0,7,100.0
350870,2012,6,0,0,6,100.0
350870,2013,7,0,0,7,100.0
350870,2014,3,0,0,3,100.0
350870,2015,4,0,2,6,66.66666666666666
350870,2016,2,0,1,3,66.66666666666666
350870,2017,4,0,0,4,100.0
350870,2018,6,0,0,6,100.0
350870,2019,3,0,0,3,100.0
350870,2020,6,0,0,6,100.0
350880,2012,1,0,8,9,11.11111111111111
350880,2013,1,0,4,5,20.0
350880,2014,0,0,3,3,0.0
350880,2015,0,1,4,5,20.0
350880,2016,3,0,2,5,60.0
350880,2017,0,1,6,7,14.285714285714285
350880,2018,0,0,7,7,0.0
350880,2019,0,2,3,5,40.0
350880,2020,0,0,1,1,0.0
350890,2012,2,0,0,2,100.0
350890,2014,0,0,1,1,0.0
350890,2015,0,0,2,2,0.0
350890,2016,2,0,0,2,100.0
350890,2019,0,0,1,1,0.0
350890,2020,1,0,0,1,100.0
350900,2012,10,1,18,29,37.93103448275862
350900,2013,40,0,0,40,100.0
350900,2014,22,0,0,22,100.0
350900,2015,18,5,10,33,69.6969696969697
350900,2016,27,0,0,27,100.0
350900,2017,19,0,4,23,82.6086956521739
350900,2018,31,0,0,31,100.0
350900,2019,31,0,0,31,100.0
350900,2020,33,0,0,33,100.0
350910,2012,0,0,2,2,0.0
350910,2013,1,0,2,3,33.33333333333333
350910,2014,0,1,2,3,33.33333333333333
350910,2017,0,0,1,1,0.0
350910,2018,0,0,2,2,0.0
350910,2019,0,0,1,1,0.0
350910,2020,0,0,1,1,0.0
350920,2012,23,0,0,23,100.0
350920,2013,20,0,3,23,86.95652173913044
350920,2014,28,1,1,30,96.66666666666667
350920,2015,28,0,5,33,84.84848484848484
350920,2016,28,0,0,28,100.0
350920,2017,16,0,1,17,94.11764705882352
350920,2018,22,0,0,22,100.0
350920,2019,30,0,0,30,100.0
350920,2020,36,1,1,38,97.36842105263158
350925,2012,7,0,0,7,100.0
350925,2013,10,0,0,10,100.0
350925,2014,11,0,0,11,100.0
350925,2015,6,0,0,6,100.0
350925,2016,14,0,0,14,100.0
350925,2017,11,0,0,11,100.0
350925,2018,11,0,0,11,100.0
350925,2019,10,0,0,10,100.0
350925,2020,8,0,0,8,100.0
350930,2013,0,0,2,2,0.0
350930,2015,1,1,2,4,50.0
350930,2016,3,0,0,3,100.0
350930,2018,2,0,0,2,100.0
350930,2019,5,0,0,5,100.0
350930,2020,4,0,0,4,100.0
350940,2012,6,0,0,6,100.0
350940,2013,7,0,0,7,100.0
350940,2014,7,0,5,12,58.333333333333336
350940,2015,6,0,0,6,100.0
350940,2016,8,0,0,8,100.0
350940,2017,7,0,0,7,100.0
350940,2018,9,0,0,9,100.0
350940,2019,5,0,0,5,100.0
350940,2020,7,0,0,7,100.0
350945,2012,1,0,4,5,20.0
350945,2013,0,0,1,1,0.0
350945,2014,0,0,2,2,0.0
350945,2016,0,1,3,4,25.0
350945,2017,0,0,2,2,0.0
350945,2018,1,0,1,2,50.0
350945,2019,1,0,1,2,50.0
350945,2020,2,0,0,2,100.0
350950,2012,282,0,0,282,100.0
350950,2013,293,7,33,333,90.09009009009009
350950,2014,276,2,0,278,100.0
350950,2015,287,0,0,287,100.0
350950,2016,280,0,0,280,100.0
350950,2017,273,0,0,273,100.0
350950,2018,260,0,0,260,100.0
350950,2019,272,0,3,275,98.9090909090909
350950,2020,306,0,0,306,100.0
350960,2012,25,0,1,26,96.15384615384616
350960,2013,18,2,2,22,90.9090909090909
350960,2014,22,0,0,22,100.0
350960,2015,25,0,0,25,100.0
350960,2016,9,0,8,17,52.94117647058824
350960,2017,1,2,18,21,14.285714285714285
350960,2018,0,1,19,20,5.0
350960,2019,2,0,32,34,5.88235294117647
350960,2020,0,1,21,22,4.545454545454546
350970,2012,23,0,0,23,100.0
350970,2013,20,0,1,21,95.23809523809523
350970,2014,14,0,0,14,100.0
350970,2015,20,2,1,23,95.65217391304348
350970,2016,0,9,11,20,45.0
350970,2017,15,0,0,15,100.0
350970,2018,19,0,0,19,100.0
350970,2019,19,0,0,19,100.0
350970,2020,12,0,0,12,100.0
350980,2012,2,0,0,2,100.0
350980,2014,1,0,0,1,100.0
350980,2016,2,0,0,2,100.0
350980,2017,2,0,0,2,100.0
350980,2019,2,0,0,2,100.0
350990,2012,2,0,1,3,66.66666666666666
350990,2013,3,0,1,4,75.0
350990,2014,2,0,1,3,66.66666666666666
350990,2015,0,0,3,3,0.0
350990,2016,6,0,1,7,85.71428571428571
350990,2017,0,1,3,4,25.0
350990,2018,0,1,4,5,20.0
350990,2019,1,0,5,6,16.666666666666664
350990,2020,1,1,3,5,40.0
350995,2012,2,1,0,3,100.0
350995,2013,1,0,1,2,50.0
350995,2014,0,1,1,2,50.0
350995,2015,0,0,1,1,0.0
350995,2016,3,0,0,3,100.0
350995,2017,2,0,0,2,100.0
350995,2018,2,0,0,2,100.0
350995,2019,2,0,0,2,100.0
350995,2020,2,0,0,2,100.0
351000,2012,4,1,7,12,41.66666666666667
351000,2013,8,1,6,15,60.0
351000,2014,8,0,0,8,100.0
351000,2015,9,0,0,9,100.0
351000,2016,9,0,0,9,100.0
351000,2017,8,0,0,8,100.0
351000,2018,11,0,0,11,100.0
351000,2019,8,0,0,8,100.0
351000,2020,7,0,0,7,100.0
351010,2012,1,0,0,1,100.0
351010,2019,2,0,1,3,66.66666666666666
351010,2020,1,0,0,1,100.0
351015,2013,0,0,1,1,0.0
351015,2014,0,0,2,2,0.0
351015,2016,0,0,1,1,0.0
351015,2017,0,1,5,6,16.666666666666664
351015,2018,0,0,1,1,0.0
351020,2012,22,0,0,22,100.0
351020,2013,20,0,0,20,100.0
351020,2014,15,0,0,15,100.0
351020,2015,16,0,0,16,100.0
351020,2016,14,0,1,15,93.33333333333333
351020,2017,24,0,0,24,100.0
351020,2018,15,0,0,15,100.0
351020,2019,13,0,0,13,100.0
351020,2020,15,0,0,15,100.0
351030,2012,1,0,0,1,100.0
351030,2013,1,0,5,6,16.666666666666664
351030,2014,0,0,8,8,0.0
351030,2015,0,0,6,6,0.0
351030,2016,4,0,0,4,100.0
351030,2017,7,0,1,8,87.5
351030,2018,2,0,4,6,33.33333333333333
351030,2019,5,0,0,5,100.0
351030,2020,7,0,0,7,100.0
351040,2012,13,1,0,14,100.0
351040,2013,14,1,0,15,100.0
351040,2014,10,12,0,22,100.0
351040,2015,3,12,2,17,88.23529411764706
351040,2016,13,1,2,16,87.5
351040,2017,12,0,0,12,100.0
351040,2018,13,1,0,14,100.0
351040,2019,13,4,0,17,100.0
351040,2020,12,2,0,14,100.0
351050,2012,44,0,1,45,97.77777777777777
351050,2013,30,0,8,38,78.94736842105263
351050,2014,17,1,16,34,52.94117647058824
351050,2015,35,2,4,41,90.2439024390244
351050,2016,28,1,7,36,80.55555555555556
351050,2017,40,1,4,45,91.11111111111111
351050,2018,43,0,8,51,84.31372549019608
351050,2019,29,1,9,39,76.92307692307693
351050,2020,38,3,7,48,85.41666666666666
351060,2012,121,0,1,122,99.18032786885246
351060,2013,110,1,3,114,97.36842105263158
351060,2014,113,0,1,114,99.12280701754386
351060,2015,133,0,0,133,100.0
351060,2016,116,0,3,119,97.47899159663865
351060,2017,108,0,0,108,100.0
351060,2018,131,0,0,131,100.0
351060,2019,115,0,0,115,100.0
351060,2020,139,0,9,148,93.91891891891892
351070,2012,4,0,0,4,100.0
351070,2013,6,0,0,6,100.0
351070,2014,4,0,0,4,100.0
351070,2015,4,0,0,4,100.0
351070,2016,1,0,0,1,100.0
351070,2017,7,0,0,7,100.0
351070,2018,2,0,0,2,100.0
351070,2019,8,0,0,8,100.0
351070,2020,1,0,0,1,100.0
351080,2012,5,0,0,5,100.0
351080,2013,15,1,0,16,100.0
351080,2014,7,0,0,7,100.0
351080,2015,11,0,1,12,91.66666666666666
351080,2016,12,0,0,12,100.0
351080,2017,7,0,0,7,100.0
351080,2018,6,0,0,6,100.0
351080,2019,17,0,0,17,100.0
351080,2020,12,0,0,12,100.0
351090,2015,0,0,1,1,0.0
351090,2016,0,0,1,1,0.0
351090,2017,1,0,0,1,100.0
351090,2020,0,0,1,1,0.0
351100,2012,7,0,0,7,100.0
351100,2013,5,0,0,5,100.0
351100,2014,4,0,0,4,100.0
351100,2015,3,0,0,3,100.0
351100,2016,6,0,0,6,100.0
351100,2017,7,0,0,7,100.0
351100,2018,4,0,0,4,100.0
351100,2019,4,0,0,4,100.0
351100,2020,5,0,0,5,100.0
351110,2012,35,0,1,36,97.22222222222221
351110,2013,41,0,0,41,100.0
351110,2014,36,0,0,36,100.0
351110,2015,40,0,0,40,100.0
351110,2016,33,0,0,33,100.0
351110,2017,41,0,0,41,100.0
351110,2018,42,0,0,42,100.0
351110,2019,32,1,0,33,100.0
351110,2020,34,0,0,34,100.0
351120,2012,3,0,0,3,100.0
351120,2013,5,0,0,5,100.0
351120,2014,4,0,0,4,100.0
351120,2015,3,0,0,3,100.0
351120,2016,4,0,0,4,100.0
351120,2017,4,0,0,4,100.0
351120,2018,2,0,0,2,100.0
351120,2019,1,0,0,1,100.0
351120,2020,2,0,0,2,100.0
351130,2012,3,0,0,3,100.0
351130,2013,2,0,0,2,100.0
351130,2014,2,0,2,4,50.0
351130,2015,5,0,0,5,100.0
351130,2016,1,0,0,1,100.0
351130,2017,1,0,1,2,50.0
351130,2019,4,0,0,4,100.0
351130,2020,3,0,0,3,100.0
351140,2012,6,0,0,6,100.0
351140,2013,11,0,0,11,100.0
351140,2014,8,0,0,8,100.0
351140,2015,5,0,0,5,100.0
351140,2016,3,0,0,3,100.0
351140,2017,10,0,0,10,100.0
351140,2018,5,0,0,5,100.0
351140,2019,13,0,0,13,100.0
351140,2020,7,0,0,7,100.0
351150,2012,8,0,0,8,100.0
351150,2013,15,0,0,15,100.0
351150,2014,14,0,0,14,100.0
351150,2015,15,0,0,15,100.0
351150,2016,13,0,0,13,100.0
351150,2017,9,0,1,10,90.0
351150,2018,15,0,0,15,100.0
351150,2019,9,0,1,10,90.0
351150,2020,8,0,0,8,100.0
351160,2012,4,1,0,5,100.0
351160,2013,2,0,6,8,25.0
351160,2014,5,0,6,11,45.45454545454545
351160,2015,7,0,0,7,100.0
351160,2016,4,0,1,5,80.0
351160,2017,3,0,0,3,100.0
351160,2018,5,0,0,5,100.0
351160,2019,5,0,0,5,100.0
351160,2020,6,0,0,6,100.0
351170,2012,2,1,0,3,100.0
351170,2013,6,0,0,6,100.0
351170,2014,3,0,0,3,100.0
351170,2015,5,0,0,5,100.0
351170,2016,3,0,1,4,75.0
351170,2017,4,1,1,6,83.33333333333334
351170,2018,2,3,0,5,100.0
351170,2019,5,1,0,6,100.0
351170,2020,3,0,0,3,100.0
351190,2012,2,0,0,2,100.0
351190,2013,2,0,0,2,100.0
351190,2014,3,0,0,3,100.0
351190,2015,2,0,0,2,100.0
351190,2016,6,0,0,6,100.0
351190,2017,2,0,0,2,100.0
351190,2018,3,0,0,3,100.0
351190,2019,5,0,0,5,100.0
351190,2020,0,0,1,1,0.0
351200,2012,3,0,0,3,100.0
351200,2013,6,0,0,6,100.0
351200,2014,3,0,1,4,75.0
351200,2015,4,0,2,6,66.66666666666666
351200,2016,5,0,10,15,33.33333333333333
351200,2017,4,0,0,4,100.0
351200,2018,4,0,0,4,100.0
351200,2019,5,1,1,7,85.71428571428571
351200,2020,11,0,0,11,100.0
351210,2012,5,0,0,5,100.0
351210,2013,1,0,0,1,100.0
351210,2014,3,0,0,3,100.0
351210,2015,3,0,0,3,100.0
351210,2016,1,0,0,1,100.0
351210,2017,2,0,0,2,100.0
351210,2019,3,0,0,3,100.0
351210,2020,1,0,0,1,100.0
351220,2012,2,0,3,5,40.0
351220,2013,0,1,7,8,12.5
351220,2014,6,0,3,9,66.66666666666666
351220,2015,10,0,0,10,100.0
351220,2016,9,0,0,9,100.0
351220,2017,9,0,0,9,100.0
351220,2018,10,0,0,10,100.0
351220,2019,7,0,0,7,100.0
351220,2020,9,0,0,9,100.0
351230,2012,5,0,0,5,100.0
351230,2013,3,0,1,4,75.0
351230,2014,5,0,0,5,100.0
351230,2015,6,0,0,6,100.0
351230,2016,6,0,0,6,100.0
351230,2017,5,0,0,5,100.0
351230,2018,2,0,0,2,100.0
351230,2019,3,0,0,3,100.0
351230,2020,1,0,0,1,100.0
351240,2012,5,0,2,7,71.42857142857143
351240,2013,8,0,0,8,100.0
351240,2014,7,0,0,7,100.0
351240,2015,4,0,0,4,100.0
351240,2016,8,0,0,8,100.0
351240,2017,3,0,0,3,100.0
351240,2018,6,0,0,6,100.0
351240,2019,6,0,0,6,100.0
351240,2020,2,0,0,2,100.0
351250,2012,2,0,0,2,100.0
351250,2013,1,0,0,1,100.0
351250,2014,1,0,0,1,100.0
351250,2017,3,0,0,3,100.0
351250,2018,1,0,0,1,100.0
351250,2019,2,0,0,2,100.0
351250,2020,4,0,0,4,100.0
351260,2012,0,0,1,1,0.0
351260,2013,3,0,0,3,100.0
351260,2015,2,0,0,2,100.0
351260,2016,3,0,0,3,100.0
351260,2017,1,0,0,1,100.0
351260,2018,1,0,0,1,100.0
351260,2019,1,0,0,1,100.0
351260,2020,1,0,0,1,100.0
351270,2012,1,0,0,1,100.0
351270,2013,1,0,0,1,100.0
351270,2015,1,0,0,1,100.0
351270,2016,2,0,0,2,100.0
351270,2017,1,0,0,1,100.0
351270,2018,1,0,0,1,100.0
351270,2019,3,2,0,5,100.0
351270,2020,2,0,0,2,100.0
351280,2012,13,0,0,13,100.0
351280,2013,19,0,1,20,95.0
351280,2014,23,0,0,23,100.0
351280,2015,21,0,0,21,100.0
351280,2016,21,0,0,21,100.0
351280,2017,23,0,0,23,100.0
351280,2018,16,0,0,16,100.0
351280,2019,19,0,0,19,100.0
351280,2020,15,0,0,15,100.0
351290,2012,1,0,0,1,100.0
351290,2013,5,0,0,5,100.0
351290,2014,1,0,0,1,100.0
351290,2015,1,0,0,1,100.0
351290,2016,3,0,0,3,100.0
351290,2018,1,0,0,1,100.0
351290,2019,2,0,0,2,100.0
351290,2020,1,2,1,4,75.0
351300,2012,72,3,8,83,90.36144578313254
351300,2013,81,0,3,84,96.42857142857143
351300,2014,86,0,1,87,98.85057471264368
351300,2015,62,0,0,62,100.0
351300,2016,74,0,0,74,100.0
351300,2017,67,0,0,67,100.0
351300,2018,64,0,0,64,100.0
351300,2019,74,0,0,74,100.0
351300,2020,77,0,2,79,97.46835443037975
351310,2012,6,0,0,6,100.0
351310,2013,4,0,0,4,100.0
351310,2014,8,0,0,8,100.0
351310,2015,6,0,0,6,100.0
351310,2016,12,0,0,12,100.0
351310,2017,12,0,0,12,100.0
351310,2018,13,0,0,13,100.0
351310,2019,15,0,0,15,100.0
351310,2020,10,0,0,10,100.0
351320,2013,5,0,0,5,100.0
351320,2014,4,0,0,4,100.0
351320,2015,2,0,0,2,100.0
351320,2016,0,0,4,4,0.0
351320,2018,2,0,3,5,40.0
351320,2019,7,0,0,7,100.0
351320,2020,0,0,1,1,0.0
351330,2016,1,0,1,2,50.0
351330,2017,2,0,1,3,66.66666666666666
351330,2019,0,0,1,1,0.0
351340,2012,3,12,15,30,50.0
351340,2013,3,7,12,22,45.45454545454545
351340,2014,24,0,1,25,96.0
351340,2015,2,2,11,15,26.666666666666668
351340,2016,1,9,16,26,38.46153846153847
351340,2017,18,0,0,18,100.0
351340,2018,24,0,3,27,88.88888888888889
351340,2019,0,6,28,34,17.647058823529413
351340,2020,4,5,14,23,39.130434782608695
351350,2012,38,0,0,38,100.0
351350,2013,49,0,0,49,100.0
351350,2014,46,0,1,47,97.87234042553192
351350,2015,43,0,0,43,100.0
351350,2016,47,0,0,47,100.0
351350,2017,56,0,0,56,100.0
351350,2018,44,0,0,44,100.0
351350,2019,45,0,0,45,100.0
351350,2020,49,0,0,49,100.0
351360,2012,0,2,3,5,40.0
351360,2013,1,0,5,6,16.666666666666664
351360,2014,7,0,0,7,100.0
351360,2015,3,0,0,3,100.0
351360,2016,4,0,0,4,100.0
351360,2017,3,0,0,3,100.0
351360,2018,10,0,0,10,100.0
351360,2019,3,0,2,5,60.0
351360,2020,6,0,0,6,100.0
351370,2012,9,0,0,9,100.0
351370,2013,11,0,0,11,100.0
351370,2014,6,0,0,6,100.0
351370,2015,7,0,0,7,100.0
351370,2016,5,0,0,5,100.0
351370,2017,7,0,0,7,100.0
351370,2018,9,0,0,9,100.0
351370,2019,10,0,0,10,100.0
351370,2020,8,0,0,8,100.0
351380,2012,128,4,7,139,94.96402877697841
351380,2013,145,9,5,159,96.85534591194968
351380,2014,130,3,3,136,97.79411764705883
351380,2015,107,6,11,124,91.12903225806451
351380,2016,154,2,2,158,98.73417721518987
351380,2017,146,1,0,147,100.0
351380,2018,138,0,0,138,100.0
351380,2019,117,1,0,118,100.0
351380,2020,148,3,9,160,94.375
351385,2012,0,0,1,1,0.0
351385,2014,1,0,0,1,100.0
351385,2015,1,0,0,1,100.0
351385,2017,0,0,1,1,0.0
351385,2020,1,0,0,1,100.0
351390,2012,5,0,0,5,100.0
351390,2013,5,0,0,5,100.0
351390,2014,4,0,0,4,100.0
351390,2015,6,0,0,6,100.0
351390,2016,6,0,0,6,100.0
351390,2017,7,0,0,7,100.0
351390,2018,3,0,0,3,100.0
351390,2019,4,0,0,4,100.0
351390,2020,6,0,0,6,100.0
351400,2012,4,0,0,4,100.0
351400,2013,2,0,0,2,100.0
351400,2015,3,0,0,3,100.0
351400,2017,3,0,0,3,100.0
351400,2019,2,0,0,2,100.0
351400,2020,5,0,1,6,83.33333333333334
351410,2012,3,2,3,8,62.5
351410,2013,3,4,0,7,100.0
351410,2014,1,1,11,13,15.384615384615385
351410,2015,0,3,3,6,50.0
351410,2016,0,2,4,6,33.33333333333333
351410,2017,1,3,4,8,50.0
351410,2018,5,1,9,15,40.0
351410,2019,4,3,4,11,63.63636363636363
351410,2020,5,1,6,12,50.0
351420,2013,1,0,0,1,100.0
351420,2015,1,0,0,1,100.0
351420,2017,1,1,0,2,100.0
351420,2018,3,0,0,3,100.0
351420,2020,1,0,0,1,100.0
351430,2012,0,0,1,1,0.0
351430,2013,1,0,1,2,50.0
351430,2014,5,0,0,5,100.0
351430,2015,2,0,0,2,100.0
351430,2016,1,0,0,1,100.0
351430,2017,4,0,0,4,100.0
351430,2019,3,0,0,3,100.0
351430,2020,3,0,1,4,75.0
351440,2012,11,0,0,11,100.0
351440,2013,11,2,5,18,72.22222222222221
351440,2014,1,6,3,10,70.0
351440,2015,13,0,0,13,100.0
351440,2016,14,0,0,14,100.0
351440,2017,9,0,0,9,100.0
351440,2018,18,0,0,18,100.0
351440,2019,16,0,0,16,100.0
351440,2020,17,0,0,17,100.0
351450,2012,1,0,1,2,50.0
351450,2013,6,0,0,6,100.0
351450,2014,6,0,0,6,100.0
351450,2015,3,0,0,3,100.0
351450,2016,4,0,0,4,100.0
351450,2017,5,0,1,6,83.33333333333334
351450,2018,2,0,0,2,100.0
351450,2019,5,0,0,5,100.0
351450,2020,3,1,0,4,100.0
351460,2012,1,0,0,1,100.0
351460,2013,2,1,2,5,60.0
351460,2014,2,0,1,3,66.66666666666666
351460,2015,4,0,3,7,57.14285714285714
351460,2016,0,0,2,2,0.0
351460,2017,3,0,0,3,100.0
351460,2018,3,0,0,3,100.0
351460,2019,4,0,0,4,100.0
351460,2020,3,0,0,3,100.0
351470,2014,3,0,0,3,100.0
351470,2015,2,0,0,2,100.0
351470,2016,2,0,0,2,100.0
351470,2017,1,0,0,1,100.0
351470,2018,1,0,0,1,100.0
351470,2019,3,0,0,3,100.0
351470,2020,4,0,0,4,100.0
351480,2012,4,0,0,4,100.0
351480,2013,6,0,1,7,85.71428571428571
351480,2014,1,0,2,3,33.33333333333333
351480,2015,4,0,0,4,100.0
351480,2016,2,0,0,2,100.0
351480,2017,6,0,0,6,100.0
351480,2018,4,0,0,4,100.0
351480,2019,7,0,0,7,100.0
351480,2020,4,0,0,4,100.0
351490,2012,1,1,0,2,100.0
351490,2013,0,3,2,5,60.0
351490,2014,3,1,0,4,100.0
351490,2015,6,0,1,7,85.71428571428571
351490,2016,2,0,0,2,100.0
351490,2017,5,0,0,5,100.0
351490,2018,5,0,0,5,100.0
351490,2019,6,0,0,6,100.0
351490,2020,5,0,0,5,100.0
351492,2012,2,0,1,3,66.66666666666666
351492,2013,2,0,0,2,100.0
351492,2014,1,0,0,1,100.0
351492,2015,0,0,1,1,0.0
351492,2017,0,1,1,2,50.0
351492,2018,2,0,0,2,100.0
351492,2019,1,0,0,1,100.0
351492,2020,0,2,0,2,100.0
351495,2012,1,0,0,1,100.0
351495,2013,1,0,0,1,100.0
351495,2014,1,0,0,1,100.0
351495,2015,0,1,0,1,100.0
351495,2016,0,0,1,1,0.0
351495,2017,0,1,0,1,100.0
351495,2019,0,0,1,1,0.0
351495,2020,0,0,2,2,0.0
351500,2012,83,2,11,96,88.54166666666666
351500,2013,83,0,9,92,90.21739130434783
351500,2014,63,5,21,89,76.40449438202246
351500,2015,24,14,45,83,45.78313253012048
351500,2016,35,5,50,90,44.44444444444444
351500,2017,67,0,6,73,91.78082191780823
351500,2018,83,0,0,83,100.0
351500,2019,72,0,6,78,92.3076923076923
351500,2020,109,0,0,109,100.0
351510,2012,0,4,19,23,17.391304347826086
351510,2013,1,1,19,21,9.523809523809524
351510,2014,30,0,1,31,96.7741935483871
351510,2015,32,0,0,32,100.0
351510,2016,34,0,0,34,100.0
351510,2017,20,0,0,20,100.0
351510,2018,20,0,0,20,100.0
351510,2019,29,0,1,30,96.66666666666667
351510,2020,30,0,0,30,100.0
351512,2012,3,0,0,3,100.0
351512,2016,1,0,0,1,100.0
351512,2018,2,0,0,2,100.0
351512,2020,2,0,0,2,100.0
351515,2012,6,0,0,6,100.0
351515,2013,3,0,1,4,75.0
351515,2014,0,0,4,4,0.0
351515,2015,7,0,1,8,87.5
351515,2016,3,0,1,4,75.0
351515,2017,6,0,0,6,100.0
351515,2018,9,0,0,9,100.0
351515,2019,6,0,0,6,100.0
351515,2020,2,0,0,2,100.0
351518,2012,15,0,0,15,100.0
351518,2013,10,0,0,10,100.0
351518,2014,11,0,0,11,100.0
351518,2015,13,0,0,13,100.0
351518,2016,12,0,0,12,100.0
351518,2017,17,0,0,17,100.0
351518,2018,15,0,0,15,100.0
351518,2019,16,0,0,16,100.0
351518,2020,18,0,0,18,100.0
351519,2012,1,0,0,1,100.0
351519,2013,2,0,0,2,100.0
351519,2014,2,0,0,2,100.0
351519,2015,1,0,0,1,100.0
351519,2016,6,0,0,6,100.0
351519,2017,1,0,0,1,100.0
351519,2018,1,0,0,1,100.0
351519,2019,1,0,0,1,100.0
351519,2020,1,0,1,2,50.0
351520,2012,5,0,0,5,100.0
351520,2013,2,0,0,2,100.0
351520,2014,2,0,0,2,100.0
351520,2015,3,0,0,3,100.0
351520,2016,2,0,0,2,100.0
351520,2017,2,0,0,2,100.0
351520,2018,3,0,0,3,100.0
351520,2019,2,0,0,2,100.0
351520,2020,5,0,0,5,100.0
351530,2013,0,0,2,2,0.0
351530,2015,0,0,2,2,0.0
351530,2017,3,0,0,3,100.0
351530,2020,1,0,0,1,100.0
351535,2012,2,0,5,7,28.57142857142857
351535,2013,2,0,1,3,66.66666666666666
351535,2014,2,0,0,2,100.0
351535,2015,4,0,0,4,100.0
351535,2016,6,0,0,6,100.0
351535,2017,3,0,0,3,100.0
351535,2018,5,0,0,5,100.0
351535,2019,1,0,0,1,100.0
351535,2020,4,0,0,4,100.0
351540,2012,3,0,0,3,100.0
351540,2013,8,0,0,8,100.0
351540,2014,2,0,1,3,66.66666666666666
351540,2015,4,0,0,4,100.0
351540,2016,7,0,0,7,100.0
351540,2017,8,0,0,8,100.0
351540,2018,8,0,0,8,100.0
351540,2019,3,1,2,6,66.66666666666666
351540,2020,1,1,1,3,66.66666666666666
351550,2012,22,0,0,22,100.0
351550,2013,23,0,0,23,100.0
351550,2014,13,0,0,13,100.0
351550,2015,20,0,0,20,100.0
351550,2016,21,0,0,21,100.0
351550,2017,19,0,0,19,100.0
351550,2018,17,0,0,17,100.0
351550,2019,17,0,0,17,100.0
351550,2020,21,0,0,21,100.0
351560,2012,1,0,0,1,100.0
351560,2014,2,0,0,2,100.0
351560,2015,1,0,0,1,100.0
351560,2017,1,0,0,1,100.0
351560,2018,3,0,0,3,100.0
351560,2019,2,0,0,2,100.0
351560,2020,1,0,0,1,100.0
351565,2012,1,0,0,1,100.0
351565,2020,1,0,0,1,100.0
351570,2012,63,1,10,74,86.48648648648648
351570,2013,54,4,5,63,92.06349206349206
351570,2014,54,5,3,62,95.16129032258065
351570,2015,53,2,12,67,82.08955223880598
351570,2016,77,0,0,77,100.0
351570,2017,62,0,0,62,100.0
351570,2018,76,0,0,76,100.0
351570,2019,59,0,4,63,93.65079365079364
351570,2020,4,11,59,74,20.27027027027027
351580,2015,1,0,0,1,100.0
351580,2016,1,0,0,1,100.0
351580,2017,0,0,1,1,0.0
351590,2012,2,0,0,2,100.0
351590,2013,3,0,0,3,100.0
351590,2014,1,1,0,2,100.0
351590,2016,0,0,1,1,0.0
351590,2017,1,0,0,1,100.0
351590,2018,2,0,0,2,100.0
351590,2020,1,0,0,1,100.0
351600,2012,7,0,0,7,100.0
351600,2013,5,0,0,5,100.0
351600,2014,6,0,0,6,100.0
351600,2015,3,0,0,3,100.0
351600,2016,1,0,0,1,100.0
351600,2017,1,0,0,1,100.0
351600,2018,5,0,0,5,100.0
351600,2020,3,0,0,3,100.0
351610,2012,0,0,2,2,0.0
351610,2013,0,0,1,1,0.0
351610,2015,0,1,0,1,100.0
351610,2017,0,0,1,1,0.0
351610,2018,0,0,1,1,0.0
351610,2019,1,1,0,2,100.0
351610,2020,0,0,2,2,0.0
351620,2012,90,0,3,93,96.7741935483871
351620,2013,91,0,1,92,98.91304347826086
351620,2014,86,1,0,87,100.0
351620,2015,83,11,4,98,95.91836734693877
351620,2016,81,3,7,91,92.3076923076923
351620,2017,90,2,0,92,100.0
351620,2018,99,0,1,100,99.0
351620,2019,107,1,1,109,99.08256880733946
351620,2020,105,3,0,108,100.0
351630,2012,69,0,0,69,100.0
351630,2013,50,0,2,52,96.15384615384616
351630,2014,73,0,0,73,100.0
351630,2015,58,0,0,58,100.0
351630,2016,60,0,2,62,96.7741935483871
351630,2017,59,2,3,64,95.3125
351630,2018,55,0,0,55,100.0
351630,2019,60,0,0,60,100.0
351630,2020,75,0,0,75,100.0
351640,2012,30,5,31,66,53.03030303030303
351640,2013,21,2,30,53,43.39622641509434
351640,2014,42,0,1,43,97.67441860465115
351640,2015,35,1,9,45,80.0
351640,2016,35,0,2,37,94.5945945945946
351640,2017,53,0,2,55,96.36363636363636
351640,2018,34,2,0,36,100.0
351640,2019,43,0,0,43,100.0
351640,2020,65,1,2,68,97.05882352941177
351650,2012,1,0,0,1,100.0
351650,2013,1,0,0,1,100.0
351650,2014,1,0,0,1,100.0
351650,2016,1,0,0,1,100.0
351650,2017,1,0,0,1,100.0
351650,2020,1,0,0,1,100.0
351660,2013,1,0,0,1,100.0
351660,2014,3,0,0,3,100.0
351660,2015,5,0,0,5,100.0
351660,2016,5,0,0,5,100.0
351660,2017,4,0,0,4,100.0
351660,2018,3,0,0,3,100.0
351660,2019,4,0,0,4,100.0
351660,2020,1,0,0,1,100.0
351670,2012,22,0,1,23,95.65217391304348
351670,2013,15,0,0,15,100.0
351670,2014,12,0,0,12,100.0
351670,2015,12,0,0,12,100.0
351670,2016,21,0,0,21,100.0
351670,2017,18,0,0,18,100.0
351670,2018,17,0,0,17,100.0
351670,2019,13,0,0,13,100.0
351670,2020,13,0,0,13,100.0
351680,2012,1,0,0,1,100.0
351680,2016,1,0,0,1,100.0
351680,2017,1,0,0,1,100.0
351680,2019,1,0,0,1,100.0
351680,2020,1,0,0,1,100.0
351685,2013,1,0,0,1,100.0
351685,2014,0,0,1,1,0.0
351685,2015,0,0,2,2,0.0
351685,2016,2,0,0,2,100.0
351685,2017,2,0,0,2,100.0
351685,2018,2,0,0,2,100.0
351685,2019,1,0,0,1,100.0
351685,2020,3,0,0,3,100.0
351690,2012,3,0,0,3,100.0
351690,2013,6,0,0,6,100.0
351690,2014,9,0,0,9,100.0
351690,2015,6,0,0,6,100.0
351690,2017,5,0,0,5,100.0
351690,2018,2,0,0,2,100.0
351690,2019,3,0,0,3,100.0
351690,2020,6,0,0,6,100.0
351700,2012,0,0,3,3,0.0
351700,2013,2,0,0,2,100.0
351700,2014,1,0,0,1,100.0
351700,2015,4,0,0,4,100.0
351700,2016,2,2,0,4,100.0
351700,2017,1,1,5,7,28.57142857142857
351700,2018,0,0,1,1,0.0
351700,2019,0,0,1,1,0.0
351700,2020,0,0,1,1,0.0
351710,2012,1,0,0,1,100.0
351710,2013,1,0,0,1,100.0
351710,2014,2,0,0,2,100.0
351710,2015,2,0,1,3,66.66666666666666
351710,2016,3,0,0,3,100.0
351710,2017,1,0,0,1,100.0
351710,2018,2,0,0,2,100.0
351710,2019,6,0,0,6,100.0
351720,2012,5,0,0,5,100.0
351720,2013,3,0,0,3,100.0
351720,2014,4,0,3,7,57.14285714285714
351720,2015,2,0,0,2,100.0
351720,2016,2,0,1,3,66.66666666666666
351720,2017,6,0,1,7,85.71428571428571
351720,2018,4,0,0,4,100.0
351720,2019,8,1,2,11,81.81818181818183
351720,2020,3,0,0,3,100.0
351730,2012,1,0,0,1,100.0
351730,2013,2,0,0,2,100.0
351730,2014,2,0,0,2,100.0
351730,2015,1,0,0,1,100.0
351730,2017,1,0,0,1,100.0
351730,2018,3,0,0,3,100.0
351730,2019,3,0,0,3,100.0
351740,2012,23,2,0,25,100.0
351740,2013,14,0,0,14,100.0
351740,2014,21,0,0,21,100.0
351740,2015,18,0,0,18,100.0
351740,2016,17,0,0,17,100.0
351740,2017,15,0,0,15,100.0
351740,2018,16,0,0,16,100.0
351740,2019,15,0,0,15,100.0
351740,2020,13,0,0,13,100.0
351750,2012,6,0,0,6,100.0
351750,2013,1,0,0,1,100.0
351750,2014,2,0,0,2,100.0
351750,2015,4,0,1,5,80.0
351750,2016,6,0,0,6,100.0
351750,2017,4,0,0,4,100.0
351750,2018,3,0,0,3,100.0
351750,2019,6,0,0,6,100.0
351750,2020,4,0,0,4,100.0
351760,2012,7,0,0,7,100.0
351760,2013,3,0,1,4,75.0
351760,2014,4,0,2,6,66.66666666666666
351760,2015,1,0,4,5,20.0
351760,2016,4,0,0,4,100.0
351760,2017,3,0,0,3,100.0
351760,2018,4,0,0,4,100.0
351760,2019,8,0,0,8,100.0
351760,2020,8,0,0,8,100.0
351770,2012,5,0,0,5,100.0
351770,2013,6,0,0,6,100.0
351770,2014,10,0,0,10,100.0
351770,2015,6,0,0,6,100.0
351770,2016,12,0,0,12,100.0
351770,2017,7,0,0,7,100.0
351770,2018,8,0,0,8,100.0
351770,2019,5,0,0,5,100.0
351770,2020,17,0,0,17,100.0
351780,2013,2,0,0,2,100.0
351780,2014,4,0,0,4,100.0
351780,2015,1,0,0,1,100.0
351780,2016,2,0,0,2,100.0
351780,2017,4,0,0,4,100.0
351780,2018,1,0,0,1,100.0
351780,2019,2,0,0,2,100.0
351790,2012,9,0,0,9,100.0
351790,2013,2,0,2,4,50.0
351790,2014,3,0,1,4,75.0
351790,2015,2,0,1,3,66.66666666666666
351790,2016,2,0,1,3,66.66666666666666
351790,2017,8,0,1,9,88.88888888888889
351790,2018,2,0,0,2,100.0
351790,2020,3,0,0,3,100.0
351800,2012,1,0,0,1,100.0
351800,2015,1,0,0,1,100.0
351800,2016,1,0,0,1,100.0
351800,2017,1,0,0,1,100.0
351800,2018,1,0,0,1,100.0
351800,2020,3,0,0,3,100.0
351810,2012,1,0,0,1,100.0
351810,2013,2,0,0,2,100.0
351810,2014,2,0,0,2,100.0
351810,2015,4,0,0,4,100.0
351810,2016,1,0,0,1,100.0
351810,2017,5,0,0,5,100.0
351810,2018,1,0,0,1,100.0
351810,2019,2,0,0,2,100.0
351810,2020,1,0,0,1,100.0
351820,2012,11,0,0,11,100.0
351820,2013,7,0,0,7,100.0
351820,2014,5,0,0,5,100.0
351820,2015,8,0,0,8,100.0
351820,2016,10,0,0,10,100.0
351820,2017,10,0,0,10,100.0
351820,2018,10,0,0,10,100.0
351820,2019,9,0,0,9,100.0
351820,2020,15,0,0,15,100.0
351830,2012,4,0,0,4,100.0
351830,2013,7,1,2,10,80.0
351830,2014,1,1,5,7,28.57142857142857
351830,2015,8,0,0,8,100.0
351830,2016,5,0,0,5,100.0
351830,2017,8,0,0,8,100.0
351830,2018,8,0,0,8,100.0
351830,2019,4,0,0,4,100.0
351830,2020,9,0,0,9,100.0
351840,2012,46,0,0,46,100.0
351840,2013,30,4,5,39,87.17948717948718
351840,2014,33,0,0,33,100.0
351840,2015,36,0,1,37,97.2972972972973
351840,2016,36,0,2,38,94.73684210526315
351840,2017,49,0,1,50,98.0
351840,2018,25,0,0,25,100.0
351840,2019,26,0,1,27,96.29629629629629
351840,2020,40,0,0,40,100.0
351850,2012,0,0,3,3,0.0
351850,2013,0,0,2,2,0.0
351850,2015,0,1,3,4,25.0
351850,2016,0,2,5,7,28.57142857142857
351850,2017,4,1,0,5,100.0
351850,2018,4,2,2,8,75.0
351850,2019,1,0,0,1,100.0
351850,2020,7,0,0,7,100.0
351860,2012,9,0,0,9,100.0
351860,2013,8,0,0,8,100.0
351860,2014,11,0,0,11,100.0
351860,2015,13,0,0,13,100.0
351860,2016,12,0,0,12,100.0
351860,2017,8,0,0,8,100.0
351860,2018,10,0,0,10,100.0
351860,2019,17,0,1,18,94.44444444444444
351860,2020,17,0,0,17,100.0
351870,2012,109,0,1,110,99.0909090909091
351870,2013,130,0,0,130,100.0
351870,2014,134,0,0,134,100.0
351870,2015,124,0,0,124,100.0
351870,2016,115,0,1,116,99.13793103448276
351870,2017,127,0,0,127,100.0
351870,2018,118,0,0,118,100.0
351870,2019,101,0,0,101,100.0
351870,2020,171,0,0,171,100.0
351880,2012,442,3,3,448,99.33035714285714
351880,2013,428,0,1,429,99.76689976689977
351880,2014,426,2,13,441,97.05215419501134
351880,2015,396,2,27,425,93.64705882352942
351880,2016,448,2,17,467,96.35974304068522
351880,2017,431,0,1,432,99.76851851851852
351880,2018,457,1,1,459,99.78213507625271
351880,2019,439,1,14,454,96.91629955947137
351880,2020,501,3,17,521,96.73704414587331
351885,2012,0,1,0,1,100.0
351885,2013,3,0,0,3,100.0
351885,2015,1,0,0,1,100.0
351885,2016,4,0,0,4,100.0
351885,2017,1,0,0,1,100.0
351885,2018,3,0,0,3,100.0
351885,2019,3,0,0,3,100.0
351885,2020,1,0,0,1,100.0
351890,2012,1,0,0,1,100.0
351890,2014,2,0,0,2,100.0
351890,2015,3,0,0,3,100.0
351890,2016,1,0,0,1,100.0
351890,2017,1,0,0,1,100.0
351890,2020,4,0,0,4,100.0
351900,2012,1,0,0,1,100.0
351900,2013,5,0,0,5,100.0
351900,2014,5,0,0,5,100.0
351900,2015,3,0,0,3,100.0
351900,2016,4,0,0,4,100.0
351900,2017,4,0,0,4,100.0
351900,2018,4,0,0,4,100.0
351900,2019,2,0,0,2,100.0
351900,2020,4,0,0,4,100.0
351905,2012,0,1,0,1,100.0
351905,2013,0,1,4,5,20.0
351905,2014,0,1,0,1,100.0
351905,2015,3,0,0,3,100.0
351905,2016,0,0,1,1,0.0
351905,2017,1,2,1,4,75.0
351905,2018,0,0,2,2,0.0
351905,2019,1,0,4,5,20.0
351905,2020,0,0,5,5,0.0
351907,2012,77,0,0,77,100.0
351907,2013,63,0,1,64,98.4375
351907,2014,61,0,1,62,98.38709677419355
351907,2015,86,0,0,86,100.0
351907,2016,56,0,0,56,100.0
351907,2017,57,0,0,57,100.0
351907,2018,64,0,0,64,100.0
351907,2019,76,0,0,76,100.0
351907,2020,57,0,0,57,100.0
351910,2012,0,0,2,2,0.0
351910,2013,1,1,1,3,66.66666666666666
351910,2014,1,0,4,5,20.0
351910,2016,1,0,4,5,20.0
351910,2017,1,0,3,4,25.0
351910,2018,1,1,4,6,33.33333333333333
351910,2019,0,1,3,4,25.0
351910,2020,2,2,4,8,50.0
351920,2013,1,0,0,1,100.0
351920,2014,1,0,0,1,100.0
351920,2015,3,0,0,3,100.0
351920,2016,4,0,0,4,100.0
351920,2017,3,0,0,3,100.0
351920,2018,1,0,0,1,100.0
351920,2019,3,0,0,3,100.0
351920,2020,4,0,0,4,100.0
351925,2012,0,0,2,2,0.0
351925,2013,1,0,0,1,100.0
351925,2014,1,0,0,1,100.0
351925,2015,1,0,0,1,100.0
351925,2016,4,0,0,4,100.0
351925,2018,2,0,0,2,100.0
351925,2019,2,0,0,2,100.0
351925,2020,2,0,0,2,100.0
351930,2012,9,0,0,9,100.0
351930,2013,10,0,0,10,100.0
351930,2014,8,0,0,8,100.0
351930,2015,10,0,0,10,100.0
351930,2016,9,0,0,9,100.0
351930,2017,13,0,0,13,100.0
351930,2018,6,0,0,6,100.0
351930,2019,15,0,0,15,100.0
351930,2020,9,0,1,10,90.0
351940,2012,4,0,0,4,100.0
351940,2013,2,0,0,2,100.0
351940,2014,1,0,0,1,100.0
351940,2015,2,0,0,2,100.0
351940,2016,2,0,0,2,100.0
351940,2018,1,0,0,1,100.0
351940,2019,1,0,0,1,100.0
351940,2020,5,0,0,5,100.0
351950,2012,0,0,1,1,0.0
351950,2013,0,1,3,4,25.0
351950,2014,0,0,3,3,0.0
351950,2015,1,0,1,2,50.0
351950,2016,4,0,0,4,100.0
351950,2017,2,0,0,2,100.0
351950,2019,0,1,0,1,100.0
351950,2020,1,0,1,2,50.0
351960,2012,20,0,0,20,100.0
351960,2013,16,0,0,16,100.0
351960,2014,18,0,0,18,100.0
351960,2015,22,0,0,22,100.0
351960,2016,19,0,1,20,95.0
351960,2017,11,0,1,12,91.66666666666666
351960,2018,12,0,0,12,100.0
351960,2019,20,0,2,22,90.9090909090909
351960,2020,19,0,8,27,70.37037037037037
351970,2012,27,0,1,28,96.42857142857143
351970,2013,24,0,0,24,100.0
351970,2014,0,3,26,29,10.344827586206897
351970,2015,0,1,26,27,3.7037037037037033
351970,2016,1,0,31,32,3.125
351970,2017,2,1,24,27,11.11111111111111
351970,2018,16,1,14,31,54.83870967741935
351970,2019,4,0,15,19,21.052631578947366
351970,2020,20,0,7,27,74.07407407407408
351980,2012,3,0,1,4,75.0
351980,2013,2,0,0,2,100.0
351980,2015,1,0,0,1,100.0
351980,2016,2,0,0,2,100.0
351980,2018,1,1,2,4,50.0
351980,2019,1,3,1,5,80.0
351980,2020,0,1,1,2,50.0
351990,2014,4,0,0,4,100.0
351990,2015,1,0,0,1,100.0
351990,2016,3,0,0,3,100.0
351990,2017,3,0,0,3,100.0
351990,2018,2,0,0,2,100.0
351990,2019,1,0,0,1,100.0
352000,2012,2,2,4,8,50.0
352000,2013,4,1,7,12,41.66666666666667
352000,2014,3,1,5,9,44.44444444444444
352000,2015,0,2,5,7,28.57142857142857
352000,2016,0,1,3,4,25.0
352000,2017,0,7,4,11,63.63636363636363
352000,2018,3,0,2,5,60.0
352000,2019,1,1,2,4,50.0
352000,2020,4,2,2,8,75.0
352010,2012,6,0,3,9,66.66666666666666
352010,2013,1,0,6,7,14.285714285714285
352010,2014,7,0,0,7,100.0
352010,2015,15,0,0,15,100.0
352010,2016,11,0,0,11,100.0
352010,2017,6,0,0,6,100.0
352010,2018,6,0,0,6,100.0
352010,2019,7,0,0,7,100.0
352010,2020,6,0,0,6,100.0
352020,2012,4,0,0,4,100.0
352020,2013,1,0,0,1,100.0
352020,2014,2,0,0,2,100.0
352020,2015,2,0,0,2,100.0
352020,2016,6,0,0,6,100.0
352020,2017,1,0,0,1,100.0
352020,2018,4,0,0,4,100.0
352020,2019,4,0,0,4,100.0
352020,2020,7,0,0,7,100.0
352030,2012,8,0,0,8,100.0
352030,2013,11,0,1,12,91.66666666666666
352030,2014,7,1,0,8,100.0
352030,2015,7,0,0,7,100.0
352030,2016,9,1,1,11,90.9090909090909
352030,2017,14,0,0,14,100.0
352030,2018,4,0,0,4,100.0
352030,2019,10,0,0,10,100.0
352030,2020,10,0,0,10,100.0
352040,2012,13,0,0,13,100.0
352040,2013,7,0,0,7,100.0
352040,2014,5,0,0,5,100.0
352040,2015,12,0,0,12,100.0
352040,2016,16,0,0,16,100.0
352040,2017,10,0,0,10,100.0
352040,2018,3,0,0,3,100.0
352040,2019,5,0,0,5,100.0
352040,2020,8,0,0,8,100.0
352042,2013,3,0,0,3,100.0
352042,2014,3,0,0,3,100.0
352042,2015,5,0,0,5,100.0
352042,2016,3,0,0,3,100.0
352042,2017,4,0,0,4,100.0
352042,2018,4,0,0,4,100.0
352042,2019,1,0,0,1,100.0
352042,2020,4,0,0,4,100.0
352044,2012,6,0,0,6,100.0
352044,2013,12,0,0,12,100.0
352044,2014,15,0,0,15,100.0
352044,2015,7,0,0,7,100.0
352044,2016,6,0,0,6,100.0
352044,2017,9,0,0,9,100.0
352044,2018,5,0,0,5,100.0
352044,2019,7,1,0,8,100.0
352044,2020,8,0,0,8,100.0
352050,2012,46,0,1,47,97.87234042553192
352050,2013,42,0,2,44,95.45454545454545
352050,2014,59,0,0,59,100.0
352050,2015,69,0,0,69,100.0
352050,2016,46,0,0,46,100.0
352050,2017,45,0,0,45,100.0
352050,2018,41,0,0,41,100.0
352050,2019,50,0,0,50,100.0
352050,2020,14,32,29,75,61.33333333333333
352060,2012,3,0,0,3,100.0
352060,2013,3,0,0,3,100.0
352060,2015,2,0,0,2,100.0
352060,2016,1,0,0,1,100.0
352060,2017,1,0,0,1,100.0
352060,2018,4,0,0,4,100.0
352060,2019,2,0,0,2,100.0
352070,2012,2,0,0,2,100.0
352070,2013,1,0,0,1,100.0
352070,2015,5,0,0,5,100.0
352070,2016,4,0,0,4,100.0
352070,2017,1,0,0,1,100.0
352070,2018,3,0,0,3,100.0
352070,2019,1,0,0,1,100.0
352080,2013,1,0,0,1,100.0
352080,2015,1,0,0,1,100.0
352080,2016,3,0,0,3,100.0
352080,2017,2,0,0,2,100.0
352080,2019,2,0,0,2,100.0
352090,2012,0,1,1,2,50.0
352090,2013,3,0,1,4,75.0
352090,2014,2,1,3,6,50.0
352090,2015,1,2,3,6,50.0
352090,2016,6,0,0,6,100.0
352090,2017,7,0,0,7,100.0
352090,2018,2,0,0,2,100.0
352090,2019,3,0,0,3,100.0
352090,2020,3,0,0,3,100.0
352100,2012,12,0,0,12,100.0
352100,2013,9,0,0,9,100.0
352100,2014,1,0,0,1,100.0
352100,2015,3,0,4,7,42.857142857142854
352100,2016,11,0,0,11,100.0
352100,2017,10,0,0,10,100.0
352100,2018,3,0,0,3,100.0
352100,2019,12,0,0,12,100.0
352100,2020,12,0,0,12,100.0
352110,2012,0,0,2,2,0.0
352110,2014,0,0,2,2,0.0
352110,2015,0,0,1,1,0.0
352110,2016,0,2,4,6,33.33333333333333
352110,2017,0,0,1,1,0.0
352110,2018,0,0,2,2,0.0
352110,2019,0,2,0,2,100.0
352110,2020,2,1,0,3,100.0
352115,2013,2,0,0,2,100.0
352115,2014,3,0,0,3,100.0
352115,2015,3,0,0,3,100.0
352115,2016,1,0,0,1,100.0
352115,2017,1,0,0,1,100.0
352115,2018,3,0,0,3,100.0
352115,2019,2,0,0,2,100.0
352115,2020,3,0,0,3,100.0
352120,2014,0,0,1,1,0.0
352120,2015,0,0,1,1,0.0
352120,2016,0,1,2,3,33.33333333333333
352120,2017,0,1,0,1,100.0
352120,2018,0,1,0,1,100.0
352120,2019,0,0,1,1,0.0
352130,2012,0,0,4,4,0.0
352130,2013,9,0,0,9,100.0
352130,2014,5,0,0,5,100.0
352130,2015,4,0,0,4,100.0
352130,2016,8,0,1,9,88.88888888888889
352130,2017,6,0,0,6,100.0
352130,2018,6,0,0,6,100.0
352130,2019,8,0,1,9,88.88888888888889
352130,2020,2,0,0,2,100.0
352140,2012,4,0,0,4,100.0
352140,2013,3,0,0,3,100.0
352140,2014,5,0,0,5,100.0
352140,2015,7,0,0,7,100.0
352140,2016,7,0,0,7,100.0
352140,2017,3,0,0,3,100.0
352140,2018,5,0,0,5,100.0
352140,2019,11,0,0,11,100.0
352140,2020,7,0,0,7,100.0
352150,2012,1,0,0,1,100.0
352150,2013,2,0,0,2,100.0
352150,2014,4,0,0,4,100.0
352150,2015,5,0,0,5,100.0
352150,2016,2,0,0,2,100.0
352150,2017,2,0,0,2,100.0
352150,2018,2,0,0,2,100.0
352150,2019,2,0,0,2,100.0
352150,2020,2,0,0,2,100.0
352160,2013,2,0,1,3,66.66666666666666
352160,2014,1,0,0,1,100.0
352160,2015,2,0,0,2,100.0
352160,2016,3,0,0,3,100.0
352160,2017,2,0,0,2,100.0
352160,2019,1,0,0,1,100.0
352160,2020,4,0,0,4,100.0
352170,2012,7,0,0,7,100.0
352170,2013,6,0,0,6,100.0
352170,2014,6,0,0,6,100.0
352170,2015,8,0,1,9,88.88888888888889
352170,2016,5,0,0,5,100.0
352170,2017,1,0,0,1,100.0
352170,2018,5,0,0,5,100.0
352170,2019,7,0,0,7,100.0
352170,2020,8,0,0,8,100.0
352180,2012,6,0,1,7,85.71428571428571
352180,2013,8,0,0,8,100.0
352180,2014,9,0,0,9,100.0
352180,2015,4,0,0,4,100.0
352180,2016,10,0,0,10,100.0
352180,2017,5,0,0,5,100.0
352180,2018,6,0,0,6,100.0
352180,2019,9,0,0,9,100.0
352180,2020,4,0,20,24,16.666666666666664
352190,2012,7,0,0,7,100.0
352190,2013,5,0,0,5,100.0
352190,2014,5,0,0,5,100.0
352190,2015,6,0,0,6,100.0
352190,2016,6,0,0,6,100.0
352190,2017,4,0,0,4,100.0
352190,2018,5,0,0,5,100.0
352190,2019,4,0,0,4,100.0
352190,2020,7,0,0,7,100.0
352200,2012,0,0,1,1,0.0
352200,2013,1,0,0,1,100.0
352200,2015,0,2,0,2,100.0
352200,2017,0,0,1,1,0.0
352200,2018,1,1,0,2,100.0
352200,2020,1,0,0,1,100.0
352210,2012,46,0,1,47,97.87234042553192
352210,2013,42,0,1,43,97.67441860465115
352210,2014,36,0,0,36,100.0
352210,2015,44,0,0,44,100.0
352210,2016,38,0,0,38,100.0
352210,2017,36,0,0,36,100.0
352210,2018,41,0,0,41,100.0
352210,2019,52,0,0,52,100.0
352210,2020,50,0,0,50,100.0
352215,2012,1,0,0,1,100.0
352215,2013,1,0,0,1,100.0
352215,2014,10,0,0,10,100.0
352215,2015,2,0,0,2,100.0
352215,2016,2,0,0,2,100.0
352215,2020,1,0,0,1,100.0
352220,2012,35,1,21,57,63.1578947368421
352220,2013,52,4,6,62,90.32258064516128
352220,2014,57,2,9,68,86.76470588235294
352220,2015,66,0,0,66,100.0
352220,2016,58,0,0,58,100.0
352220,2017,61,0,0,61,100.0
352220,2018,59,0,2,61,96.72131147540983
352220,2019,54,0,4,58,93.10344827586206
352220,2020,67,0,2,69,97.10144927536231
352230,2012,41,0,0,41,100.0
352230,2013,51,0,3,54,94.44444444444444
352230,2014,52,0,2,54,96.29629629629629
352230,2015,51,0,1,52,98.07692307692307
352230,2016,43,0,2,45,95.55555555555556
352230,2017,48,0,1,49,97.95918367346938
352230,2018,46,0,0,46,100.0
352230,2019,46,0,0,46,100.0
352230,2020,39,0,0,39,100.0
352240,2012,32,0,1,33,96.96969696969697
352240,2013,24,0,1,25,96.0
352240,2014,30,0,1,31,96.7741935483871
352240,2015,26,0,3,29,89.65517241379311
352240,2016,35,0,1,36,97.22222222222221
352240,2017,20,0,0,20,100.0
352240,2018,31,0,0,31,100.0
352240,2019,32,0,0,32,100.0
352240,2020,42,0,0,42,100.0
352250,2012,79,0,0,79,100.0
352250,2013,58,1,10,69,85.5072463768116
352250,2014,45,4,21,70,70.0
352250,2015,82,0,7,89,92.13483146067416
352250,2016,64,0,4,68,94.11764705882352
352250,2017,79,1,3,83,96.3855421686747
352250,2018,77,0,2,79,97.46835443037975
352250,2019,83,2,8,93,91.39784946236558
352250,2020,1,12,79,92,14.130434782608695
352260,2012,27,0,0,27,100.0
352260,2013,17,2,3,22,86.36363636363636
352260,2014,23,0,0,23,100.0
352260,2015,25,0,0,25,100.0
352260,2016,20,0,0,20,100.0
352260,2017,18,0,1,19,94.73684210526315
352260,2018,23,0,1,24,95.83333333333334
352260,2019,10,0,6,16,62.5
352260,2020,12,0,3,15,80.0
352265,2013,2,0,0,2,100.0
352265,2016,2,0,0,2,100.0
352265,2017,1,0,0,1,100.0
352265,2019,3,0,0,3,100.0
352265,2020,1,0,0,1,100.0
352270,2012,11,0,2,13,84.61538461538461
352270,2013,16,0,0,16,100.0
352270,2014,16,0,0,16,100.0
352270,2015,12,0,0,12,100.0
352270,2016,7,0,0,7,100.0
352270,2017,19,0,0,19,100.0
352270,2018,11,0,0,11,100.0
352270,2019,19,0,0,19,100.0
352270,2020,13,1,0,14,100.0
352280,2012,1,0,1,2,50.0
352280,2013,2,0,0,2,100.0
352280,2014,4,0,0,4,100.0
352280,2015,3,0,0,3,100.0
352280,2016,4,0,0,4,100.0
352280,2017,8,0,0,8,100.0
352280,2018,4,0,0,4,100.0
352280,2019,4,0,0,4,100.0
352280,2020,4,0,0,4,100.0
352290,2012,0,4,5,9,44.44444444444444
352290,2013,0,3,0,3,100.0
352290,2014,0,1,2,3,33.33333333333333
352290,2015,0,2,1,3,66.66666666666666
352290,2016,6,0,0,6,100.0
352290,2017,5,0,0,5,100.0
352290,2018,1,0,0,1,100.0
352290,2019,6,0,0,6,100.0
352290,2020,7,0,0,7,100.0
352300,2012,4,0,0,4,100.0
352300,2013,0,1,0,1,100.0
352300,2014,1,1,0,2,100.0
352300,2015,2,0,0,2,100.0
352300,2017,3,0,0,3,100.0
352300,2018,1,0,0,1,100.0
352300,2020,2,0,0,2,100.0
352310,2012,112,0,3,115,97.3913043478261
352310,2013,134,0,1,135,99.25925925925925
352310,2014,114,0,1,115,99.1304347826087
352310,2015,128,0,0,128,100.0
352310,2016,139,0,0,139,100.0
352310,2017,133,0,0,133,100.0
352310,2018,116,0,0,116,100.0
352310,2019,124,0,0,124,100.0
352310,2020,154,0,0,154,100.0
352320,2012,21,0,0,21,100.0
352320,2013,15,0,0,15,100.0
352320,2014,16,0,0,16,100.0
352320,2015,16,0,0,16,100.0
352320,2016,9,0,0,9,100.0
352320,2017,16,0,0,16,100.0
352320,2018,19,0,0,19,100.0
352320,2019,12,0,0,12,100.0
352320,2020,13,0,1,14,92.85714285714286
352330,2012,0,0,3,3,0.0
352330,2013,3,0,0,3,100.0
352330,2014,4,0,0,4,100.0
352330,2015,2,0,0,2,100.0
352330,2016,3,0,2,5,60.0
352330,2017,1,0,0,1,100.0
352330,2018,7,0,0,7,100.0
352330,2019,7,0,1,8,87.5
352330,2020,1,0,2,3,33.33333333333333
352340,2012,26,0,0,26,100.0
352340,2013,20,0,0,20,100.0
352340,2014,29,0,0,29,100.0
352340,2015,33,0,0,33,100.0
352340,2016,31,0,0,31,100.0
352340,2017,23,0,0,23,100.0
352340,2018,30,0,0,30,100.0
352340,2019,23,0,2,25,92.0
352340,2020,32,0,0,32,100.0
352350,2012,4,0,0,4,100.0
352350,2013,3,0,0,3,100.0
352350,2014,2,0,0,2,100.0
352350,2015,10,0,0,10,100.0
352350,2016,1,0,0,1,100.0
352350,2017,6,0,0,6,100.0
352350,2018,5,0,0,5,100.0
352350,2019,7,0,0,7,100.0
352350,2020,9,0,0,9,100.0
352360,2012,2,0,0,2,100.0
352360,2013,6,0,0,6,100.0
352360,2014,4,0,2,6,66.66666666666666
352360,2015,0,0,8,8,0.0
352360,2016,6,0,0,6,100.0
352360,2017,8,0,0,8,100.0
352360,2018,1,0,0,1,100.0
352360,2019,4,0,0,4,100.0
352360,2020,6,0,0,6,100.0
352370,2012,1,1,1,3,66.66666666666666
352370,2013,0,0,2,2,0.0
352370,2014,0,0,3,3,0.0
352370,2015,0,0,3,3,0.0
352370,2017,3,0,0,3,100.0
352370,2018,0,0,1,1,0.0
352370,2019,0,0,2,2,0.0
352370,2020,0,0,2,2,0.0
352380,2012,3,0,0,3,100.0
352380,2013,3,0,0,3,100.0
352380,2014,2,0,1,3,66.66666666666666
352380,2015,2,0,0,2,100.0
352380,2016,4,0,0,4,100.0
352380,2017,2,0,0,2,100.0
352380,2018,2,0,0,2,100.0
352380,2019,1,0,0,1,100.0
352380,2020,3,0,0,3,100.0
352390,2012,62,0,0,62,100.0
352390,2013,45,1,1,47,97.87234042553192
352390,2014,7,18,41,66,37.878787878787875
352390,2015,4,11,36,51,29.411764705882355
352390,2016,63,0,1,64,98.4375
352390,2017,42,0,0,42,100.0
352390,2018,48,0,0,48,100.0
352390,2019,9,1,30,40,25.0
352390,2020,31,2,21,54,61.111111111111114
352400,2012,16,0,0,16,100.0
352400,2013,20,0,0,20,100.0
352400,2014,10,0,1,11,90.9090909090909
352400,2015,8,0,0,8,100.0
352400,2016,5,0,0,5,100.0
352400,2017,17,0,0,17,100.0
352400,2018,15,0,0,15,100.0
352400,2019,15,0,0,15,100.0
352400,2020,16,0,0,16,100.0
352410,2012,3,0,8,11,27.27272727272727
352410,2013,10,0,2,12,83.33333333333334
352410,2014,13,0,0,13,100.0
352410,2015,15,0,1,16,93.75
352410,2016,13,0,1,14,92.85714285714286
352410,2017,15,0,0,15,100.0
352410,2018,13,0,0,13,100.0
352410,2019,11,0,1,12,91.66666666666666
352410,2020,23,0,0,23,100.0
352420,2014,1,0,0,1,100.0
352420,2015,1,0,0,1,100.0
352420,2016,1,0,0,1,100.0
352420,2018,1,0,0,1,100.0
352420,2019,2,0,0,2,100.0
352430,2012,25,0,0,25,100.0
352430,2013,19,0,0,19,100.0
352430,2014,26,0,0,26,100.0
352430,2015,20,0,0,20,100.0
352430,2016,19,0,0,19,100.0
352430,2017,19,0,0,19,100.0
352430,2018,16,0,0,16,100.0
352430,2019,25,0,0,25,100.0
352430,2020,25,0,0,25,100.0
352440,2012,71,0,0,71,100.0
352440,2013,66,0,0,66,100.0
352440,2014,53,0,0,53,100.0
352440,2015,72,1,0,73,100.0
352440,2016,60,0,11,71,84.50704225352112
352440,2017,53,3,10,66,84.84848484848484
352440,2018,57,1,4,62,93.54838709677419
352440,2019,40,0,6,46,86.95652173913044
352440,2020,81,1,2,84,97.61904761904762
352450,2012,3,0,0,3,100.0
352450,2013,2,0,0,2,100.0
352450,2014,2,0,0,2,100.0
352450,2015,2,0,0,2,100.0
352450,2016,6,0,0,6,100.0
352450,2017,3,0,0,3,100.0
352450,2018,2,0,0,2,100.0
352450,2019,5,0,1,6,83.33333333333334
352460,2012,2,0,1,3,66.66666666666666
352460,2013,8,0,2,10,80.0
352460,2014,3,0,1,4,75.0
352460,2015,9,0,0,9,100.0
352460,2016,6,0,1,7,85.71428571428571
352460,2017,3,0,0,3,100.0
352460,2018,8,0,1,9,88.88888888888889
352460,2019,7,0,0,7,100.0
352460,2020,3,0,0,3,100.0
352470,2012,1,4,8,13,38.46153846153847
352470,2013,1,0,10,11,9.090909090909092
352470,2014,0,3,16,19,15.789473684210526
352470,2015,11,1,1,13,92.3076923076923
352470,2016,17,0,0,17,100.0
352470,2017,2,0,9,11,18.181818181818183
352470,2018,13,0,1,14,92.85714285714286
352470,2019,4,0,4,8,50.0
352470,2020,0,2,7,9,22.22222222222222
352480,2012,13,0,0,13,100.0
352480,2013,8,0,0,8,100.0
352480,2014,14,0,0,14,100.0
352480,2015,17,0,0,17,100.0
352480,2016,21,0,0,21,100.0
352480,2017,15,0,0,15,100.0
352480,2018,16,0,0,16,100.0
352480,2019,20,0,0,20,100.0
352480,2020,21,0,0,21,100.0
352490,2012,2,0,0,2,100.0
352490,2014,0,0,2,2,0.0
352490,2015,0,0,1,1,0.0
352490,2016,0,0,2,2,0.0
352490,2017,1,0,0,1,100.0
352490,2018,2,0,0,2,100.0
352490,2020,2,0,0,2,100.0
352500,2012,35,0,4,39,89.74358974358975
352500,2013,28,1,10,39,74.35897435897436
352500,2014,32,1,1,34,97.05882352941177
352500,2015,34,0,1,35,97.14285714285714
352500,2016,45,0,0,45,100.0
352500,2017,32,0,0,32,100.0
352500,2018,25,0,0,25,100.0
352500,2019,23,0,4,27,85.18518518518519
352500,2020,26,1,9,36,75.0
352510,2012,17,0,0,17,100.0
352510,2013,6,0,0,6,100.0
352510,2014,10,0,0,10,100.0
352510,2015,18,0,0,18,100.0
352510,2016,11,0,0,11,100.0
352510,2017,10,0,0,10,100.0
352510,2018,9,0,0,9,100.0
352510,2019,9,0,1,10,90.0
352510,2020,11,0,0,11,100.0
352520,2012,10,0,0,10,100.0
352520,2013,7,0,0,7,100.0
352520,2014,7,0,0,7,100.0
352520,2015,9,0,0,9,100.0
352520,2016,4,0,0,4,100.0
352520,2017,8,0,0,8,100.0
352520,2018,5,0,0,5,100.0
352520,2019,4,0,0,4,100.0
352520,2020,7,0,0,7,100.0
352530,2012,33,1,0,34,100.0
352530,2013,38,0,0,38,100.0
352530,2014,32,2,0,34,100.0
352530,2015,41,0,2,43,95.34883720930233
352530,2016,46,0,2,48,95.83333333333334
352530,2017,34,0,3,37,91.8918918918919
352530,2018,43,0,0,43,100.0
352530,2019,31,1,0,32,100.0
352530,2020,41,0,0,41,100.0
352540,2012,0,0,2,2,0.0
352540,2013,0,0,2,2,0.0
352540,2014,0,0,2,2,0.0
352540,2015,0,0,2,2,0.0
352540,2016,1,0,0,1,100.0
352540,2017,2,0,0,2,100.0
352540,2018,1,0,0,1,100.0
352540,2020,1,0,1,2,50.0
352550,2012,6,0,0,6,100.0
352550,2013,7,0,0,7,100.0
352550,2014,2,0,0,2,100.0
352550,2015,2,0,0,2,100.0
352550,2016,3,0,0,3,100.0
352550,2017,4,0,0,4,100.0
352550,2019,2,0,0,2,100.0
352550,2020,3,0,1,4,75.0
352560,2012,1,0,0,1,100.0
352560,2014,1,0,0,1,100.0
352560,2015,0,0,2,2,0.0
352560,2016,2,0,0,2,100.0
352560,2017,4,0,0,4,100.0
352560,2018,1,0,0,1,100.0
352560,2019,2,0,0,2,100.0
352560,2020,3,0,0,3,100.0
352570,2012,13,0,0,13,100.0
352570,2013,8,0,0,8,100.0
352570,2014,10,0,0,10,100.0
352570,2015,12,0,0,12,100.0
352570,2016,11,0,0,11,100.0
352570,2017,9,0,0,9,100.0
352570,2018,8,0,0,8,100.0
352570,2019,9,0,0,9,100.0
352570,2020,10,0,0,10,100.0
352580,2012,4,0,0,4,100.0
352580,2013,2,0,0,2,100.0
352580,2014,2,0,0,2,100.0
352580,2015,3,0,0,3,100.0
352580,2016,1,0,0,1,100.0
352580,2017,2,0,0,2,100.0
352580,2018,1,0,0,1,100.0
352580,2019,2,0,0,2,100.0
352580,2020,3,0,0,3,100.0
352585,2012,1,1,0,2,100.0
352585,2013,2,0,0,2,100.0
352585,2014,1,0,0,1,100.0
352585,2015,2,0,0,2,100.0
352585,2016,1,0,0,1,100.0
352590,2012,95,0,0,95,100.0
352590,2013,103,0,0,103,100.0
352590,2014,90,0,0,90,100.0
352590,2015,79,0,0,79,100.0
352590,2016,107,0,0,107,100.0
352590,2017,90,0,0,90,100.0
352590,2018,106,0,0,106,100.0
352590,2019,89,0,0,89,100.0
352590,2020,92,0,0,92,100.0
352600,2012,6,0,0,6,100.0
352600,2013,5,0,0,5,100.0
352600,2014,8,0,0,8,100.0
352600,2015,10,0,0,10,100.0
352600,2016,6,0,0,6,100.0
352600,2017,7,0,0,7,100.0
352600,2018,6,0,0,6,100.0
352600,2019,10,0,0,10,100.0
352600,2020,6,0,0,6,100.0
352610,2012,5,1,2,8,75.0
352610,2013,5,0,6,11,45.45454545454545
352610,2014,5,0,2,7,71.42857142857143
352610,2015,6,0,2,8,75.0
352610,2016,5,0,1,6,83.33333333333334
352610,2017,3,0,0,3,100.0
352610,2018,7,0,0,7,100.0
352610,2019,5,0,0,5,100.0
352610,2020,12,0,0,12,100.0
352620,2012,9,1,5,15,66.66666666666666
352620,2013,3,0,6,9,33.33333333333333
352620,2014,6,1,5,12,58.333333333333336
352620,2015,1,0,5,6,16.666666666666664
352620,2016,5,0,10,15,33.33333333333333
352620,2017,7,0,6,13,53.84615384615385
352620,2018,7,0,0,7,100.0
352620,2019,9,0,0,9,100.0
352620,2020,2,2,1,5,80.0
352630,2012,1,0,0,1,100.0
352630,2013,3,0,0,3,100.0
352630,2014,1,0,0,1,100.0
352630,2016,4,0,0,4,100.0
352630,2017,0,1,0,1,100.0
352630,2019,0,2,0,2,100.0
352630,2020,2,0,0,2,100.0
352640,2012,9,0,0,9,100.0
352640,2013,8,0,0,8,100.0
352640,2014,11,0,0,11,100.0
352640,2015,12,0,0,12,100.0
352640,2016,13,0,0,13,100.0
352640,2017,3,0,0,3,100.0
352640,2018,11,1,0,12,100.0
352640,2019,9,0,0,9,100.0
352640,2020,9,0,0,9,100.0
352650,2012,1,0,0,1,100.0
352650,2013,1,0,0,1,100.0
352650,2014,2,0,1,3,66.66666666666666
352650,2016,1,0,0,1,100.0
352650,2017,3,0,0,3,100.0
352650,2018,1,0,1,2,50.0
352660,2012,0,0,1,1,0.0
352660,2013,0,1,2,3,33.33333333333333
352660,2014,1,0,0,1,100.0
352660,2015,0,0,1,1,0.0
352660,2016,0,0,1,1,0.0
352660,2017,2,0,0,2,100.0
352660,2018,3,0,0,3,100.0
352660,2019,0,0,1,1,0.0
352660,2020,0,1,1,2,50.0
352670,2012,33,1,0,34,100.0
352670,2013,25,0,0,25,100.0
352670,2014,41,0,0,41,100.0
352670,2015,32,0,1,33,96.96969696969697
352670,2016,34,0,0,34,100.0
352670,2017,29,0,0,29,100.0
352670,2018,26,0,0,26,100.0
352670,2019,25,0,0,25,100.0
352670,2020,28,0,0,28,100.0
352680,2012,0,13,6,19,68.42105263157895
352680,2013,13,0,4,17,76.47058823529412
352680,2014,13,0,3,16,81.25
352680,2015,11,0,0,11,100.0
352680,2016,18,0,0,18,100.0
352680,2017,14,0,0,14,100.0
352680,2018,20,0,0,20,100.0
352680,2019,21,0,0,21,100.0
352680,2020,18,0,2,20,90.0
352690,2012,109,0,0,109,100.0
352690,2013,84,1,0,85,100.0
352690,2014,78,0,0,78,100.0
352690,2015,90,1,1,92,98.91304347826086
352690,2016,83,0,0,83,100.0
352690,2017,100,0,0,100,100.0
352690,2018,65,0,0,65,100.0
352690,2019,92,0,0,92,100.0
352690,2020,115,1,0,116,100.0
352700,2012,2,0,1,3,66.66666666666666
352700,2013,0,0,1,1,0.0
352700,2014,0,0,3,3,0.0
352700,2015,1,0,3,4,25.0
352700,2016,2,0,1,3,66.66666666666666
352700,2017,5,0,0,5,100.0
352700,2018,1,0,0,1,100.0
352700,2019,0,0,1,1,0.0
352700,2020,0,0,4,4,0.0
352710,2012,29,0,0,29,100.0
352710,2013,33,0,0,33,100.0
352710,2014,26,0,0,26,100.0
352710,2015,23,0,0,23,100.0
352710,2016,23,0,1,24,95.83333333333334
352710,2017,27,0,0,27,100.0
352710,2018,30,0,0,30,100.0
352710,2019,38,0,0,38,100.0
352710,2020,30,0,0,30,100.0
352720,2012,23,0,1,24,95.83333333333334
352720,2013,31,0,1,32,96.875
352720,2014,34,0,1,35,97.14285714285714
352720,2015,40,0,0,40,100.0
352720,2016,21,0,0,21,100.0
352720,2017,30,0,0,30,100.0
352720,2018,27,0,0,27,100.0
352720,2019,21,0,0,21,100.0
352720,2020,37,0,4,41,90.2439024390244
352725,2013,1,0,0,1,100.0
352725,2014,0,0,1,1,0.0
352725,2019,0,0,1,1,0.0
352725,2020,0,0,2,2,0.0
352730,2012,8,0,0,8,100.0
352730,2013,10,0,0,10,100.0
352730,2014,13,0,0,13,100.0
352730,2015,14,0,0,14,100.0
352730,2016,14,0,0,14,100.0
352730,2017,8,0,0,8,100.0
352730,2018,8,0,0,8,100.0
352730,2019,10,0,0,10,100.0
352730,2020,10,0,0,10,100.0
352740,2012,6,0,0,6,100.0
352740,2013,5,0,0,5,100.0
352740,2014,5,0,0,5,100.0
352740,2015,5,0,0,5,100.0
352740,2016,7,0,0,7,100.0
352740,2017,4,0,0,4,100.0
352740,2018,3,0,0,3,100.0
352740,2019,11,0,0,11,100.0
352740,2020,17,0,0,17,100.0
352750,2012,1,0,1,2,50.0
352750,2013,0,1,0,1,100.0
352750,2016,0,0,1,1,0.0
352750,2018,1,0,0,1,100.0
352750,2020,0,0,1,1,0.0
352760,2012,4,0,2,6,66.66666666666666
352760,2013,3,0,3,6,50.0
352760,2014,2,0,0,2,100.0
352760,2015,3,0,0,3,100.0
352760,2016,5,0,0,5,100.0
352760,2017,3,0,1,4,75.0
352760,2018,3,0,0,3,100.0
352760,2019,3,0,0,3,100.0
352760,2020,4,0,0,4,100.0
352770,2012,3,0,1,4,75.0
352770,2013,2,0,0,2,100.0
352770,2014,2,0,0,2,100.0
352770,2015,1,0,0,1,100.0
352770,2016,2,0,0,2,100.0
352770,2018,0,0,1,1,0.0
352770,2019,0,0,2,2,0.0
352770,2020,1,0,0,1,100.0
352780,2012,1,0,0,1,100.0
352780,2013,2,0,0,2,100.0
352780,2014,1,0,0,1,100.0
352780,2015,2,0,0,2,100.0
352780,2017,3,0,0,3,100.0
352780,2019,2,0,0,2,100.0
352780,2020,1,0,0,1,100.0
352790,2012,2,0,0,2,100.0
352790,2014,4,0,0,4,100.0
352790,2015,1,0,0,1,100.0
352790,2016,1,0,0,1,100.0
352790,2017,2,0,0,2,100.0
352790,2020,3,0,0,3,100.0
352800,2012,6,0,1,7,85.71428571428571
352800,2013,2,0,1,3,66.66666666666666
352800,2014,4,0,0,4,100.0
352800,2015,6,0,0,6,100.0
352800,2016,2,0,0,2,100.0
352800,2017,7,0,0,7,100.0
352800,2018,3,0,0,3,100.0
352800,2019,3,0,0,3,100.0
352800,2020,6,0,0,6,100.0
352810,2012,1,0,0,1,100.0
352810,2013,3,0,0,3,100.0
352810,2014,1,0,0,1,100.0
352810,2015,2,0,0,2,100.0
352810,2016,5,0,0,5,100.0
352810,2017,1,0,0,1,100.0
352810,2019,3,0,0,3,100.0
352810,2020,1,0,0,1,100.0
352820,2013,2,0,0,2,100.0
352820,2017,3,0,0,3,100.0
352820,2018,1,0,0,1,100.0
352820,2019,2,0,0,2,100.0
352830,2013,1,0,0,1,100.0
352830,2014,3,0,0,3,100.0
352830,2015,2,0,0,2,100.0
352830,2016,1,0,0,1,100.0
352830,2018,2,0,0,2,100.0
352830,2019,2,0,0,2,100.0
352830,2020,1,0,0,1,100.0
352840,2012,8,0,5,13,61.53846153846154
352840,2013,16,0,3,19,84.21052631578947
352840,2014,11,0,1,12,91.66666666666666
352840,2015,18,0,0,18,100.0
352840,2016,15,0,0,15,100.0
352840,2017,23,0,0,23,100.0
352840,2018,13,0,0,13,100.0
352840,2019,12,0,0,12,100.0
352840,2020,18,0,0,18,100.0
352850,2012,24,0,0,24,100.0
352850,2013,24,0,0,24,100.0
352850,2014,33,0,0,33,100.0
352850,2015,24,0,0,24,100.0
352850,2016,29,1,2,32,93.75
352850,2017,32,0,0,32,100.0
352850,2018,30,0,0,30,100.0
352850,2019,27,0,0,27,100.0
352850,2020,33,0,0,33,100.0
352860,2012,7,0,0,7,100.0
352860,2013,2,0,0,2,100.0
352860,2014,3,0,0,3,100.0
352860,2015,3,0,0,3,100.0
352860,2016,5,0,0,5,100.0
352860,2017,2,0,0,2,100.0
352860,2018,2,0,0,2,100.0
352860,2019,4,0,0,4,100.0
352860,2020,5,0,0,5,100.0
352870,2013,1,0,2,3,33.33333333333333
352870,2015,0,0,1,1,0.0
352870,2016,0,0,1,1,0.0
352870,2017,1,0,0,1,100.0
352870,2018,1,0,0,1,100.0
352870,2019,2,0,0,2,100.0
352870,2020,3,0,0,3,100.0
352880,2012,0,1,2,3,33.33333333333333
352880,2013,0,0,7,7,0.0
352880,2014,0,0,4,4,0.0
352880,2015,3,1,2,6,66.66666666666666
352880,2017,9,0,0,9,100.0
352880,2018,2,0,0,2,100.0
352880,2019,5,0,0,5,100.0
352880,2020,2,0,0,2,100.0
352885,2013,2,0,0,2,100.0
352885,2015,1,0,0,1,100.0
352885,2016,1,0,0,1,100.0
352885,2017,1,0,0,1,100.0
352885,2018,1,0,0,1,100.0
352885,2019,2,0,0,2,100.0
352890,2012,2,0,0,2,100.0
352890,2014,2,0,0,2,100.0
352890,2015,1,0,0,1,100.0
352890,2016,1,0,0,1,100.0
352890,2017,1,0,0,1,100.0
352890,2018,2,0,0,2,100.0
352890,2019,2,0,0,2,100.0
352900,2012,79,0,0,79,100.0
352900,2013,71,0,0,71,100.0
352900,2014,57,0,1,58,98.27586206896551
352900,2015,67,0,1,68,98.52941176470588
352900,2016,55,0,0,55,100.0
352900,2017,62,0,0,62,100.0
352900,2018,69,0,0,69,100.0
352900,2019,66,0,0,66,100.0
352900,2020,70,0,0,70,100.0
352910,2012,1,0,0,1,100.0
352910,2014,2,0,0,2,100.0
352910,2016,2,0,0,2,100.0
352910,2018,1,0,0,1,100.0
352910,2019,1,0,0,1,100.0
352910,2020,1,0,0,1,100.0
352920,2012,6,0,0,6,100.0
352920,2013,3,0,0,3,100.0
352920,2014,9,0,0,9,100.0
352920,2015,7,0,0,7,100.0
352920,2016,8,0,0,8,100.0
352920,2017,10,0,0,10,100.0
352920,2018,5,0,0,5,100.0
352920,2019,6,0,0,6,100.0
352920,2020,12,0,0,12,100.0
352930,2012,21,0,0,21,100.0
352930,2013,18,0,0,18,100.0
352930,2014,21,0,0,21,100.0
352930,2015,24,0,0,24,100.0
352930,2016,26,0,0,26,100.0
352930,2017,16,0,2,18,88.88888888888889
352930,2018,19,0,1,20,95.0
352930,2019,31,0,2,33,93.93939393939394
352930,2020,10,2,5,17,70.58823529411765
352940,2012,121,0,3,124,97.58064516129032
352940,2013,136,0,0,136,100.0
352940,2014,128,0,3,131,97.70992366412213
352940,2015,120,0,0,120,100.0
352940,2016,126,0,0,126,100.0
352940,2017,128,0,4,132,96.96969696969697
352940,2018,99,1,2,102,98.0392156862745
352940,2019,119,1,19,139,86.33093525179856
352940,2020,119,14,20,153,86.9281045751634
352950,2012,1,0,0,1,100.0
352950,2013,1,0,0,1,100.0
352950,2014,1,0,0,1,100.0
352950,2015,1,0,0,1,100.0
352950,2016,1,0,0,1,100.0
352950,2017,1,0,0,1,100.0
352950,2018,1,0,0,1,100.0
352950,2019,1,0,0,1,100.0
352950,2020,3,0,0,3,100.0
352960,2012,1,0,0,1,100.0
352960,2013,2,0,0,2,100.0
352960,2014,1,0,0,1,100.0
352960,2016,1,0,0,1,100.0
352960,2017,2,0,0,2,100.0
352960,2019,3,0,0,3,100.0
352960,2020,1,0,0,1,100.0
352965,2012,1,0,0,1,100.0
352965,2014,3,0,0,3,100.0
352965,2016,1,0,0,1,100.0
352965,2017,1,0,0,1,100.0
352965,2019,1,0,0,1,100.0
352965,2020,1,0,0,1,100.0
352970,2012,1,0,5,6,16.666666666666664
352970,2013,0,0,4,4,0.0
352970,2014,1,0,4,5,20.0
352970,2015,0,0,5,5,0.0
352970,2016,0,2,4,6,33.33333333333333
352970,2017,0,0,2,2,0.0
352970,2018,1,0,4,5,20.0
352970,2019,1,0,7,8,12.5
352970,2020,1,0,6,7,14.285714285714285
352980,2012,3,0,0,3,100.0
352980,2013,4,0,0,4,100.0
352980,2014,3,0,0,3,100.0
352980,2015,4,0,0,4,100.0
352980,2016,6,0,0,6,100.0
352980,2017,1,0,0,1,100.0
352980,2018,7,1,0,8,100.0
352980,2019,2,0,1,3,66.66666666666666
352980,2020,0,4,0,4,100.0
352990,2012,6,0,0,6,100.0
352990,2013,6,0,0,6,100.0
352990,2014,6,0,0,6,100.0
352990,2015,9,0,0,9,100.0
352990,2016,11,0,0,11,100.0
352990,2017,5,0,0,5,100.0
352990,2018,7,0,0,7,100.0
352990,2019,6,0,0,6,100.0
352990,2020,6,0,0,6,100.0
353000,2012,3,0,0,3,100.0
353000,2014,1,0,0,1,100.0
353000,2016,1,0,0,1,100.0
353000,2017,1,0,0,1,100.0
353000,2020,1,0,0,1,100.0
353010,2012,10,0,1,11,90.9090909090909
353010,2013,7,0,2,9,77.77777777777779
353010,2014,16,0,0,16,100.0
353010,2015,3,0,0,3,100.0
353010,2016,11,0,0,11,100.0
353010,2017,7,0,0,7,100.0
353010,2018,5,0,4,9,55.55555555555556
353010,2019,5,1,2,8,75.0
353010,2020,7,0,1,8,87.5
353020,2012,3,0,3,6,50.0
353020,2013,4,0,0,4,100.0
353020,2014,10,0,0,10,100.0
353020,2015,3,0,0,3,100.0
353020,2016,6,0,0,6,100.0
353020,2017,4,0,0,4,100.0
353020,2018,6,0,0,6,100.0
353020,2019,7,0,0,7,100.0
353020,2020,1,0,0,1,100.0
353030,2012,13,0,0,13,100.0
353030,2013,19,0,0,19,100.0
353030,2014,12,0,4,16,75.0
353030,2015,12,0,0,12,100.0
353030,2016,17,0,0,17,100.0
353030,2017,15,0,0,15,100.0
353030,2018,13,2,0,15,100.0
353030,2019,7,4,1,12,91.66666666666666
353030,2020,0,8,12,20,40.0
353040,2012,0,1,0,1,100.0
353040,2013,2,0,0,2,100.0
353040,2014,1,0,0,1,100.0
353040,2015,0,0,1,1,0.0
353040,2016,0,0,1,1,0.0
353040,2018,0,2,0,2,100.0
353040,2019,0,0,1,1,0.0
353050,2012,22,0,0,22,100.0
353050,2013,24,0,0,24,100.0
353050,2014,23,0,3,26,88.46153846153845
353050,2015,10,1,2,13,84.61538461538461
353050,2016,20,0,1,21,95.23809523809523
353050,2017,19,0,0,19,100.0
353050,2018,18,0,0,18,100.0
353050,2019,19,0,0,19,100.0
353050,2020,19,0,0,19,100.0
353060,2012,139,1,0,140,100.0
353060,2013,116,0,1,117,99.14529914529915
353060,2014,122,0,1,123,99.1869918699187
353060,2015,147,0,0,147,100.0
353060,2016,122,6,4,132,96.96969696969697
353060,2017,119,0,0,119,100.0
353060,2018,140,0,0,140,100.0
353060,2019,145,0,0,145,100.0
353060,2020,161,0,0,161,100.0
353070,2012,40,0,2,42,95.23809523809523
353070,2013,35,0,0,35,100.0
353070,2014,52,0,2,54,96.29629629629629
353070,2015,34,0,1,35,97.14285714285714
353070,2016,36,0,2,38,94.73684210526315
353070,2017,50,0,0,50,100.0
353070,2018,38,0,0,38,100.0
353070,2019,47,0,0,47,100.0
353070,2020,48,0,0,48,100.0
353080,2012,24,0,0,24,100.0
353080,2013,23,1,1,25,96.0
353080,2014,32,0,0,32,100.0
353080,2015,24,0,0,24,100.0
353080,2016,24,0,0,24,100.0
353080,2017,17,0,1,18,94.44444444444444
353080,2018,27,0,1,28,96.42857142857143
353080,2019,28,0,0,28,100.0
353080,2020,24,0,4,28,85.71428571428571
353090,2012,1,0,0,1,100.0
353090,2016,3,0,0,3,100.0
353090,2017,2,0,0,2,100.0
353090,2018,2,0,0,2,100.0
353090,2019,0,0,1,1,0.0
353090,2020,1,0,0,1,100.0
353100,2014,2,0,0,2,100.0
353100,2015,1,0,0,1,100.0
353100,2018,1,0,0,1,100.0
353110,2012,25,0,0,25,100.0
353110,2013,18,0,2,20,90.0
353110,2014,24,0,0,24,100.0
353110,2015,25,0,0,25,100.0
353110,2016,28,0,0,28,100.0
353110,2017,21,0,0,21,100.0
353110,2018,18,0,0,18,100.0
353110,2019,22,0,0,22,100.0
353110,2020,27,0,0,27,100.0
353120,2012,2,0,0,2,100.0
353120,2013,0,0,1,1,0.0
353120,2014,0,0,3,3,0.0
353120,2015,1,0,0,1,100.0
353120,2017,1,0,0,1,100.0
353120,2018,1,0,0,1,100.0
353120,2019,1,0,0,1,100.0
353120,2020,1,0,0,1,100.0
353130,2012,12,0,0,12,100.0
353130,2013,10,0,0,10,100.0
353130,2014,18,0,0,18,100.0
353130,2015,15,0,0,15,100.0
353130,2016,10,0,0,10,100.0
353130,2017,16,0,0,16,100.0
353130,2018,8,0,0,8,100.0
353130,2019,10,0,0,10,100.0
353130,2020,16,0,0,16,100.0
353140,2012,4,0,0,4,100.0
353140,2013,4,0,3,7,57.14285714285714
353140,2014,1,0,1,2,50.0
353140,2015,4,0,2,6,66.66666666666666
353140,2016,5,0,2,7,71.42857142857143
353140,2017,10,0,1,11,90.9090909090909
353140,2018,3,1,0,4,100.0
353140,2019,0,4,0,4,100.0
353140,2020,6,1,0,7,100.0
353150,2012,4,0,1,5,80.0
353150,2013,6,0,1,7,85.71428571428571
353150,2014,9,0,1,10,90.0
353150,2015,8,0,0,8,100.0
353150,2016,1,0,2,3,33.33333333333333
353150,2017,5,0,0,5,100.0
353150,2018,0,0,4,4,0.0
353150,2019,4,0,6,10,40.0
353150,2020,3,1,2,6,66.66666666666666
353160,2012,1,0,2,3,33.33333333333333
353160,2013,3,0,0,3,100.0
353160,2014,1,0,0,1,100.0
353160,2017,1,0,0,1,100.0
353160,2019,3,0,0,3,100.0
353160,2020,1,0,0,1,100.0
353170,2014,1,0,0,1,100.0
353170,2015,3,0,1,4,75.0
353170,2017,1,0,0,1,100.0
353170,2019,1,0,0,1,100.0
353170,2020,1,0,0,1,100.0
353180,2012,14,0,1,15,93.33333333333333
353180,2013,13,0,0,13,100.0
353180,2014,15,0,0,15,100.0
353180,2015,26,0,0,26,100.0
353180,2016,25,0,0,25,100.0
353180,2017,15,0,0,15,100.0
353180,2018,15,0,1,16,93.75
353180,2019,16,0,2,18,88.88888888888889
353180,2020,9,2,10,21,52.38095238095239
353190,2012,9,0,0,9,100.0
353190,2013,14,0,0,14,100.0
353190,2014,7,0,4,11,63.63636363636363
353190,2015,2,0,7,9,22.22222222222222
353190,2016,2,1,7,10,30.0
353190,2017,10,1,3,14,78.57142857142857
353190,2018,4,1,2,7,71.42857142857143
353190,2019,4,0,10,14,28.57142857142857
353190,2020,5,0,7,12,41.66666666666667
353200,2012,3,0,0,3,100.0
353200,2013,2,0,0,2,100.0
353200,2014,6,0,0,6,100.0
353200,2015,5,0,0,5,100.0
353200,2016,8,0,0,8,100.0
353200,2017,2,0,0,2,100.0
353200,2018,2,0,0,2,100.0
353200,2019,1,0,1,2,50.0
353200,2020,0,0,5,5,0.0
353205,2012,1,0,1,2,50.0
353205,2013,0,0,2,2,0.0
353205,2014,0,0,1,1,0.0
353205,2016,1,0,0,1,100.0
353205,2018,1,0,0,1,100.0
353205,2019,1,0,1,2,50.0
353205,2020,0,0,1,1,0.0
353210,2012,1,0,0,1,100.0
353210,2014,1,0,0,1,100.0
353210,2015,2,0,0,2,100.0
353210,2016,2,0,0,2,100.0
353210,2018,2,0,0,2,100.0
353210,2019,1,0,0,1,100.0
353215,2012,1,0,0,1,100.0
353215,2013,2,0,0,2,100.0
353215,2016,3,0,0,3,100.0
353215,2017,3,0,0,3,100.0
353215,2018,2,0,0,2,100.0
353215,2019,1,2,0,3,100.0
353215,2020,0,0,2,2,0.0
353220,2012,1,0,0,1,100.0
353220,2013,1,0,0,1,100.0
353220,2014,1,0,0,1,100.0
353220,2015,2,0,0,2,100.0
353220,2016,1,0,0,1,100.0
353220,2017,2,0,0,2,100.0
353220,2019,1,0,0,1,100.0
353230,2012,0,0,3,3,0.0
353230,2013,0,0,3,3,0.0
353230,2014,1,0,0,1,100.0
353230,2015,4,0,0,4,100.0
353230,2016,4,0,0,4,100.0
353230,2017,3,0,0,3,100.0
353230,2018,1,0,2,3,33.33333333333333
353230,2019,1,1,1,3,66.66666666666666
353230,2020,2,0,1,3,66.66666666666666
353240,2012,5,1,0,6,100.0
353240,2013,4,0,0,4,100.0
353240,2014,4,0,0,4,100.0
353240,2015,2,0,0,2,100.0
353240,2016,5,0,0,5,100.0
353240,2017,6,0,0,6,100.0
353240,2018,7,0,0,7,100.0
353240,2019,4,0,0,4,100.0
353240,2020,7,0,1,8,87.5
353250,2012,3,0,0,3,100.0
353250,2013,4,0,0,4,100.0
353250,2014,4,0,0,4,100.0
353250,2015,4,0,0,4,100.0
353250,2016,2,0,0,2,100.0
353250,2017,4,0,0,4,100.0
353250,2018,2,0,0,2,100.0
353250,2019,1,0,0,1,100.0
353250,2020,1,0,0,1,100.0
353260,2012,3,0,0,3,100.0
353260,2013,4,0,0,4,100.0
353260,2014,3,0,0,3,100.0
353260,2015,3,0,0,3,100.0
353260,2016,5,0,0,5,100.0
353260,2017,3,0,0,3,100.0
353260,2018,4,0,0,4,100.0
353260,2019,1,0,0,1,100.0
353260,2020,5,0,0,5,100.0
353270,2012,1,0,0,1,100.0
353270,2013,1,0,0,1,100.0
353270,2014,1,0,0,1,100.0
353270,2015,0,0,3,3,0.0
353270,2016,0,0,1,1,0.0
353270,2018,0,2,1,3,66.66666666666666
353270,2019,0,1,3,4,25.0
353270,2020,2,1,0,3,100.0
353280,2012,1,0,0,1,100.0
353280,2014,2,0,0,2,100.0
353280,2015,1,0,0,1,100.0
353280,2016,2,0,0,2,100.0
353280,2017,3,0,0,3,100.0
353280,2018,2,0,0,2,100.0
353280,2019,4,0,0,4,100.0
353280,2020,2,0,0,2,100.0
353282,2012,0,0,3,3,0.0
353282,2013,0,0,1,1,0.0
353282,2014,1,0,0,1,100.0
353282,2015,0,0,3,3,0.0
353282,2016,1,1,1,3,66.66666666666666
353282,2017,2,0,0,2,100.0
353282,2018,3,0,0,3,100.0
353282,2019,1,0,0,1,100.0
353282,2020,0,0,3,3,0.0
353284,2013,2,0,0,2,100.0
353284,2014,1,0,0,1,100.0
353284,2015,1,0,0,1,100.0
353286,2014,1,0,0,1,100.0
353286,2020,2,0,0,2,100.0
353290,2012,5,0,0,5,100.0
353290,2013,2,0,1,3,66.66666666666666
353290,2014,5,0,0,5,100.0
353290,2015,2,0,0,2,100.0
353290,2016,4,0,0,4,100.0
353290,2017,3,0,0,3,100.0
353290,2018,5,0,0,5,100.0
353290,2020,2,0,0,2,100.0
353300,2012,9,0,1,10,90.0
353300,2013,2,0,0,2,100.0
353300,2014,2,0,1,3,66.66666666666666
353300,2015,6,0,0,6,100.0
353300,2016,6,0,1,7,85.71428571428571
353300,2017,3,3,0,6,100.0
353300,2018,4,1,0,5,100.0
353300,2019,9,0,0,9,100.0
353300,2020,11,0,0,11,100.0
353310,2012,1,0,1,2,50.0
353310,2013,0,0,1,1,0.0
353310,2014,3,0,0,3,100.0
353310,2015,1,0,1,2,50.0
353310,2016,0,1,0,1,100.0
353310,2017,1,0,0,1,100.0
353320,2014,1,0,0,1,100.0
353320,2016,1,0,0,1,100.0
353320,2018,1,0,0,1,100.0
353320,2019,2,0,0,2,100.0
353320,2020,2,0,0,2,100.0
353325,2012,3,0,0,3,100.0
353325,2013,1,0,0,1,100.0
353325,2014,0,2,0,2,100.0
353325,2015,0,1,1,2,50.0
353325,2016,0,1,0,1,100.0
353325,2017,1,0,0,1,100.0
353325,2018,2,0,0,2,100.0
353325,2019,2,0,0,2,100.0
353325,2020,0,5,0,5,100.0
353330,2012,1,0,0,1,100.0
353330,2014,4,0,0,4,100.0
353330,2018,0,1,0,1,100.0
353330,2020,0,0,1,1,0.0
353340,2012,11,0,3,14,78.57142857142857
353340,2013,14,0,2,16,87.5
353340,2014,18,0,0,18,100.0
353340,2015,14,0,0,14,100.0
353340,2016,11,1,0,12,100.0
353340,2017,12,0,6,18,66.66666666666666
353340,2018,7,0,0,7,100.0
353340,2019,8,1,0,9,100.0
353340,2020,7,0,1,8,87.5
353350,2012,13,0,0,13,100.0
353350,2013,16,0,0,16,100.0
353350,2014,8,0,0,8,100.0
353350,2015,9,0,0,9,100.0
353350,2016,10,0,0,10,100.0
353350,2017,11,1,0,12,100.0
353350,2018,17,0,0,17,100.0
353350,2019,15,0,0,15,100.0
353350,2020,24,0,0,24,100.0
353360,2012,5,0,0,5,100.0
353360,2013,2,0,0,2,100.0
353360,2014,2,0,1,3,66.66666666666666
353360,2016,1,0,1,2,50.0
353360,2017,2,0,0,2,100.0
353360,2018,3,0,1,4,75.0
353360,2019,2,0,0,2,100.0
353360,2020,3,0,0,3,100.0
353370,2012,1,0,0,1,100.0
353370,2013,4,0,0,4,100.0
353370,2014,1,0,0,1,100.0
353370,2015,1,0,0,1,100.0
353370,2016,1,0,0,1,100.0
353370,2018,1,0,0,1,100.0
353370,2019,1,0,1,2,50.0
353380,2012,3,0,0,3,100.0
353380,2014,2,0,0,2,100.0
353380,2015,1,0,0,1,100.0
353380,2016,1,0,0,1,100.0
353380,2017,2,0,0,2,100.0
353380,2019,1,0,0,1,100.0
353380,2020,3,0,0,3,100.0
353390,2012,17,0,1,18,94.44444444444444
353390,2013,6,0,13,19,31.57894736842105
353390,2014,12,0,0,12,100.0
353390,2015,18,0,0,18,100.0
353390,2016,14,0,0,14,100.0
353390,2017,12,0,0,12,100.0
353390,2018,12,0,0,12,100.0
353390,2019,14,0,1,15,93.33333333333333
353390,2020,16,0,0,16,100.0
353400,2012,1,0,0,1,100.0
353400,2014,0,0,1,1,0.0
353400,2015,1,0,0,1,100.0
353400,2016,1,0,0,1,100.0
353400,2017,0,0,1,1,0.0
353410,2012,1,0,0,1,100.0
353410,2013,2,0,0,2,100.0
353410,2014,2,0,0,2,100.0
353410,2016,2,0,0,2,100.0
353410,2017,3,0,0,3,100.0
353410,2018,2,0,0,2,100.0
353410,2019,2,0,0,2,100.0
353410,2020,4,0,0,4,100.0
353420,2012,1,0,0,1,100.0
353420,2015,4,0,0,4,100.0
353420,2016,2,0,0,2,100.0
353420,2017,2,2,0,4,100.0
353420,2019,1,0,0,1,100.0
353420,2020,1,0,0,1,100.0
353430,2012,11,0,0,11,100.0
353430,2013,10,0,0,10,100.0
353430,2014,11,1,0,12,100.0
353430,2015,8,0,1,9,88.88888888888889
353430,2016,11,0,0,11,100.0
353430,2017,3,1,4,8,50.0
353430,2018,1,1,7,9,22.22222222222222
353430,2019,4,1,13,18,27.77777777777778
353430,2020,1,0,8,9,11.11111111111111
353440,2012,215,13,32,260,87.6923076923077
353440,2013,193,10,26,229,88.64628820960698
353440,2014,252,0,1,253,99.60474308300395
353440,2015,227,0,2,229,99.12663755458514
353440,2016,257,0,7,264,97.34848484848484
353440,2017,229,0,0,229,100.0
353440,2018,216,1,0,217,100.0
353440,2019,243,0,1,244,99.59016393442623
353440,2020,245,0,1,246,99.59349593495935
353450,2012,1,0,0,1,100.0
353450,2017,2,0,0,2,100.0
353450,2019,2,0,0,2,100.0
353450,2020,1,0,0,1,100.0
353460,2012,8,0,0,8,100.0
353460,2013,13,0,0,13,100.0
353460,2014,7,0,0,7,100.0
353460,2015,6,0,0,6,100.0
353460,2016,6,0,0,6,100.0
353460,2017,10,0,0,10,100.0
353460,2018,8,0,0,8,100.0
353460,2019,11,0,0,11,100.0
353460,2020,8,0,0,8,100.0
353470,2012,38,0,3,41,92.6829268292683
353470,2013,32,0,6,38,84.21052631578947
353470,2014,25,0,1,26,96.15384615384616
353470,2015,29,0,1,30,96.66666666666667
353470,2016,42,0,0,42,100.0
353470,2017,27,0,0,27,100.0
353470,2018,27,0,1,28,96.42857142857143
353470,2019,21,0,2,23,91.30434782608695
353470,2020,24,1,4,29,86.20689655172413
353475,2012,3,0,0,3,100.0
353475,2013,5,0,0,5,100.0
353475,2014,4,0,0,4,100.0
353475,2015,1,0,0,1,100.0
353475,2016,3,0,0,3,100.0
353475,2017,1,0,0,1,100.0
353475,2018,4,0,0,4,100.0
353475,2019,11,0,0,11,100.0
353475,2020,7,0,0,7,100.0
353480,2012,2,0,0,2,100.0
353480,2013,4,0,0,4,100.0
353480,2014,5,0,0,5,100.0
353480,2015,1,0,0,1,100.0
353480,2017,2,0,0,2,100.0
353480,2018,1,0,0,1,100.0
353480,2019,5,0,0,5,100.0
353480,2020,4,0,0,4,100.0
353490,2012,2,0,0,2,100.0
353490,2013,2,0,0,2,100.0
353490,2014,5,0,0,5,100.0
353490,2015,7,0,0,7,100.0
353490,2016,1,0,0,1,100.0
353490,2017,4,0,0,4,100.0
353490,2018,3,0,0,3,100.0
353490,2019,5,0,0,5,100.0
353490,2020,1,0,0,1,100.0
353500,2012,3,0,0,3,100.0
353500,2013,10,0,0,10,100.0
353500,2014,3,0,0,3,100.0
353500,2015,2,0,0,2,100.0
353500,2016,3,0,0,3,100.0
353500,2017,3,0,0,3,100.0
353500,2018,1,0,0,1,100.0
353500,2019,7,0,0,7,100.0
353500,2020,3,1,0,4,100.0
353510,2012,4,0,0,4,100.0
353510,2013,5,0,0,5,100.0
353510,2014,5,0,0,5,100.0
353510,2015,3,0,0,3,100.0
353510,2016,1,0,0,1,100.0
353510,2017,5,0,0,5,100.0
353510,2018,6,0,0,6,100.0
353510,2019,3,0,0,3,100.0
353510,2020,5,0,0,5,100.0
353520,2012,3,0,0,3,100.0
353520,2013,1,0,0,1,100.0
353520,2014,5,0,0,5,100.0
353520,2015,5,0,0,5,100.0
353520,2016,4,0,0,4,100.0
353520,2017,1,0,0,1,100.0
353520,2018,3,0,0,3,100.0
353520,2019,3,0,0,3,100.0
353520,2020,2,0,0,2,100.0
353530,2012,0,0,3,3,0.0
353530,2013,0,0,6,6,0.0
353530,2014,0,1,4,5,20.0
353530,2015,7,0,0,7,100.0
353530,2016,4,0,0,4,100.0
353530,2017,4,0,0,4,100.0
353530,2018,5,0,0,5,100.0
353530,2019,6,0,0,6,100.0
353530,2020,5,0,3,8,62.5
353540,2012,3,0,0,3,100.0
353540,2013,4,0,0,4,100.0
353540,2014,5,0,1,6,83.33333333333334
353540,2015,2,0,0,2,100.0
353540,2016,3,0,3,6,50.0
353540,2017,3,0,0,3,100.0
353540,2018,6,0,0,6,100.0
353540,2019,6,0,0,6,100.0
353540,2020,6,0,0,6,100.0
353550,2012,18,0,0,18,100.0
353550,2013,12,0,0,12,100.0
353550,2014,14,0,0,14,100.0
353550,2015,15,0,0,15,100.0
353550,2016,17,0,0,17,100.0
353550,2017,10,0,0,10,100.0
353550,2018,11,0,0,11,100.0
353550,2019,7,0,0,7,100.0
353550,2020,17,0,0,17,100.0
353560,2012,11,0,0,11,100.0
353560,2013,6,0,0,6,100.0
353560,2014,3,0,0,3,100.0
353560,2015,5,0,0,5,100.0
353560,2016,3,0,3,6,50.0
353560,2017,3,0,0,3,100.0
353560,2018,2,0,1,3,66.66666666666666
353560,2019,6,0,0,6,100.0
353560,2020,4,0,0,4,100.0
353570,2012,5,0,0,5,100.0
353570,2013,1,0,0,1,100.0
353570,2015,3,0,0,3,100.0
353570,2016,1,0,0,1,100.0
353570,2017,1,0,0,1,100.0
353570,2018,2,0,0,2,100.0
353570,2019,1,0,0,1,100.0
353570,2020,4,0,0,4,100.0
353580,2012,3,0,1,4,75.0
353580,2013,8,0,0,8,100.0
353580,2014,4,0,0,4,100.0
353580,2015,3,0,1,4,75.0
353580,2016,11,0,0,11,100.0
353580,2017,3,0,0,3,100.0
353580,2018,6,0,0,6,100.0
353580,2019,3,0,0,3,100.0
353580,2020,3,0,1,4,75.0
353590,2012,2,0,0,2,100.0
353590,2013,2,0,0,2,100.0
353590,2014,1,0,0,1,100.0
353590,2016,2,0,0,2,100.0
353590,2018,2,0,0,2,100.0
353590,2019,2,0,0,2,100.0
353590,2020,1,0,0,1,100.0
353600,2012,1,0,0,1,100.0
353600,2013,1,0,0,1,100.0
353600,2014,3,0,0,3,100.0
353600,2015,1,0,0,1,100.0
353600,2016,4,0,0,4,100.0
353600,2017,2,0,0,2,100.0
353600,2018,2,0,0,2,100.0
353600,2019,5,0,0,5,100.0
353600,2020,2,0,0,2,100.0
353610,2012,0,1,0,1,100.0
353610,2014,1,0,0,1,100.0
353610,2015,4,0,0,4,100.0
353610,2016,3,0,0,3,100.0
353610,2017,1,0,0,1,100.0
353610,2018,2,0,0,2,100.0
353610,2019,2,0,0,2,100.0
353610,2020,3,0,0,3,100.0
353620,2012,9,0,1,10,90.0
353620,2013,5,0,0,5,100.0
353620,2014,4,0,0,4,100.0
353620,2015,3,0,0,3,100.0
353620,2016,2,0,0,2,100.0
353620,2017,4,0,0,4,100.0
353620,2018,4,0,0,4,100.0
353620,2019,7,0,0,7,100.0
353620,2020,7,0,0,7,100.0
353625,2012,1,0,0,1,100.0
353625,2013,1,0,0,1,100.0
353625,2015,1,0,0,1,100.0
353625,2016,1,0,0,1,100.0
353625,2017,1,0,0,1,100.0
353625,2018,2,0,0,2,100.0
353625,2020,3,0,0,3,100.0
353630,2012,0,0,7,7,0.0
353630,2013,1,0,5,6,16.666666666666664
353630,2014,0,0,2,2,0.0
353630,2015,0,0,5,5,0.0
353630,2016,1,0,6,7,14.285714285714285
353630,2017,2,0,2,4,50.0
353630,2018,3,0,1,4,75.0
353630,2019,0,0,5,5,0.0
353630,2020,0,0,5,5,0.0
353640,2012,0,0,4,4,0.0
353640,2013,0,0,3,3,0.0
353640,2014,0,0,1,1,0.0
353640,2015,2,1,3,6,50.0
353640,2016,2,0,1,3,66.66666666666666
353640,2017,4,0,0,4,100.0
353640,2018,7,0,0,7,100.0
353640,2019,6,0,0,6,100.0
353640,2020,3,0,0,3,100.0
353650,2012,22,0,0,22,100.0
353650,2013,14,0,5,19,73.68421052631578
353650,2014,26,0,0,26,100.0
353650,2015,16,0,0,16,100.0
353650,2016,28,0,6,34,82.35294117647058
353650,2017,26,0,2,28,92.85714285714286
353650,2018,21,0,0,21,100.0
353650,2019,18,0,9,27,66.66666666666666
353650,2020,7,0,23,30,23.333333333333332
353657,2016,0,1,0,1,100.0
353657,2018,2,0,0,2,100.0
353657,2020,0,1,0,1,100.0
353660,2012,4,0,0,4,100.0
353660,2013,2,0,0,2,100.0
353660,2014,1,0,1,2,50.0
353660,2015,2,0,0,2,100.0
353660,2016,3,0,0,3,100.0
353660,2017,1,0,0,1,100.0
353660,2018,5,0,0,5,100.0
353660,2020,2,0,0,2,100.0
353670,2012,0,0,13,13,0.0
353670,2013,3,1,8,12,33.33333333333333
353670,2014,9,0,7,16,56.25
353670,2015,18,0,1,19,94.73684210526315
353670,2016,17,0,0,17,100.0
353670,2017,10,0,0,10,100.0
353670,2018,8,0,0,8,100.0
353670,2019,21,0,0,21,100.0
353670,2020,16,0,0,16,100.0
353680,2013,1,0,0,1,100.0
353680,2014,1,0,0,1,100.0
353680,2015,1,0,0,1,100.0
353680,2016,2,0,0,2,100.0
353680,2017,1,2,0,3,100.0
353680,2018,0,0,1,1,0.0
353680,2019,1,0,0,1,100.0
353680,2020,0,0,1,1,0.0
353690,2013,1,0,0,1,100.0
353690,2020,2,0,0,2,100.0
353700,2013,1,0,4,5,20.0
353700,2014,0,0,4,4,0.0
353700,2015,0,0,7,7,0.0
353700,2016,0,3,7,10,30.0
353700,2017,0,1,4,5,20.0
353700,2018,1,0,7,8,12.5
353700,2019,0,0,4,4,0.0
353700,2020,0,0,4,4,0.0
353710,2012,6,0,0,6,100.0
353710,2013,10,0,0,10,100.0
353710,2014,9,0,0,9,100.0
353710,2015,17,0,0,17,100.0
353710,2016,12,0,0,12,100.0
353710,2017,9,1,0,10,100.0
353710,2018,12,0,0,12,100.0
353710,2019,10,0,1,11,90.9090909090909
353710,2020,13,0,0,13,100.0
353715,2012,0,1,1,2,50.0
353715,2013,0,0,1,1,0.0
353715,2014,0,0,1,1,0.0
353715,2016,0,0,1,1,0.0
353715,2020,3,0,0,3,100.0
353720,2012,0,0,3,3,0.0
353720,2013,0,3,1,4,75.0
353720,2014,0,0,3,3,0.0
353720,2015,3,0,1,4,75.0
353720,2016,6,0,0,6,100.0
353720,2017,3,0,0,3,100.0
353720,2018,1,0,0,1,100.0
353720,2019,2,0,0,2,100.0
353720,2020,2,2,1,5,80.0
353730,2012,19,0,0,19,100.0
353730,2013,19,0,1,20,95.0
353730,2014,13,0,0,13,100.0
353730,2015,14,0,0,14,100.0
353730,2016,18,0,1,19,94.73684210526315
353730,2017,16,0,0,16,100.0
353730,2018,23,0,0,23,100.0
353730,2019,12,0,0,12,100.0
353730,2020,17,0,0,17,100.0
353740,2012,11,0,0,11,100.0
353740,2013,9,0,0,9,100.0
353740,2014,6,0,0,6,100.0
353740,2015,13,0,0,13,100.0
353740,2016,13,0,0,13,100.0
353740,2017,9,0,0,9,100.0
353740,2018,10,0,0,10,100.0
353740,2019,8,0,0,8,100.0
353740,2020,6,0,0,6,100.0
353750,2012,4,0,0,4,100.0
353750,2013,2,0,0,2,100.0
353750,2014,1,0,0,1,100.0
353750,2015,1,0,0,1,100.0
353750,2016,2,0,0,2,100.0
353750,2017,4,0,0,4,100.0
353750,2018,2,0,0,2,100.0
353750,2019,1,0,0,1,100.0
353750,2020,1,0,0,1,100.0
353760,2012,10,6,12,28,57.14285714285714
353760,2013,19,2,3,24,87.5
353760,2014,20,0,1,21,95.23809523809523
353760,2015,13,2,4,19,78.94736842105263
353760,2016,23,0,2,25,92.0
353760,2017,29,0,2,31,93.54838709677419
353760,2018,28,0,0,28,100.0
353760,2019,28,0,0,28,100.0
353760,2020,25,0,0,25,100.0
353770,2012,2,0,0,2,100.0
353770,2013,1,0,0,1,100.0
353770,2014,3,0,0,3,100.0
353770,2017,2,0,0,2,100.0
353770,2018,1,0,0,1,100.0
353770,2019,2,0,0,2,100.0
353770,2020,2,0,0,2,100.0
353780,2012,22,0,0,22,100.0
353780,2013,20,0,0,20,100.0
353780,2014,29,0,0,29,100.0
353780,2015,17,0,0,17,100.0
353780,2016,11,0,1,12,91.66666666666666
353780,2017,23,0,1,24,95.83333333333334
353780,2018,22,0,0,22,100.0
353780,2019,14,0,0,14,100.0
353780,2020,13,0,8,21,61.904761904761905
353790,2012,7,0,0,7,100.0
353790,2013,9,0,2,11,81.81818181818183
353790,2014,8,0,2,10,80.0
353790,2015,3,0,0,3,100.0
353790,2016,12,0,0,12,100.0
353790,2017,16,0,0,16,100.0
353790,2018,10,0,0,10,100.0
353790,2019,10,0,0,10,100.0
353790,2020,6,0,0,6,100.0
353800,2012,40,0,1,41,97.5609756097561
353800,2013,46,1,0,47,100.0
353800,2014,50,0,0,50,100.0
353800,2015,55,0,0,55,100.0
353800,2016,35,0,0,35,100.0
353800,2017,36,0,0,36,100.0
353800,2018,51,0,0,51,100.0
353800,2019,59,0,0,59,100.0
353800,2020,44,0,1,45,97.77777777777777
353810,2012,4,0,0,4,100.0
353810,2013,5,3,0,8,100.0
353810,2014,0,2,0,2,100.0
353810,2015,1,4,0,5,100.0
353810,2016,0,3,2,5,60.0
353810,2017,5,0,0,5,100.0
353810,2018,2,0,0,2,100.0
353810,2019,0,5,0,5,100.0
353810,2020,4,0,0,4,100.0
353820,2012,5,0,0,5,100.0
353820,2013,0,1,0,1,100.0
353820,2014,1,0,0,1,100.0
353820,2015,4,0,0,4,100.0
353820,2016,3,0,0,3,100.0
353820,2017,5,0,0,5,100.0
353820,2018,1,0,0,1,100.0
353820,2019,4,0,0,4,100.0
353820,2020,7,0,0,7,100.0
353830,2013,0,0,2,2,0.0
353830,2017,0,0,3,3,0.0
353830,2019,0,0,1,1,0.0
353850,2012,3,0,2,5,60.0
353850,2013,4,1,1,6,83.33333333333334
353850,2014,0,0,5,5,0.0
353850,2015,2,1,3,6,50.0
353850,2016,0,1,1,2,50.0
353850,2017,0,0,1,1,0.0
353850,2018,0,0,2,2,0.0
353850,2019,0,0,6,6,0.0
353850,2020,1,0,3,4,25.0
353860,2012,4,0,3,7,57.14285714285714
353860,2013,6,0,0,6,100.0
353860,2014,3,0,3,6,50.0
353860,2015,2,0,2,4,50.0
353860,2016,5,2,0,7,100.0
353860,2017,7,0,0,7,100.0
353860,2018,7,0,0,7,100.0
353860,2019,6,0,1,7,85.71428571428571
353860,2020,4,0,0,4,100.0
353870,2012,115,0,0,115,100.0
353870,2013,124,0,0,124,100.0
353870,2014,98,0,0,98,100.0
353870,2015,110,0,0,110,100.0
353870,2016,105,0,0,105,100.0
353870,2017,117,0,0,117,100.0
353870,2018,95,0,0,95,100.0
353870,2019,100,0,0,100,100.0
353870,2020,119,0,0,119,100.0
353880,2012,7,0,0,7,100.0
353880,2013,11,0,0,11,100.0
353880,2014,6,0,0,6,100.0
353880,2015,9,0,0,9,100.0
353880,2016,7,0,0,7,100.0
353880,2017,4,0,0,4,100.0
353880,2018,5,0,0,5,100.0
353880,2019,10,1,0,11,100.0
353880,2020,9,0,1,10,90.0
353890,2012,2,0,0,2,100.0
353890,2013,4,3,1,8,87.5
353890,2014,2,4,1,7,85.71428571428571
353890,2015,7,0,2,9,77.77777777777779
353890,2016,9,0,1,10,90.0
353890,2017,7,0,0,7,100.0
353890,2018,9,0,0,9,100.0
353890,2019,5,1,2,8,75.0
353890,2020,8,3,1,12,91.66666666666666
353900,2012,4,0,0,4,100.0
353900,2013,3,0,0,3,100.0
353900,2014,2,0,1,3,66.66666666666666
353900,2015,3,1,0,4,100.0
353900,2016,4,0,0,4,100.0
353900,2017,1,0,0,1,100.0
353900,2018,5,0,0,5,100.0
353900,2019,4,0,0,4,100.0
353900,2020,2,0,0,2,100.0
353910,2012,1,1,4,6,33.33333333333333
353910,2013,0,2,4,6,33.33333333333333
353910,2014,0,1,3,4,25.0
353910,2015,0,0,5,5,0.0
353910,2016,0,0,5,5,0.0
353910,2017,0,0,9,9,0.0
353910,2019,0,1,6,7,14.285714285714285
353910,2020,1,1,6,8,25.0
353920,2012,13,0,0,13,100.0
353920,2013,10,0,0,10,100.0
353920,2014,7,0,0,7,100.0
353920,2015,11,0,0,11,100.0
353920,2016,13,0,0,13,100.0
353920,2017,8,0,0,8,100.0
353920,2018,9,0,0,9,100.0
353920,2019,8,0,0,8,100.0
353920,2020,9,0,0,9,100.0
353930,2012,4,25,5,34,85.29411764705883
353930,2013,1,12,2,15,86.66666666666667
353930,2014,22,2,2,26,92.3076923076923
353930,2015,18,0,0,18,100.0
353930,2016,18,0,0,18,100.0
353930,2017,27,0,0,27,100.0
353930,2018,21,0,0,21,100.0
353930,2019,25,0,0,25,100.0
353930,2020,19,0,0,19,100.0
353940,2012,0,0,4,4,0.0
353940,2013,2,0,1,3,66.66666666666666
353940,2014,2,0,1,3,66.66666666666666
353940,2015,1,0,4,5,20.0
353940,2016,0,1,1,2,50.0
353940,2017,0,1,4,5,20.0
353940,2018,0,2,5,7,28.57142857142857
353940,2019,0,3,2,5,60.0
353940,2020,8,0,0,8,100.0
353950,2012,15,0,0,15,100.0
353950,2013,20,0,0,20,100.0
353950,2014,18,0,0,18,100.0
353950,2015,14,0,0,14,100.0
353950,2016,15,0,0,15,100.0
353950,2017,12,0,0,12,100.0
353950,2018,13,0,0,13,100.0
353950,2019,15,0,0,15,100.0
353950,2020,17,0,0,17,100.0
353960,2013,1,0,1,2,50.0
353960,2016,1,0,0,1,100.0
353960,2017,2,1,0,3,100.0
353960,2018,2,0,0,2,100.0
353960,2019,0,2,0,2,100.0
353960,2020,1,0,0,1,100.0
353970,2012,0,0,2,2,0.0
353970,2013,0,0,1,1,0.0
353970,2017,0,0,1,1,0.0
353970,2018,0,0,2,2,0.0
353970,2019,0,1,0,1,100.0
353970,2020,0,0,5,5,0.0
353980,2012,30,0,4,34,88.23529411764706
353980,2013,44,0,2,46,95.65217391304348
353980,2014,35,1,4,40,90.0
353980,2015,12,4,21,37,43.24324324324324
353980,2016,6,5,17,28,39.285714285714285
353980,2017,20,3,12,35,65.71428571428571
353980,2018,37,1,10,48,79.16666666666666
353980,2019,16,1,23,40,42.5
353980,2020,29,3,5,37,86.48648648648648
353990,2012,1,0,0,1,100.0
353990,2013,2,0,0,2,100.0
353990,2014,2,0,0,2,100.0
353990,2015,1,0,0,1,100.0
353990,2016,1,0,0,1,100.0
353990,2017,2,0,0,2,100.0
353990,2018,1,0,0,1,100.0
353990,2019,2,0,0,2,100.0
354000,2012,10,0,0,10,100.0
354000,2013,11,0,0,11,100.0
354000,2014,6,0,0,6,100.0
354000,2015,4,0,0,4,100.0
354000,2016,6,0,0,6,100.0
354000,2017,7,0,0,7,100.0
354000,2018,6,0,0,6,100.0
354000,2019,5,0,0,5,100.0
354000,2020,4,0,0,4,100.0
354010,2012,1,0,0,1,100.0
354010,2013,0,0,2,2,0.0
354010,2014,3,0,0,3,100.0
354010,2015,1,0,0,1,100.0
354010,2018,1,0,0,1,100.0
354010,2020,0,1,0,1,100.0
354020,2012,18,0,0,18,100.0
354020,2013,13,0,0,13,100.0
354020,2014,9,0,0,9,100.0
354020,2015,12,0,0,12,100.0
354020,2016,16,0,0,16,100.0
354020,2017,12,0,0,12,100.0
354020,2018,12,0,0,12,100.0
354020,2019,15,0,0,15,100.0
354020,2020,21,0,0,21,100.0
354025,2012,2,0,0,2,100.0
354025,2015,2,0,0,2,100.0
354025,2016,2,0,0,2,100.0
354025,2018,1,0,0,1,100.0
354025,2019,1,0,0,1,100.0
354025,2020,1,0,0,1,100.0
354030,2012,1,0,0,1,100.0
354030,2013,1,0,0,1,100.0
354030,2015,0,0,1,1,0.0
354030,2016,1,0,0,1,100.0
354030,2017,1,0,0,1,100.0
354030,2018,2,0,0,2,100.0
354030,2019,0,0,1,1,0.0
354040,2012,2,0,0,2,100.0
354040,2013,1,0,0,1,100.0
354040,2015,3,0,0,3,100.0
354040,2017,1,0,0,1,100.0
354040,2018,2,0,0,2,100.0
354040,2019,1,0,0,1,100.0
354040,2020,3,0,0,3,100.0
354050,2012,4,0,0,4,100.0
354050,2013,4,0,0,4,100.0
354050,2014,4,0,0,4,100.0
354050,2015,2,0,0,2,100.0
354050,2016,2,0,0,2,100.0
354050,2017,2,0,0,2,100.0
354050,2018,5,0,0,5,100.0
354050,2019,3,0,0,3,100.0
354050,2020,4,0,0,4,100.0
354060,2012,11,0,0,11,100.0
354060,2013,17,0,0,17,100.0
354060,2014,15,0,0,15,100.0
354060,2015,19,0,0,19,100.0
354060,2016,13,0,0,13,100.0
354060,2017,14,0,0,14,100.0
354060,2018,12,0,0,12,100.0
354060,2019,13,0,0,13,100.0
354060,2020,14,0,0,14,100.0
354070,2012,13,0,0,13,100.0
354070,2013,17,0,1,18,94.44444444444444
354070,2014,14,0,1,15,93.33333333333333
354070,2015,14,0,3,17,82.35294117647058
354070,2016,13,0,0,13,100.0
354070,2017,13,0,1,14,92.85714285714286
354070,2018,20,0,0,20,100.0
354070,2019,16,0,0,16,100.0
354070,2020,20,0,0,20,100.0
354075,2012,0,3,4,7,42.857142857142854
354075,2013,14,0,1,15,93.33333333333333
354075,2014,7,0,0,7,100.0
354075,2015,7,0,0,7,100.0
354075,2016,9,0,0,9,100.0
354075,2017,3,0,0,3,100.0
354075,2018,6,0,0,6,100.0
354075,2019,10,0,0,10,100.0
354075,2020,4,0,0,4,100.0
354080,2012,2,0,0,2,100.0
354080,2013,3,0,0,3,100.0
354080,2014,6,0,0,6,100.0
354080,2016,1,0,0,1,100.0
354080,2017,7,0,0,7,100.0
354080,2018,4,0,0,4,100.0
354080,2019,4,0,0,4,100.0
354080,2020,3,0,0,3,100.0
354085,2012,1,0,0,1,100.0
354085,2014,1,0,0,1,100.0
354085,2015,1,0,0,1,100.0
354085,2018,3,0,0,3,100.0
354090,2012,3,0,0,3,100.0
354090,2013,5,0,0,5,100.0
354090,2014,8,0,0,8,100.0
354090,2015,9,0,0,9,100.0
354090,2016,8,0,0,8,100.0
354090,2017,4,0,0,4,100.0
354090,2018,6,0,0,6,100.0
354090,2019,7,0,0,7,100.0
354090,2020,6,0,0,6,100.0
354100,2012,110,0,0,110,100.0
354100,2013,131,0,0,131,100.0
354100,2014,93,0,1,94,98.93617021276596
354100,2015,112,0,0,112,100.0
354100,2016,104,0,0,104,100.0
354100,2017,107,0,0,107,100.0
354100,2018,120,0,0,120,100.0
354100,2019,114,0,0,114,100.0
354100,2020,130,0,0,130,100.0
354105,2012,1,0,0,1,100.0
354105,2013,1,0,0,1,100.0
354105,2015,1,0,0,1,100.0
354105,2016,1,0,0,1,100.0
354105,2017,4,0,0,4,100.0
354105,2018,3,0,0,3,100.0
354105,2019,1,0,0,1,100.0
354105,2020,1,0,0,1,100.0
354110,2012,0,0,2,2,0.0
354110,2013,0,1,0,1,100.0
354110,2014,2,0,2,4,50.0
354110,2015,0,1,1,2,50.0
354110,2016,0,1,0,1,100.0
354110,2017,0,0,1,1,0.0
354110,2018,1,0,0,1,100.0
354110,2019,0,0,1,1,0.0
354110,2020,0,1,0,1,100.0
354120,2012,0,0,1,1,0.0
354120,2013,0,0,1,1,0.0
354120,2015,2,0,0,2,100.0
354120,2016,3,0,0,3,100.0
354120,2017,0,2,0,2,100.0
354120,2018,3,0,0,3,100.0
354120,2019,4,0,0,4,100.0
354120,2020,2,0,0,2,100.0
354130,2012,9,0,0,9,100.0
354130,2013,20,0,0,20,100.0
354130,2014,20,0,0,20,100.0
354130,2015,16,0,0,16,100.0
354130,2016,14,0,0,14,100.0
354130,2017,16,0,0,16,100.0
354130,2018,7,0,0,7,100.0
354130,2019,13,0,0,13,100.0
354130,2020,13,0,0,13,100.0
354140,2012,59,0,0,59,100.0
354140,2013,71,0,2,73,97.26027397260275
354140,2014,69,0,0,69,100.0
354140,2015,68,0,0,68,100.0
354140,2016,46,0,0,46,100.0
354140,2017,47,0,0,47,100.0
354140,2018,60,0,0,60,100.0
354140,2019,56,0,0,56,100.0
354140,2020,61,0,1,62,98.38709677419355
354150,2012,9,1,0,10,100.0
354150,2013,20,0,0,20,100.0
354150,2014,10,0,0,10,100.0
354150,2015,10,0,0,10,100.0
354150,2016,12,1,0,13,100.0
354150,2017,15,0,0,15,100.0
354150,2018,12,0,0,12,100.0
354150,2019,11,0,0,11,100.0
354150,2020,5,0,0,5,100.0
354160,2012,10,0,3,13,76.92307692307693
354160,2013,14,0,0,14,100.0
354160,2014,12,0,0,12,100.0
354160,2015,7,0,0,7,100.0
354160,2016,8,0,0,8,100.0
354160,2017,16,0,0,16,100.0
354160,2018,9,0,0,9,100.0
354160,2019,12,0,0,12,100.0
354160,2020,3,4,9,16,43.75
354165,2017,0,0,3,3,0.0
354165,2018,0,0,1,1,0.0
354165,2020,0,0,1,1,0.0
354170,2012,3,0,0,3,100.0
354170,2013,2,0,0,2,100.0
354170,2014,4,0,0,4,100.0
354170,2015,1,0,1,2,50.0
354170,2016,5,0,1,6,83.33333333333334
354170,2017,5,0,0,5,100.0
354170,2018,3,0,0,3,100.0
354170,2019,6,0,0,6,100.0
354170,2020,2,0,1,3,66.66666666666666
354180,2012,3,0,0,3,100.0
354180,2013,1,0,0,1,100.0
354180,2015,3,0,0,3,100.0
354180,2016,1,0,0,1,100.0
354180,2017,0,0,1,1,0.0
354180,2020,2,0,0,2,100.0
354190,2012,0,4,1,5,80.0
354190,2013,1,3,0,4,100.0
354190,2014,3,0,0,3,100.0
354190,2016,7,0,0,7,100.0
354190,2017,3,0,0,3,100.0
354190,2018,4,0,0,4,100.0
354190,2019,4,0,1,5,80.0
354190,2020,2,0,2,4,50.0
354200,2012,1,0,0,1,100.0
354200,2013,3,0,0,3,100.0
354200,2014,1,0,0,1,100.0
354200,2016,3,0,0,3,100.0
354200,2018,2,0,0,2,100.0
354200,2019,1,0,0,1,100.0
354200,2020,3,0,0,3,100.0
354210,2012,4,0,0,4,100.0
354210,2013,3,0,0,3,100.0
354210,2014,1,0,0,1,100.0
354210,2015,3,0,0,3,100.0
354210,2016,3,0,0,3,100.0
354210,2017,4,0,0,4,100.0
354210,2018,2,0,0,2,100.0
354210,2019,2,0,0,2,100.0
354210,2020,5,0,0,5,100.0
354220,2012,5,0,0,5,100.0
354220,2013,11,0,0,11,100.0
354220,2014,3,0,4,7,42.857142857142854
354220,2015,11,0,0,11,100.0
354220,2016,16,0,0,16,100.0
354220,2017,16,0,0,16,100.0
354220,2018,16,0,0,16,100.0
354220,2019,9,0,0,9,100.0
354220,2020,8,0,0,8,100.0
354230,2012,1,0,0,1,100.0
354230,2014,1,1,1,3,66.66666666666666
354230,2018,0,4,0,4,100.0
354230,2019,0,0,1,1,0.0
354230,2020,0,0,2,2,0.0
354240,2012,8,0,0,8,100.0
354240,2013,7,0,0,7,100.0
354240,2014,4,0,0,4,100.0
354240,2015,5,0,0,5,100.0
354240,2016,6,0,0,6,100.0
354240,2017,7,0,0,7,100.0
354240,2018,3,0,0,3,100.0
354240,2019,8,0,0,8,100.0
354240,2020,9,0,0,9,100.0
354250,2012,1,0,0,1,100.0
354250,2013,1,0,0,1,100.0
354250,2014,1,0,0,1,100.0
354250,2016,4,0,1,5,80.0
354250,2017,2,0,0,2,100.0
354250,2018,1,0,0,1,100.0
354250,2019,1,0,0,1,100.0
354250,2020,4,0,0,4,100.0
354260,2012,15,0,3,18,83.33333333333334
354260,2013,11,0,0,11,100.0
354260,2014,12,0,1,13,92.3076923076923
354260,2015,23,0,0,23,100.0
354260,2016,23,0,0,23,100.0
354260,2017,13,0,0,13,100.0
354260,2018,20,0,0,20,100.0
354260,2019,9,0,0,9,100.0
354260,2020,17,0,0,17,100.0
354270,2012,0,0,1,1,0.0
354270,2013,0,0,1,1,0.0
354270,2014,0,0,1,1,0.0
354270,2015,0,0,2,2,0.0
354270,2016,0,0,3,3,0.0
354270,2017,0,0,1,1,0.0
354270,2018,2,0,0,2,100.0
354270,2019,2,0,0,2,100.0
354270,2020,2,0,0,2,100.0
354280,2012,1,0,0,1,100.0
354280,2014,0,0,2,2,0.0
354280,2015,0,0,1,1,0.0
354280,2016,0,2,0,2,100.0
354280,2017,1,0,0,1,100.0
354280,2018,1,0,0,1,100.0
354280,2019,1,0,0,1,100.0
354280,2020,2,1,0,3,100.0
354290,2012,4,0,0,4,100.0
354290,2013,4,0,0,4,100.0
354290,2014,3,0,0,3,100.0
354290,2015,2,0,0,2,100.0
354290,2016,5,0,0,5,100.0
354290,2017,2,0,0,2,100.0
354290,2018,3,0,0,3,100.0
354290,2019,3,0,0,3,100.0
354290,2020,3,0,0,3,100.0
354300,2012,7,0,0,7,100.0
354300,2013,7,0,0,7,100.0
354300,2014,7,0,0,7,100.0
354300,2015,9,0,0,9,100.0
354300,2016,4,0,0,4,100.0
354300,2017,4,0,0,4,100.0
354300,2018,7,0,0,7,100.0
354300,2019,4,0,0,4,100.0
354300,2020,7,0,0,7,100.0
354310,2012,1,0,0,1,100.0
354310,2014,3,0,0,3,100.0
354310,2015,3,0,0,3,100.0
354310,2016,1,0,0,1,100.0
354310,2017,1,0,0,1,100.0
354310,2018,2,0,0,2,100.0
354310,2020,1,0,0,1,100.0
354320,2012,3,0,0,3,100.0
354320,2013,1,0,0,1,100.0
354320,2014,2,0,1,3,66.66666666666666
354320,2015,3,0,0,3,100.0
354320,2018,0,0,2,2,0.0
354320,2019,0,0,1,1,0.0
354320,2020,1,0,2,3,33.33333333333333
354323,2012,0,0,2,2,0.0
354323,2018,0,1,0,1,100.0
354323,2019,0,0,2,2,0.0
354323,2020,1,0,0,1,100.0
354325,2012,2,0,0,2,100.0
354325,2013,7,0,0,7,100.0
354325,2014,0,1,0,1,100.0
354325,2015,0,0,2,2,0.0
354325,2016,0,0,4,4,0.0
354325,2017,1,0,0,1,100.0
354325,2018,0,0,5,5,0.0
354325,2019,0,0,1,1,0.0
354325,2020,0,1,3,4,25.0
354330,2012,33,0,0,33,100.0
354330,2013,26,0,2,28,92.85714285714286
354330,2014,27,1,0,28,100.0
354330,2015,30,0,4,34,88.23529411764706
354330,2016,28,4,15,47,68.08510638297872
354330,2017,27,2,9,38,76.31578947368422
354330,2018,25,1,3,29,89.65517241379311
354330,2019,18,1,12,31,61.29032258064516
354330,2020,25,0,10,35,71.42857142857143
354340,2012,200,0,0,200,100.0
354340,2013,150,0,0,150,100.0
354340,2014,176,0,1,177,99.43502824858757
354340,2015,153,0,0,153,100.0
354340,2016,197,1,0,198,100.0
354340,2017,166,0,0,166,100.0
354340,2018,191,2,2,195,98.97435897435898
354340,2019,146,2,7,155,95.48387096774194
354340,2020,213,0,1,214,99.53271028037383
354350,2012,2,0,0,2,100.0
354350,2013,1,0,0,1,100.0
354350,2014,5,0,0,5,100.0
354350,2015,3,0,0,3,100.0
354350,2016,3,0,0,3,100.0
354350,2017,2,0,0,2,100.0
354350,2018,4,0,0,4,100.0
354350,2019,4,0,0,4,100.0
354350,2020,1,0,0,1,100.0
354360,2012,1,0,0,1,100.0
354360,2013,2,0,0,2,100.0
354360,2014,3,0,0,3,100.0
354360,2015,2,0,1,3,66.66666666666666
354360,2016,1,0,0,1,100.0
354360,2017,3,0,0,3,100.0
354360,2018,1,0,0,1,100.0
354360,2019,2,0,0,2,100.0
354360,2020,1,0,0,1,100.0
354370,2012,2,0,0,2,100.0
354370,2013,5,0,0,5,100.0
354370,2014,1,0,0,1,100.0
354370,2015,1,0,0,1,100.0
354370,2016,2,0,0,2,100.0
354370,2017,4,0,0,4,100.0
354370,2018,2,0,0,2,100.0
354370,2019,4,0,0,4,100.0
354370,2020,3,0,0,3,100.0
354380,2012,2,0,0,2,100.0
354380,2014,5,0,0,5,100.0
354380,2015,4,0,0,4,100.0
354380,2016,4,0,0,4,100.0
354380,2017,2,0,0,2,100.0
354380,2018,6,0,0,6,100.0
354380,2019,1,0,1,2,50.0
354390,2012,50,0,1,51,98.0392156862745
354390,2013,64,0,0,64,100.0
354390,2014,63,0,1,64,98.4375
354390,2015,58,0,0,58,100.0
354390,2016,49,0,0,49,100.0
354390,2017,46,0,0,46,100.0
354390,2018,55,0,0,55,100.0
354390,2019,47,2,12,61,80.32786885245902
354390,2020,64,8,2,74,97.2972972972973
354400,2012,5,0,0,5,100.0
354400,2013,5,0,0,5,100.0
354400,2014,12,0,0,12,100.0
354400,2015,8,0,0,8,100.0
354400,2016,3,0,0,3,100.0
354400,2017,9,0,0,9,100.0
354400,2018,6,0,0,6,100.0
354400,2019,2,2,0,4,100.0
354400,2020,7,0,0,7,100.0
354410,2012,13,0,0,13,100.0
354410,2013,21,0,3,24,87.5
354410,2014,10,2,8,20,60.0
354410,2015,18,1,4,23,82.6086956521739
354410,2016,14,2,2,18,88.88888888888889
354410,2017,13,0,3,16,81.25
354410,2018,11,0,3,14,78.57142857142857
354410,2019,14,0,1,15,93.33333333333333
354410,2020,15,4,4,23,82.6086956521739
354420,2012,4,0,0,4,100.0
354420,2013,4,0,0,4,100.0
354420,2014,6,0,0,6,100.0
354420,2015,3,0,0,3,100.0
354420,2016,2,0,0,2,100.0
354420,2017,5,0,0,5,100.0
354420,2018,1,0,0,1,100.0
354420,2019,7,0,0,7,100.0
354420,2020,5,0,0,5,100.0
354425,2012,7,0,0,7,100.0
354425,2013,6,0,0,6,100.0
354425,2014,12,0,0,12,100.0
354425,2015,2,1,1,4,75.0
354425,2016,7,0,0,7,100.0
354425,2017,5,0,1,6,83.33333333333334
354425,2018,1,2,2,5,60.0
354425,2019,4,0,3,7,57.14285714285714
354425,2020,10,0,1,11,90.9090909090909
354430,2012,8,0,0,8,100.0
354430,2013,5,0,0,5,100.0
354430,2014,1,0,0,1,100.0
354430,2015,4,0,0,4,100.0
354430,2016,1,0,1,2,50.0
354430,2017,0,1,6,7,14.285714285714285
354430,2018,3,0,2,5,60.0
354430,2019,0,0,2,2,0.0
354430,2020,1,0,0,1,100.0
354440,2013,1,0,0,1,100.0
354440,2014,2,0,0,2,100.0
354440,2015,1,0,0,1,100.0
354440,2016,2,0,0,2,100.0
354440,2019,1,0,0,1,100.0
354440,2020,1,0,0,1,100.0
354450,2012,1,0,0,1,100.0
354450,2014,1,0,0,1,100.0
354450,2015,1,0,0,1,100.0
354450,2016,1,0,0,1,100.0
354450,2017,1,0,0,1,100.0
354450,2018,3,0,0,3,100.0
354450,2019,1,0,0,1,100.0
354450,2020,1,0,0,1,100.0
354460,2012,2,0,0,2,100.0
354460,2013,4,0,0,4,100.0
354460,2014,0,0,4,4,0.0
354460,2015,2,0,0,2,100.0
354460,2016,5,0,0,5,100.0
354460,2017,2,0,0,2,100.0
354460,2018,3,0,0,3,100.0
354460,2019,5,0,0,5,100.0
354460,2020,5,0,1,6,83.33333333333334
354470,2012,4,0,0,4,100.0
354470,2013,1,0,0,1,100.0
354470,2014,1,0,0,1,100.0
354470,2016,1,0,0,1,100.0
354470,2019,1,0,0,1,100.0
354480,2013,1,0,1,2,50.0
354480,2014,2,0,0,2,100.0
354480,2015,0,0,1,1,0.0
354480,2016,1,2,0,3,100.0
354480,2017,0,1,1,2,50.0
354480,2018,1,0,0,1,100.0
354480,2019,1,0,0,1,100.0
354480,2020,0,1,0,1,100.0
354490,2012,3,0,0,3,100.0
354490,2013,2,0,0,2,100.0
354490,2014,1,0,0,1,100.0
354490,2015,1,0,0,1,100.0
354490,2016,2,0,0,2,100.0
354490,2017,3,0,0,3,100.0
354490,2018,3,0,0,3,100.0
354490,2019,6,0,0,6,100.0
354490,2020,4,0,0,4,100.0
354500,2012,5,0,0,5,100.0
354500,2013,4,0,0,4,100.0
354500,2014,4,0,0,4,100.0
354500,2015,2,0,0,2,100.0
354500,2016,7,0,0,7,100.0
354500,2017,5,0,0,5,100.0
354500,2018,5,0,0,5,100.0
354500,2019,3,0,0,3,100.0
354500,2020,12,0,0,12,100.0
354510,2012,1,0,0,1,100.0
354510,2013,1,0,0,1,100.0
354510,2015,3,0,0,3,100.0
354510,2016,1,0,0,1,100.0
354510,2017,4,0,0,4,100.0
354510,2018,1,0,0,1,100.0
354510,2020,1,0,0,1,100.0
354515,2012,0,2,0,2,100.0
354515,2013,0,3,0,3,100.0
354515,2014,0,4,0,4,100.0
354515,2015,0,0,1,1,0.0
354515,2016,1,1,0,2,100.0
354515,2017,2,0,0,2,100.0
354515,2018,1,0,0,1,100.0
354515,2019,1,0,0,1,100.0
354515,2020,1,0,0,1,100.0
354520,2012,37,0,0,37,100.0
354520,2013,24,0,0,24,100.0
354520,2014,37,0,0,37,100.0
354520,2015,28,0,0,28,100.0
354520,2016,29,0,2,31,93.54838709677419
354520,2017,32,0,0,32,100.0
354520,2018,37,0,0,37,100.0
354520,2019,21,0,0,21,100.0
354520,2020,39,0,0,39,100.0
354530,2012,20,0,1,21,95.23809523809523
354530,2013,16,0,1,17,94.11764705882352
354530,2014,13,0,0,13,100.0
354530,2015,23,0,0,23,100.0
354530,2016,16,0,0,16,100.0
354530,2017,13,0,0,13,100.0
354530,2018,15,0,0,15,100.0
354530,2019,17,0,0,17,100.0
354530,2020,13,0,0,13,100.0
354540,2012,5,1,0,6,100.0
354540,2013,1,0,1,2,50.0
354540,2014,0,0,3,3,0.0
354540,2015,0,0,4,4,0.0
354540,2016,6,0,1,7,85.71428571428571
354540,2017,1,0,2,3,33.33333333333333
354540,2018,7,0,0,7,100.0
354540,2019,4,0,1,5,80.0
354540,2020,3,0,0,3,100.0
354550,2012,0,1,1,2,50.0
354550,2013,0,0,1,1,0.0
354550,2014,2,0,0,2,100.0
354550,2015,2,0,0,2,100.0
354550,2017,3,1,0,4,100.0
354550,2020,1,0,0,1,100.0
354560,2012,3,0,0,3,100.0
354560,2013,13,0,0,13,100.0
354560,2014,5,0,0,5,100.0
354560,2015,5,0,0,5,100.0
354560,2016,6,0,0,6,100.0
354560,2017,4,0,0,4,100.0
354560,2018,4,0,0,4,100.0
354560,2019,5,0,0,5,100.0
354560,2020,6,0,0,6,100.0
354570,2012,2,0,0,2,100.0
354570,2013,5,0,0,5,100.0
354570,2014,2,0,0,2,100.0
354570,2015,1,0,0,1,100.0
354570,2017,1,0,0,1,100.0
354570,2018,2,0,0,2,100.0
354570,2019,2,0,0,2,100.0
354570,2020,2,0,0,2,100.0
354580,2012,68,0,0,68,100.0
354580,2013,64,0,0,64,100.0
354580,2014,47,0,0,47,100.0
354580,2015,54,0,0,54,100.0
354580,2016,40,0,1,41,97.5609756097561
354580,2017,60,0,0,60,100.0
354580,2018,43,0,0,43,100.0
354580,2019,47,0,0,47,100.0
354580,2020,56,0,0,56,100.0
354600,2012,3,0,0,3,100.0
354600,2013,5,0,0,5,100.0
354600,2014,6,0,0,6,100.0
354600,2015,5,0,0,5,100.0
354600,2016,2,0,0,2,100.0
354600,2017,6,0,0,6,100.0
354600,2018,4,0,0,4,100.0
354600,2019,4,0,0,4,100.0
354600,2020,7,0,0,7,100.0
354610,2013,1,0,0,1,100.0
354610,2014,1,0,0,1,100.0
354610,2017,0,0,1,1,0.0
354610,2019,2,0,0,2,100.0
354610,2020,1,0,0,1,100.0
354620,2012,0,2,0,2,100.0
354620,2013,0,0,1,1,0.0
354620,2014,1,0,0,1,100.0
354620,2015,2,0,0,2,100.0
354620,2016,2,0,0,2,100.0
354620,2017,1,0,0,1,100.0
354620,2019,1,0,0,1,100.0
354620,2020,1,0,0,1,100.0
354625,2012,0,0,1,1,0.0
354625,2016,0,0,1,1,0.0
354625,2018,2,0,0,2,100.0
354625,2020,0,0,1,1,0.0
354630,2012,5,0,0,5,100.0
354630,2013,4,0,0,4,100.0
354630,2014,7,0,1,8,87.5
354630,2015,8,0,0,8,100.0
354630,2016,5,0,1,6,83.33333333333334
354630,2017,8,0,0,8,100.0
354630,2018,11,0,0,11,100.0
354630,2019,6,0,1,7,85.71428571428571
354630,2020,11,0,0,11,100.0
354640,2012,7,0,0,7,100.0
354640,2013,7,0,1,8,87.5
354640,2014,12,0,0,12,100.0
354640,2015,10,0,0,10,100.0
354640,2016,11,0,2,13,84.61538461538461
354640,2017,12,0,0,12,100.0
354640,2018,14,0,0,14,100.0
354640,2019,18,0,0,18,100.0
354640,2020,10,0,0,10,100.0
354650,2012,1,0,1,2,50.0
354650,2013,2,0,0,2,100.0
354650,2014,1,0,0,1,100.0
354650,2015,1,0,0,1,100.0
354650,2016,2,0,0,2,100.0
354650,2017,2,0,0,2,100.0
354650,2018,4,0,0,4,100.0
354650,2019,1,0,0,1,100.0
354650,2020,6,0,0,6,100.0
354660,2012,10,0,0,10,100.0
354660,2013,11,0,0,11,100.0
354660,2014,11,0,0,11,100.0
354660,2015,8,0,0,8,100.0
354660,2016,13,0,0,13,100.0
354660,2017,8,0,0,8,100.0
354660,2018,14,0,0,14,100.0
354660,2019,12,0,0,12,100.0
354660,2020,16,0,0,16,100.0
354670,2012,2,2,7,11,36.36363636363637
354670,2013,1,0,7,8,12.5
354670,2014,0,1,2,3,33.33333333333333
354670,2015,1,1,3,5,40.0
354670,2016,6,0,0,6,100.0
354670,2017,4,0,1,5,80.0
354670,2018,5,1,2,8,75.0
354670,2019,7,0,5,12,58.333333333333336
354670,2020,1,0,0,1,100.0
354680,2012,15,0,1,16,93.75
354680,2013,23,0,4,27,85.18518518518519
354680,2014,17,0,3,20,85.0
354680,2015,13,0,1,14,92.85714285714286
354680,2016,16,0,1,17,94.11764705882352
354680,2017,13,0,0,13,100.0
354680,2018,12,0,7,19,63.1578947368421
354680,2019,15,0,2,17,88.23529411764706
354680,2020,24,0,1,25,96.0
354690,2013,2,0,0,2,100.0
354690,2014,5,0,0,5,100.0
354690,2015,0,1,4,5,20.0
354690,2016,0,0,1,1,0.0
354690,2018,1,0,1,2,50.0
354690,2019,1,0,1,2,50.0
354700,2012,2,0,0,2,100.0
354700,2013,2,0,0,2,100.0
354700,2014,2,0,0,2,100.0
354700,2015,2,0,0,2,100.0
354700,2016,3,0,0,3,100.0
354700,2017,2,0,0,2,100.0
354700,2018,1,0,0,1,100.0
354700,2020,1,0,0,1,100.0
354710,2012,3,0,0,3,100.0
354710,2013,1,0,0,1,100.0
354710,2014,1,0,0,1,100.0
354710,2015,1,0,0,1,100.0
354710,2016,1,0,0,1,100.0
354710,2018,1,0,0,1,100.0
354710,2019,1,0,0,1,100.0
354720,2012,1,0,0,1,100.0
354720,2013,4,0,0,4,100.0
354720,2014,2,0,0,2,100.0
354720,2018,1,0,0,1,100.0
354720,2019,1,0,0,1,100.0
354720,2020,1,0,0,1,100.0
354730,2012,31,0,1,32,96.875
354730,2013,32,0,0,32,100.0
354730,2014,36,2,0,38,100.0
354730,2015,34,0,0,34,100.0
354730,2016,43,0,0,43,100.0
354730,2017,44,0,0,44,100.0
354730,2018,38,0,0,38,100.0
354730,2019,44,0,0,44,100.0
354730,2020,38,0,0,38,100.0
354740,2013,1,0,0,1,100.0
354740,2015,1,0,0,1,100.0
354740,2018,1,0,0,1,100.0
354740,2019,2,0,0,2,100.0
354740,2020,2,0,0,2,100.0
354750,2012,14,0,0,14,100.0
354750,2013,7,0,0,7,100.0
354750,2014,5,0,0,5,100.0
354750,2015,7,0,0,7,100.0
354750,2016,7,0,0,7,100.0
354750,2017,5,0,0,5,100.0
354750,2018,11,0,0,11,100.0
354750,2019,5,0,0,5,100.0
354750,2020,7,0,0,7,100.0
354760,2012,7,0,0,7,100.0
354760,2013,5,0,1,6,83.33333333333334
354760,2014,5,0,1,6,83.33333333333334
354760,2015,5,0,0,5,100.0
354760,2016,6,0,0,6,100.0
354760,2017,5,0,0,5,100.0
354760,2018,9,0,0,9,100.0
354760,2019,6,0,0,6,100.0
354760,2020,8,0,0,8,100.0
354765,2018,1,0,0,1,100.0
354765,2020,1,0,0,1,100.0
354770,2012,4,1,0,5,100.0
354770,2013,2,3,6,11,45.45454545454545
354770,2014,4,0,0,4,100.0
354770,2015,5,0,0,5,100.0
354770,2016,7,0,0,7,100.0
354770,2017,3,2,0,5,100.0
354770,2018,5,0,0,5,100.0
354770,2019,6,0,0,6,100.0
354770,2020,9,0,0,9,100.0
354780,2012,166,0,35,201,82.58706467661692
354780,2013,159,7,30,196,84.6938775510204
354780,2014,170,11,39,220,82.27272727272728
354780,2015,205,1,5,211,97.6303317535545
354780,2016,199,0,6,205,97.07317073170731
354780,2017,209,0,0,209,100.0
354780,2018,188,0,0,188,100.0
354780,2019,181,0,4,185,97.83783783783784
354780,2020,224,1,16,241,93.3609958506224
354790,2013,2,0,0,2,100.0
354790,2014,3,0,0,3,100.0
354790,2015,2,0,0,2,100.0
354790,2016,2,0,0,2,100.0
354790,2018,3,0,0,3,100.0
354790,2019,1,0,0,1,100.0
354800,2012,9,0,0,9,100.0
354800,2013,5,0,0,5,100.0
354800,2014,6,0,0,6,100.0
354800,2015,11,0,0,11,100.0
354800,2016,6,0,0,6,100.0
354800,2017,3,0,0,3,100.0
354800,2018,7,0,0,7,100.0
354800,2019,4,0,0,4,100.0
354800,2020,9,0,0,9,100.0
354805,2012,1,0,0,1,100.0
354805,2013,2,0,1,3,66.66666666666666
354805,2014,4,0,0,4,100.0
354805,2015,2,0,0,2,100.0
354805,2016,1,0,0,1,100.0
354805,2017,2,0,0,2,100.0
354805,2018,3,0,3,6,50.0
354805,2019,4,0,0,4,100.0
354805,2020,0,2,1,3,66.66666666666666
354810,2012,3,0,0,3,100.0
354810,2013,2,0,0,2,100.0
354810,2014,2,0,0,2,100.0
354810,2015,2,0,0,2,100.0
354810,2016,3,0,0,3,100.0
354810,2017,1,0,0,1,100.0
354810,2018,1,0,0,1,100.0
354810,2019,1,0,0,1,100.0
354810,2020,2,0,0,2,100.0
354820,2012,3,0,0,3,100.0
354820,2013,1,0,1,2,50.0
354820,2014,2,0,0,2,100.0
354820,2015,3,0,0,3,100.0
354820,2016,1,0,0,1,100.0
354820,2017,1,0,0,1,100.0
354820,2019,0,0,1,1,0.0
354830,2013,1,0,0,1,100.0
354830,2014,1,0,0,1,100.0
354830,2015,1,0,0,1,100.0
354830,2017,1,0,0,1,100.0
354830,2020,0,0,1,1,0.0
354840,2012,1,0,0,1,100.0
354840,2013,1,0,0,1,100.0
354840,2014,1,0,0,1,100.0
354840,2015,2,0,0,2,100.0
354840,2018,0,0,1,1,0.0
354840,2020,1,0,2,3,33.33333333333333
354850,2012,136,0,2,138,98.55072463768117
354850,2013,139,0,0,139,100.0
354850,2014,123,0,1,124,99.19354838709677
354850,2015,120,0,0,120,100.0
354850,2016,120,0,0,120,100.0
354850,2017,126,0,0,126,100.0
354850,2018,103,0,0,103,100.0
354850,2019,119,0,0,119,100.0
354850,2020,147,0,2,149,98.65771812080537
354860,2012,2,0,0,2,100.0
354860,2013,4,0,0,4,100.0
354860,2014,3,0,0,3,100.0
354860,2015,2,0,0,2,100.0
354860,2016,2,0,0,2,100.0
354860,2017,5,0,0,5,100.0
354860,2018,4,0,1,5,80.0
354860,2019,0,0,5,5,0.0
354860,2020,1,0,2,3,33.33333333333333
354870,2012,212,0,7,219,96.80365296803653
354870,2013,185,1,2,188,98.93617021276596
354870,2014,223,0,2,225,99.11111111111111
354870,2015,210,0,0,210,100.0
354870,2016,197,0,3,200,98.5
354870,2017,213,6,11,230,95.21739130434783
354870,2018,198,1,0,199,100.0
354870,2019,195,0,0,195,100.0
354870,2020,234,0,1,235,99.57446808510639
354880,2012,36,0,0,36,100.0
354880,2013,33,0,1,34,97.05882352941177
354880,2014,29,0,1,30,96.66666666666667
354880,2015,26,0,0,26,100.0
354880,2016,35,0,0,35,100.0
354880,2017,29,0,1,30,96.66666666666667
354880,2018,29,0,0,29,100.0
354880,2019,23,0,1,24,95.83333333333334
354880,2020,28,0,2,30,93.33333333333333
354890,2012,70,4,10,84,88.09523809523809
354890,2013,68,0,0,68,100.0
354890,2014,76,0,0,76,100.0
354890,2015,73,0,0,73,100.0
354890,2016,61,0,0,61,100.0
354890,2017,62,0,1,63,98.4126984126984
354890,2018,66,0,0,66,100.0
354890,2019,65,1,3,69,95.65217391304348
354890,2020,53,0,2,55,96.36363636363636
354900,2012,1,0,0,1,100.0
354900,2013,2,0,0,2,100.0
354900,2015,1,0,0,1,100.0
354900,2016,1,0,0,1,100.0
354900,2017,1,0,0,1,100.0
354910,2012,33,0,0,33,100.0
354910,2013,27,1,0,28,100.0
354910,2014,25,0,0,25,100.0
354910,2015,30,0,1,31,96.7741935483871
354910,2016,22,0,0,22,100.0
354910,2017,29,0,1,30,96.66666666666667
354910,2018,26,0,0,26,100.0
354910,2019,34,0,3,37,91.8918918918919
354910,2020,20,0,0,20,100.0
354920,2012,1,0,0,1,100.0
354920,2013,1,0,0,1,100.0
354920,2014,2,0,0,2,100.0
354920,2015,1,0,0,1,100.0
354920,2016,2,0,0,2,100.0
354920,2017,1,0,0,1,100.0
354920,2019,4,0,0,4,100.0
354920,2020,1,0,0,1,100.0
354925,2012,1,0,0,1,100.0
354925,2013,1,0,0,1,100.0
354925,2014,1,0,0,1,100.0
354925,2016,1,0,0,1,100.0
354925,2020,2,0,0,2,100.0
354930,2013,1,0,0,1,100.0
354930,2015,1,0,1,2,50.0
354930,2016,1,0,1,2,50.0
354930,2017,1,0,0,1,100.0
354930,2019,1,1,0,2,100.0
354940,2012,1,6,7,14,50.0
354940,2013,2,6,8,16,50.0
354940,2014,1,13,5,19,73.68421052631578
354940,2015,8,0,2,10,80.0
354940,2016,10,0,0,10,100.0
354940,2017,12,0,0,12,100.0
354940,2018,10,0,0,10,100.0
354940,2019,11,0,3,14,78.57142857142857
354940,2020,9,1,5,15,66.66666666666666
354950,2012,0,0,5,5,0.0
354950,2014,5,0,0,5,100.0
354950,2015,1,0,3,4,25.0
354950,2016,2,0,0,2,100.0
354950,2017,1,0,0,1,100.0
354950,2018,1,0,0,1,100.0
354950,2019,4,0,0,4,100.0
354950,2020,2,0,0,2,100.0
354960,2012,0,0,2,2,0.0
354960,2014,1,0,1,2,50.0
354960,2015,1,0,0,1,100.0
354960,2016,0,0,1,1,0.0
354960,2017,1,0,0,1,100.0
354960,2018,1,0,0,1,100.0
354960,2019,1,0,0,1,100.0
354960,2020,1,0,0,1,100.0
354970,2012,19,0,0,19,100.0
354970,2013,14,0,0,14,100.0
354970,2014,16,0,1,17,94.11764705882352
354970,2015,8,0,0,8,100.0
354970,2016,9,0,0,9,100.0
354970,2017,11,1,0,12,100.0
354970,2018,19,0,0,19,100.0
354970,2019,6,0,0,6,100.0
354970,2020,20,0,0,20,100.0
354980,2012,109,0,0,109,100.0
354980,2013,150,0,0,150,100.0
354980,2014,117,0,0,117,100.0
354980,2015,103,0,0,103,100.0
354980,2016,127,0,0,127,100.0
354980,2017,103,0,0,103,100.0
354980,2018,109,0,0,109,100.0
354980,2019,124,1,0,125,100.0
354980,2020,157,0,0,157,100.0
354990,2012,178,0,0,178,100.0
354990,2013,171,0,0,171,100.0
354990,2014,184,0,0,184,100.0
354990,2015,166,5,6,177,96.61016949152543
354990,2016,187,0,15,202,92.57425742574257
354990,2017,173,0,0,173,100.0
354990,2018,182,1,8,191,95.81151832460732
354990,2019,160,2,9,171,94.73684210526315
354990,2020,183,1,10,194,94.84536082474226
354995,2012,4,0,0,4,100.0
354995,2013,6,0,0,6,100.0
354995,2014,3,0,1,4,75.0
354995,2015,6,0,0,6,100.0
354995,2016,6,0,0,6,100.0
354995,2017,6,0,0,6,100.0
354995,2018,6,0,0,6,100.0
354995,2019,5,0,0,5,100.0
354995,2020,2,0,0,2,100.0
355000,2012,3,0,3,6,50.0
355000,2013,3,0,0,3,100.0
355000,2014,3,0,3,6,50.0
355000,2015,0,2,3,5,40.0
355000,2016,4,0,0,4,100.0
355000,2017,5,0,0,5,100.0
355000,2018,5,0,0,5,100.0
355000,2019,2,0,2,4,50.0
355000,2020,2,0,0,2,100.0
355010,2012,9,0,0,9,100.0
355010,2013,10,0,0,10,100.0
355010,2014,12,1,0,13,100.0
355010,2015,13,0,0,13,100.0
355010,2016,18,0,0,18,100.0
355010,2017,17,0,0,17,100.0
355010,2018,12,0,0,12,100.0
355010,2019,16,0,0,16,100.0
355010,2020,16,0,0,16,100.0
355020,2012,11,0,0,11,100.0
355020,2013,14,0,1,15,93.33333333333333
355020,2014,15,0,1,16,93.75
355020,2015,4,0,0,4,100.0
355020,2016,9,0,0,9,100.0
355020,2017,10,0,1,11,90.9090909090909
355020,2018,14,0,0,14,100.0
355020,2019,10,0,0,10,100.0
355020,2020,6,0,0,6,100.0
355030,2012,3301,55,200,3556,94.37570303712036
355030,2013,3277,31,130,3438,96.21873182082606
355030,2014,3425,29,73,3527,97.93025233909839
355030,2015,3321,63,131,3515,96.27311522048365
355030,2016,3345,28,165,3538,95.33634821933296
355030,2017,2684,94,495,3273,84.87626031164069
355030,2018,2237,196,858,3291,73.92889699179581
355030,2019,2254,51,1063,3368,68.43824228028504
355030,2020,1283,201,2536,4020,36.91542288557214
355040,2012,7,0,0,7,100.0
355040,2013,16,0,0,16,100.0
355040,2014,11,0,0,11,100.0
355040,2015,17,0,0,17,100.0
355040,2016,11,0,0,11,100.0
355040,2017,6,0,0,6,100.0
355040,2018,9,0,0,9,100.0
355040,2019,11,0,0,11,100.0
355040,2020,12,0,0,12,100.0
355050,2012,0,1,1,2,50.0
355050,2013,0,0,2,2,0.0
355050,2014,4,0,0,4,100.0
355050,2015,4,0,0,4,100.0
355050,2016,2,0,1,3,66.66666666666666
355050,2017,3,0,2,5,60.0
355050,2018,1,0,0,1,100.0
355050,2019,1,0,0,1,100.0
355050,2020,0,0,2,2,0.0
355060,2012,24,0,1,25,96.0
355060,2013,14,0,0,14,100.0
355060,2014,20,0,0,20,100.0
355060,2015,29,0,1,30,96.66666666666667
355060,2016,30,0,0,30,100.0
355060,2017,23,0,0,23,100.0
355060,2018,20,0,0,20,100.0
355060,2019,24,0,0,24,100.0
355060,2020,25,0,0,25,100.0
355070,2012,19,0,0,19,100.0
355070,2013,27,0,1,28,96.42857142857143
355070,2014,30,0,0,30,100.0
355070,2015,28,0,0,28,100.0
355070,2016,36,0,0,36,100.0
355070,2017,20,0,0,20,100.0
355070,2018,27,0,0,27,100.0
355070,2019,17,0,0,17,100.0
355070,2020,16,0,0,16,100.0
355080,2012,3,0,0,3,100.0
355080,2013,2,0,0,2,100.0
355080,2014,4,0,0,4,100.0
355080,2015,2,0,0,2,100.0
355080,2016,1,0,1,2,50.0
355080,2017,2,0,0,2,100.0
355080,2018,4,0,0,4,100.0
355080,2019,1,0,0,1,100.0
355090,2012,6,0,0,6,100.0
355090,2013,5,0,0,5,100.0
355090,2014,4,0,0,4,100.0
355090,2015,4,0,0,4,100.0
355090,2016,2,0,0,2,100.0
355090,2017,3,0,0,3,100.0
355090,2018,2,0,0,2,100.0
355090,2019,7,0,0,7,100.0
355090,2020,7,0,0,7,100.0
355100,2012,126,0,1,127,99.21259842519686
355100,2013,133,1,1,135,99.25925925925925
355100,2014,129,0,1,130,99.23076923076923
355100,2015,120,0,1,121,99.17355371900827
355100,2016,127,0,0,127,100.0
355100,2017,138,0,0,138,100.0
355100,2018,120,0,0,120,100.0
355100,2019,145,0,0,145,100.0
355100,2020,160,0,0,160,100.0
355110,2012,0,0,3,3,0.0
355110,2013,1,0,3,4,25.0
355110,2014,0,0,5,5,0.0
355110,2016,0,0,4,4,0.0
355110,2017,0,0,4,4,0.0
355110,2018,1,0,1,2,50.0
355110,2019,0,0,2,2,0.0
355110,2020,0,0,4,4,0.0
355120,2013,0,1,2,3,33.33333333333333
355120,2015,1,0,0,1,100.0
355120,2016,3,0,0,3,100.0
355120,2017,1,0,0,1,100.0
355120,2018,1,0,0,1,100.0
355120,2019,1,0,2,3,33.33333333333333
355120,2020,1,0,3,4,25.0
355130,2013,1,0,0,1,100.0
355130,2014,1,0,0,1,100.0
355130,2016,1,0,0,1,100.0
355130,2017,3,0,0,3,100.0
355130,2018,1,1,1,3,66.66666666666666
355130,2019,1,0,0,1,100.0
355140,2012,0,0,2,2,0.0
355140,2013,5,0,0,5,100.0
355140,2014,4,0,0,4,100.0
355140,2015,5,0,0,5,100.0
355140,2016,2,0,0,2,100.0
355140,2017,3,0,0,3,100.0
355140,2018,4,0,1,5,80.0
355140,2019,6,0,0,6,100.0
355140,2020,2,0,0,2,100.0
355150,2012,17,0,0,17,100.0
355150,2013,12,0,0,12,100.0
355150,2014,13,0,0,13,100.0
355150,2015,13,0,0,13,100.0
355150,2016,16,0,0,16,100.0
355150,2017,8,0,0,8,100.0
355150,2018,9,0,0,9,100.0
355150,2019,17,0,0,17,100.0
355150,2020,22,0,0,22,100.0
355160,2012,5,0,0,5,100.0
355160,2013,3,0,0,3,100.0
355160,2014,2,0,4,6,33.33333333333333
355160,2015,3,0,0,3,100.0
355160,2016,9,0,0,9,100.0
355160,2017,8,0,0,8,100.0
355160,2018,5,0,0,5,100.0
355160,2019,6,0,0,6,100.0
355160,2020,6,0,0,6,100.0
355170,2012,33,0,0,33,100.0
355170,2013,34,0,0,34,100.0
355170,2014,35,0,0,35,100.0
355170,2015,47,0,0,47,100.0
355170,2016,22,1,12,35,65.71428571428571
355170,2017,27,0,0,27,100.0
355170,2018,33,0,0,33,100.0
355170,2019,43,0,0,43,100.0
355170,2020,40,0,0,40,100.0
355180,2012,5,0,1,6,83.33333333333334
355180,2013,6,0,1,7,85.71428571428571
355180,2014,8,0,0,8,100.0
355180,2015,6,0,2,8,75.0
355180,2016,5,0,2,7,71.42857142857143
355180,2017,2,0,0,2,100.0
355180,2018,5,0,0,5,100.0
355180,2019,2,1,3,6,50.0
355180,2020,2,0,1,3,66.66666666666666
355190,2012,4,0,0,4,100.0
355190,2013,2,0,0,2,100.0
355190,2014,7,0,0,7,100.0
355190,2015,9,0,0,9,100.0
355190,2016,6,0,0,6,100.0
355190,2018,4,0,1,5,80.0
355190,2019,5,0,0,5,100.0
355190,2020,9,1,0,10,100.0
355200,2012,1,0,0,1,100.0
355200,2013,2,0,0,2,100.0
355200,2015,0,0,3,3,0.0
355200,2017,1,0,2,3,33.33333333333333
355200,2018,1,0,0,1,100.0
355200,2019,5,0,1,6,83.33333333333334
355200,2020,0,0,1,1,0.0
355210,2012,7,0,0,7,100.0
355210,2013,6,0,0,6,100.0
355210,2014,9,0,0,9,100.0
355210,2015,9,0,0,9,100.0
355210,2016,8,0,0,8,100.0
355210,2017,8,0,0,8,100.0
355210,2018,8,0,0,8,100.0
355210,2019,7,0,1,8,87.5
355210,2020,10,0,0,10,100.0
355220,2012,181,1,15,197,92.38578680203045
355220,2013,98,13,89,200,55.50000000000001
355220,2014,102,4,74,180,58.88888888888889
355220,2015,182,2,3,187,98.3957219251337
355220,2016,199,3,10,212,95.28301886792453
355220,2017,171,2,27,200,86.5
355220,2018,160,3,39,202,80.6930693069307
355220,2019,168,8,41,217,81.10599078341014
355220,2020,168,7,53,228,76.75438596491229
355230,2012,2,0,0,2,100.0
355230,2013,8,0,0,8,100.0
355230,2014,1,0,0,1,100.0
355230,2015,2,0,0,2,100.0
355230,2016,6,0,0,6,100.0
355230,2017,3,0,0,3,100.0
355230,2018,1,0,0,1,100.0
355230,2019,3,0,0,3,100.0
355230,2020,2,0,0,2,100.0
355240,2012,45,5,12,62,80.64516129032258
355240,2013,73,2,11,86,87.20930232558139
355240,2014,74,1,2,77,97.40259740259741
355240,2015,76,2,7,85,91.76470588235294
355240,2016,60,0,0,60,100.0
355240,2017,69,0,0,69,100.0
355240,2018,67,0,0,67,100.0
355240,2019,62,0,0,62,100.0
355240,2020,106,0,1,107,99.06542056074767
355250,2012,73,0,2,75,97.33333333333334
355250,2013,95,0,1,96,98.95833333333334
355250,2014,92,0,0,92,100.0
355250,2015,100,0,0,100,100.0
355250,2016,121,0,1,122,99.18032786885246
355250,2017,92,0,0,92,100.0
355250,2018,87,1,0,88,100.0
355250,2019,85,0,0,85,100.0
355250,2020,123,1,0,124,100.0
355255,2012,1,0,0,1,100.0
355255,2014,1,0,0,1,100.0
355255,2016,1,0,0,1,100.0
355255,2018,1,0,1,2,50.0
355255,2020,1,0,1,2,50.0
355260,2012,5,0,0,5,100.0
355260,2013,6,0,0,6,100.0
355260,2014,3,0,0,3,100.0
355260,2015,2,0,0,2,100.0
355260,2016,10,0,0,10,100.0
355260,2017,2,0,0,2,100.0
355260,2018,3,0,0,3,100.0
355260,2019,2,0,0,2,100.0
355260,2020,5,0,0,5,100.0
355270,2012,4,0,0,4,100.0
355270,2013,6,0,0,6,100.0
355270,2014,7,0,0,7,100.0
355270,2015,6,0,0,6,100.0
355270,2016,9,0,0,9,100.0
355270,2017,6,0,0,6,100.0
355270,2018,5,0,0,5,100.0
355270,2019,5,0,0,5,100.0
355270,2020,5,0,0,5,100.0
355280,2012,82,4,8,94,91.48936170212765
355280,2013,82,4,3,89,96.62921348314607
355280,2014,99,1,5,105,95.23809523809523
355280,2015,93,2,3,98,96.93877551020408
355280,2016,92,0,1,93,98.9247311827957
355280,2017,95,0,3,98,96.93877551020408
355280,2018,81,1,0,82,100.0
355280,2019,87,0,1,88,98.86363636363636
355280,2020,116,0,0,116,100.0
355290,2012,0,1,0,1,100.0
355290,2013,0,0,1,1,0.0
355290,2014,0,0,2,2,0.0
355290,2015,0,0,6,6,0.0
355290,2016,1,0,0,1,100.0
355290,2017,4,0,0,4,100.0
355290,2018,3,0,0,3,100.0
355290,2019,2,0,0,2,100.0
355290,2020,1,0,0,1,100.0
355300,2012,4,0,0,4,100.0
355300,2013,2,0,0,2,100.0
355300,2014,3,0,0,3,100.0
355300,2015,3,0,0,3,100.0
355300,2016,1,0,0,1,100.0
355300,2017,3,0,0,3,100.0
355300,2018,3,0,0,3,100.0
355300,2019,4,0,0,4,100.0
355300,2020,6,0,1,7,85.71428571428571
355310,2012,4,0,0,4,100.0
355310,2013,1,0,0,1,100.0
355310,2014,2,0,0,2,100.0
355310,2015,4,0,0,4,100.0
355310,2016,3,0,0,3,100.0
355310,2018,4,0,0,4,100.0
355310,2019,3,0,0,3,100.0
355310,2020,4,0,0,4,100.0
355320,2012,1,0,0,1,100.0
355320,2013,2,0,1,3,66.66666666666666
355320,2014,1,0,1,2,50.0
355320,2015,1,1,0,2,100.0
355320,2017,1,0,0,1,100.0
355320,2018,1,0,0,1,100.0
355320,2019,1,0,0,1,100.0
355330,2012,7,0,0,7,100.0
355330,2013,9,0,1,10,90.0
355330,2014,3,0,0,3,100.0
355330,2015,9,0,0,9,100.0
355330,2016,11,0,0,11,100.0
355330,2017,6,0,0,6,100.0
355330,2018,4,0,0,4,100.0
355330,2019,5,0,0,5,100.0
355330,2020,5,0,0,5,100.0
355340,2012,11,0,0,11,100.0
355340,2013,6,0,0,6,100.0
355340,2014,5,0,1,6,83.33333333333334
355340,2015,8,0,0,8,100.0
355340,2016,8,0,0,8,100.0
355340,2017,5,0,0,5,100.0
355340,2018,9,0,0,9,100.0
355340,2019,10,0,0,10,100.0
355340,2020,12,0,0,12,100.0
355350,2012,0,0,4,4,0.0
355350,2013,0,0,2,2,0.0
355350,2014,0,0,2,2,0.0
355350,2015,0,0,3,3,0.0
355350,2016,0,0,1,1,0.0
355350,2017,0,0,4,4,0.0
355350,2018,0,1,2,3,33.33333333333333
355350,2019,0,0,1,1,0.0
355350,2020,0,1,1,2,50.0
355360,2012,4,0,0,4,100.0
355360,2013,3,0,0,3,100.0
355360,2014,4,0,1,5,80.0
355360,2015,9,0,0,9,100.0
355360,2016,3,0,0,3,100.0
355360,2018,5,0,0,5,100.0
355360,2019,3,0,0,3,100.0
355360,2020,5,0,0,5,100.0
355365,2012,0,1,1,2,50.0
355365,2013,1,0,0,1,100.0
355365,2014,1,0,0,1,100.0
355365,2015,1,0,0,1,100.0
355365,2017,2,0,2,4,50.0
355365,2019,1,0,0,1,100.0
355365,2020,0,1,0,1,100.0
355370,2012,26,0,0,26,100.0
355370,2013,9,0,0,9,100.0
355370,2014,25,0,0,25,100.0
355370,2015,21,0,0,21,100.0
355370,2016,13,0,0,13,100.0
355370,2017,15,0,0,15,100.0
355370,2018,17,0,0,17,100.0
355370,2019,17,0,0,17,100.0
355370,2020,19,0,0,19,100.0
355380,2012,11,1,0,12,100.0
355380,2013,12,0,0,12,100.0
355380,2014,11,2,0,13,100.0
355380,2015,11,0,0,11,100.0
355380,2016,6,0,0,6,100.0
355380,2017,3,0,0,3,100.0
355380,2018,4,0,0,4,100.0
355380,2019,1,0,0,1,100.0
355380,2020,7,0,1,8,87.5
355385,2012,1,0,0,1,100.0
355385,2013,0,0,1,1,0.0
355385,2015,3,0,0,3,100.0
355385,2017,1,0,0,1,100.0
355385,2018,3,0,0,3,100.0
355385,2019,2,0,0,2,100.0
355385,2020,2,0,0,2,100.0
355390,2012,3,0,0,3,100.0
355390,2013,1,0,0,1,100.0
355390,2014,3,0,0,3,100.0
355390,2015,2,0,0,2,100.0
355390,2016,4,0,0,4,100.0
355390,2017,1,0,0,1,100.0
355390,2018,1,0,0,1,100.0
355390,2019,2,0,0,2,100.0
355395,2012,0,1,3,4,25.0
355395,2013,0,0,4,4,0.0
355395,2014,0,0,6,6,0.0
355395,2015,1,0,4,5,20.0
355395,2016,6,0,0,6,100.0
355395,2017,5,0,0,5,100.0
355395,2018,4,0,0,4,100.0
355395,2019,5,0,0,5,100.0
355395,2020,8,0,0,8,100.0
355400,2012,37,0,0,37,100.0
355400,2013,54,0,0,54,100.0
355400,2014,37,0,2,39,94.87179487179486
355400,2015,33,0,1,34,97.05882352941177
355400,2016,33,1,1,35,97.14285714285714
355400,2017,28,1,0,29,100.0
355400,2018,36,0,0,36,100.0
355400,2019,44,0,0,44,100.0
355400,2020,41,0,0,41,100.0
355410,2012,67,6,12,85,85.88235294117646
355410,2013,70,3,20,93,78.49462365591397
355410,2014,92,0,6,98,93.87755102040816
355410,2015,65,0,7,72,90.27777777777779
355410,2016,75,1,14,90,84.44444444444444
355410,2017,64,0,3,67,95.52238805970148
355410,2018,83,0,0,83,100.0
355410,2019,67,0,0,67,100.0
355410,2020,69,0,7,76,90.78947368421053
355420,2012,6,0,0,6,100.0
355420,2013,2,0,0,2,100.0
355420,2014,3,0,0,3,100.0
355420,2015,2,0,0,2,100.0
355420,2016,1,0,0,1,100.0
355420,2019,1,0,0,1,100.0
355420,2020,1,0,0,1,100.0
355430,2012,3,0,0,3,100.0
355430,2013,8,0,0,8,100.0
355430,2014,9,0,0,9,100.0
355430,2015,10,0,0,10,100.0
355430,2016,15,0,0,15,100.0
355430,2017,8,0,0,8,100.0
355430,2018,6,0,0,6,100.0
355430,2019,10,0,0,10,100.0
355430,2020,12,0,0,12,100.0
355440,2012,3,0,0,3,100.0
355440,2013,1,0,0,1,100.0
355440,2014,3,0,0,3,100.0
355440,2015,3,0,0,3,100.0
355440,2016,2,0,0,2,100.0
355440,2017,3,0,0,3,100.0
355440,2018,0,1,0,1,100.0
355440,2019,1,0,0,1,100.0
355440,2020,5,0,0,5,100.0
355450,2012,16,0,1,17,94.11764705882352
355450,2013,10,1,2,13,84.61538461538461
355450,2014,1,9,3,13,76.92307692307693
355450,2015,1,5,3,9,66.66666666666666
355450,2016,0,13,4,17,76.47058823529412
355450,2017,0,4,4,8,50.0
355450,2018,12,0,1,13,92.3076923076923
355450,2019,1,5,6,12,50.0
355450,2020,12,0,1,13,92.3076923076923
355460,2012,1,1,1,3,66.66666666666666
355460,2013,0,0,2,2,0.0
355460,2014,0,1,2,3,33.33333333333333
355460,2018,0,0,1,1,0.0
355460,2019,0,0,1,1,0.0
355460,2020,0,0,1,1,0.0
355465,2012,1,0,0,1,100.0
355465,2013,1,0,0,1,100.0
355465,2014,2,0,0,2,100.0
355465,2016,1,0,0,1,100.0
355465,2018,2,0,0,2,100.0
355470,2012,6,0,1,7,85.71428571428571
355470,2013,3,0,0,3,100.0
355470,2014,1,0,1,2,50.0
355470,2015,1,1,0,2,100.0
355470,2018,5,0,0,5,100.0
355470,2019,1,0,0,1,100.0
355470,2020,1,0,0,1,100.0
355475,2012,1,0,0,1,100.0
355475,2015,1,0,0,1,100.0
355475,2016,2,0,0,2,100.0
355475,2019,1,0,0,1,100.0
355480,2012,14,1,0,15,100.0
355480,2013,16,0,0,16,100.0
355480,2014,14,0,1,15,93.33333333333333
355480,2015,18,0,0,18,100.0
355480,2016,7,2,0,9,100.0
355480,2017,15,0,0,15,100.0
355480,2018,6,0,2,8,75.0
355480,2019,1,5,8,14,42.857142857142854
355480,2020,7,0,6,13,53.84615384615385
355490,2012,2,0,0,2,100.0
355490,2013,1,0,1,2,50.0
355490,2014,2,0,0,2,100.0
355490,2015,5,0,0,5,100.0
355490,2016,4,0,0,4,100.0
355490,2017,2,0,0,2,100.0
355490,2019,1,0,0,1,100.0
355490,2020,3,0,0,3,100.0
355495,2012,1,0,0,1,100.0
355495,2013,2,0,0,2,100.0
355495,2014,3,0,0,3,100.0
355495,2015,1,0,0,1,100.0
355495,2017,1,0,0,1,100.0
355495,2018,1,0,0,1,100.0
355495,2019,1,0,0,1,100.0
355495,2020,1,0,0,1,100.0
355500,2012,21,0,0,21,100.0
355500,2013,15,0,0,15,100.0
355500,2014,19,0,0,19,100.0
355500,2015,23,0,0,23,100.0
355500,2016,27,0,0,27,100.0
355500,2017,22,0,0,22,100.0
355500,2018,24,0,0,24,100.0
355500,2019,15,0,0,15,100.0
355500,2020,17,0,0,17,100.0
355510,2012,3,0,0,3,100.0
355510,2013,8,0,0,8,100.0
355510,2014,7,0,0,7,100.0
355510,2015,8,0,0,8,100.0
355510,2016,4,0,0,4,100.0
355510,2017,3,0,0,3,100.0
355510,2018,5,0,0,5,100.0
355510,2019,4,0,0,4,100.0
355510,2020,4,0,0,4,100.0
355520,2012,1,0,0,1,100.0
355520,2013,2,0,0,2,100.0
355520,2017,1,0,0,1,100.0
355520,2018,1,0,0,1,100.0
355530,2012,1,0,0,1,100.0
355530,2013,1,0,0,1,100.0
355530,2014,1,0,0,1,100.0
355530,2019,1,0,0,1,100.0
355530,2020,1,0,0,1,100.0
355535,2012,1,0,0,1,100.0
355535,2013,0,1,0,1,100.0
355535,2014,1,0,0,1,100.0
355535,2015,3,0,0,3,100.0
355535,2019,1,0,0,1,100.0
355535,2020,2,0,0,2,100.0
355540,2012,21,0,0,21,100.0
355540,2013,20,0,7,27,74.07407407407408
355540,2014,28,0,8,36,77.77777777777779
355540,2015,30,0,0,30,100.0
355540,2016,25,0,0,25,100.0
355540,2017,32,1,1,34,97.05882352941177
355540,2018,23,0,2,25,92.0
355540,2019,31,0,0,31,100.0
355540,2020,32,0,3,35,91.42857142857143
355550,2012,2,0,0,2,100.0
355550,2013,1,0,0,1,100.0
355550,2014,1,0,0,1,100.0
355550,2015,4,0,0,4,100.0
355550,2016,3,0,0,3,100.0
355550,2017,3,0,0,3,100.0
355550,2020,1,0,0,1,100.0
355560,2012,1,0,0,1,100.0
355560,2013,1,0,0,1,100.0
355560,2014,2,0,0,2,100.0
355560,2015,4,0,0,4,100.0
355560,2016,1,0,0,1,100.0
355560,2017,1,1,2,4,50.0
355560,2018,1,0,0,1,100.0
355560,2019,3,0,0,3,100.0
355560,2020,3,0,0,3,100.0
355570,2012,1,0,0,1,100.0
355570,2013,1,0,0,1,100.0
355570,2015,2,0,0,2,100.0
355570,2016,1,0,0,1,100.0
355570,2020,1,0,0,1,100.0
355580,2012,1,0,0,1,100.0
355580,2013,4,0,0,4,100.0
355580,2014,2,0,0,2,100.0
355580,2015,2,0,0,2,100.0
355580,2016,4,0,0,4,100.0
355580,2017,4,0,0,4,100.0
355580,2018,4,0,0,4,100.0
355580,2019,3,0,0,3,100.0
355580,2020,4,0,0,4,100.0
355590,2013,0,0,1,1,0.0
355590,2014,1,0,1,2,50.0
355590,2016,1,2,0,3,100.0
355600,2012,4,0,0,4,100.0
355600,2013,5,0,0,5,100.0
355600,2014,6,0,0,6,100.0
355600,2015,3,0,0,3,100.0
355600,2016,2,0,2,4,50.0
355600,2017,10,0,0,10,100.0
355600,2018,0,0,1,1,0.0
355600,2020,6,0,0,6,100.0
355610,2013,3,0,0,3,100.0
355610,2014,2,0,0,2,100.0
355610,2015,4,0,0,4,100.0
355610,2016,0,0,2,2,0.0
355610,2017,1,0,1,2,50.0
355610,2018,1,1,2,4,50.0
355610,2019,0,4,2,6,66.66666666666666
355610,2020,2,2,1,5,80.0
355620,2012,32,0,0,32,100.0
355620,2013,27,0,0,27,100.0
355620,2014,20,1,0,21,100.0
355620,2015,26,0,0,26,100.0
355620,2016,29,0,0,29,100.0
355620,2017,25,0,0,25,100.0
355620,2018,18,0,0,18,100.0
355620,2019,42,0,0,42,100.0
355620,2020,33,0,1,34,97.05882352941177
355630,2012,8,0,0,8,100.0
355630,2013,7,0,1,8,87.5
355630,2014,13,0,0,13,100.0
355630,2015,5,0,0,5,100.0
355630,2016,6,0,0,6,100.0
355630,2017,4,0,0,4,100.0
355630,2018,9,0,0,9,100.0
355630,2019,4,0,0,4,100.0
355630,2020,8,0,0,8,100.0
355635,2012,1,0,0,1,100.0
355635,2013,1,0,0,1,100.0
355635,2014,2,0,1,3,66.66666666666666
355635,2015,1,0,2,3,33.33333333333333
355635,2016,0,1,0,1,100.0
355635,2017,3,0,0,3,100.0
355635,2018,4,0,0,4,100.0
355635,2019,1,0,2,3,33.33333333333333
355635,2020,2,0,1,3,66.66666666666666
355640,2012,12,0,0,12,100.0
355640,2013,13,0,0,13,100.0
355640,2014,10,0,1,11,90.9090909090909
355640,2015,16,0,0,16,100.0
355640,2016,13,0,0,13,100.0
355640,2017,10,0,0,10,100.0
355640,2018,15,0,0,15,100.0
355640,2019,12,0,0,12,100.0
355640,2020,10,0,0,10,100.0
355645,2012,13,0,0,13,100.0
355645,2013,14,0,0,14,100.0
355645,2014,14,0,1,15,93.33333333333333
355645,2015,9,0,0,9,100.0
355645,2016,14,0,0,14,100.0
355645,2017,13,0,1,14,92.85714285714286
355645,2018,9,0,1,10,90.0
355645,2019,17,0,1,18,94.44444444444444
355645,2020,13,0,0,13,100.0
355650,2012,28,0,0,28,100.0
355650,2013,35,0,0,35,100.0
355650,2014,34,0,0,34,100.0
355650,2015,32,0,0,32,100.0
355650,2016,31,0,0,31,100.0
355650,2017,27,0,0,27,100.0
355650,2018,28,0,0,28,100.0
355650,2019,30,0,0,30,100.0
355650,2020,35,0,0,35,100.0
355660,2012,3,0,1,4,75.0
355660,2013,2,0,0,2,100.0
355660,2014,2,0,0,2,100.0
355660,2015,2,0,0,2,100.0
355660,2016,7,0,0,7,100.0
355660,2017,4,0,0,4,100.0
355660,2018,3,0,0,3,100.0
355660,2019,2,0,0,2,100.0
355660,2020,1,0,0,1,100.0
355670,2012,15,0,0,15,100.0
355670,2013,18,0,0,18,100.0
355670,2014,11,0,0,11,100.0
355670,2015,24,0,0,24,100.0
355670,2016,20,0,0,20,100.0
355670,2017,13,0,0,13,100.0
355670,2018,14,0,0,14,100.0
355670,2019,13,0,0,13,100.0
355670,2020,26,0,0,26,100.0
355680,2012,6,0,0,6,100.0
355680,2013,8,2,0,10,100.0
355680,2014,5,0,0,5,100.0
355680,2015,2,0,1,3,66.66666666666666
355680,2016,3,0,0,3,100.0
355680,2017,2,0,0,2,100.0
355680,2018,5,0,0,5,100.0
355680,2019,10,0,0,10,100.0
355680,2020,3,0,0,3,100.0
355690,2012,3,0,0,3,100.0
355690,2013,2,0,0,2,100.0
355690,2014,4,0,0,4,100.0
355690,2015,1,0,0,1,100.0
355690,2016,3,0,0,3,100.0
355690,2017,3,0,0,3,100.0
355690,2018,1,0,2,3,33.33333333333333
355690,2019,2,0,0,2,100.0
355695,2012,2,0,0,2,100.0
355695,2013,1,0,0,1,100.0
355695,2015,1,0,0,1,100.0
355695,2019,1,0,0,1,100.0
355700,2012,42,0,0,42,100.0
355700,2013,37,0,2,39,94.87179487179486
355700,2014,31,0,1,32,96.875
355700,2015,26,0,7,33,78.78787878787878
355700,2016,33,0,3,36,91.66666666666666
355700,2017,34,0,4,38,89.47368421052632
355700,2018,41,0,0,41,100.0
355700,2019,31,0,0,31,100.0
355700,2020,45,0,0,45,100.0
355710,2012,33,0,1,34,97.05882352941177
355710,2013,36,0,0,36,100.0
355710,2014,32,0,1,33,96.96969696969697
355710,2015,27,0,0,27,100.0
355710,2016,20,0,0,20,100.0
355710,2017,22,0,0,22,100.0
355710,2018,20,0,0,20,100.0
355710,2019,21,0,0,21,100.0
355710,2020,35,0,0,35,100.0
355715,2016,2,0,0,2,100.0
355715,2019,1,0,0,1,100.0
355715,2020,3,0,0,3,100.0
355720,2012,3,0,0,3,100.0
355720,2013,6,0,0,6,100.0
355720,2014,3,0,0,3,100.0
355720,2015,6,0,0,6,100.0
355720,2016,4,0,0,4,100.0
355720,2017,3,0,0,3,100.0
355720,2018,2,0,0,2,100.0
355720,2019,5,0,0,5,100.0
355720,2020,5,0,0,5,100.0
355730,2012,5,0,0,5,100.0
355730,2013,6,0,0,6,100.0
355730,2014,5,0,1,6,83.33333333333334
355730,2015,4,0,1,5,80.0
355730,2017,1,0,0,1,100.0
355730,2018,2,0,0,2,100.0
355730,2019,3,0,0,3,100.0
355730,2020,4,0,0,4,100.0
410000,2012,1,0,0,1,100.0
410000,2013,0,1,0,1,100.0
410000,2014,1,1,0,2,100.0
410000,2015,0,0,1,1,0.0
410000,2016,0,3,0,3,100.0
410000,2017,0,2,0,2,100.0
410000,2018,0,2,0,2,100.0
410000,2020,0,0,1,1,0.0
410010,2012,3,0,0,3,100.0
410010,2013,4,0,0,4,100.0
410010,2014,1,0,0,1,100.0
410010,2015,0,0,1,1,0.0
410010,2016,2,0,0,2,100.0
410010,2017,1,0,0,1,100.0
410010,2018,2,0,0,2,100.0
410010,2019,2,0,0,2,100.0
410010,2020,1,0,0,1,100.0
410020,2012,1,0,0,1,100.0
410020,2013,5,0,0,5,100.0
410020,2014,3,0,0,3,100.0
410020,2015,3,0,0,3,100.0
410020,2016,3,0,0,3,100.0
410020,2018,1,0,0,1,100.0
410020,2019,2,0,0,2,100.0
410020,2020,2,1,0,3,100.0
410030,2012,3,0,0,3,100.0
410030,2013,1,0,0,1,100.0
410030,2014,8,0,0,8,100.0
410030,2015,4,0,0,4,100.0
410030,2017,5,0,0,5,100.0
410030,2018,2,0,0,2,100.0
410030,2020,1,0,0,1,100.0
410040,2012,39,0,0,39,100.0
410040,2013,51,0,0,51,100.0
410040,2014,34,0,0,34,100.0
410040,2015,37,0,0,37,100.0
410040,2016,37,0,1,38,97.36842105263158
410040,2017,43,0,0,43,100.0
410040,2018,33,0,0,33,100.0
410040,2019,36,3,0,39,100.0
410040,2020,35,0,0,35,100.0
410045,2012,1,0,0,1,100.0
410045,2013,1,0,0,1,100.0
410045,2015,1,0,0,1,100.0
410045,2016,1,0,0,1,100.0
410045,2017,1,0,0,1,100.0
410045,2018,1,0,0,1,100.0
410045,2019,1,0,0,1,100.0
410045,2020,2,0,0,2,100.0
410050,2012,4,0,0,4,100.0
410050,2013,6,0,0,6,100.0
410050,2014,6,0,0,6,100.0
410050,2015,8,0,0,8,100.0
410050,2016,9,0,0,9,100.0
410050,2017,8,0,0,8,100.0
410050,2018,8,0,0,8,100.0
410050,2019,6,0,0,6,100.0
410050,2020,7,0,0,7,100.0
410060,2012,4,0,0,4,100.0
410060,2013,4,0,0,4,100.0
410060,2014,4,0,0,4,100.0
410060,2015,5,0,0,5,100.0
410060,2016,3,0,0,3,100.0
410060,2017,2,0,0,2,100.0
410060,2018,5,0,0,5,100.0
410060,2019,4,0,0,4,100.0
410060,2020,7,0,0,7,100.0
410070,2012,6,0,0,6,100.0
410070,2013,3,0,0,3,100.0
410070,2014,8,0,0,8,100.0
410070,2015,3,0,0,3,100.0
410070,2016,3,0,0,3,100.0
410070,2017,6,0,0,6,100.0
410070,2018,2,0,0,2,100.0
410070,2019,4,0,0,4,100.0
410070,2020,4,0,0,4,100.0
410080,2012,2,0,0,2,100.0
410080,2013,3,0,0,3,100.0
410080,2014,4,0,0,4,100.0
410080,2015,1,0,0,1,100.0
410080,2016,2,0,0,2,100.0
410080,2017,4,0,0,4,100.0
410080,2018,1,0,0,1,100.0
410080,2019,1,0,0,1,100.0
410080,2020,3,0,0,3,100.0
410090,2012,5,0,0,5,100.0
410090,2013,1,0,0,1,100.0
410090,2014,4,0,0,4,100.0
410090,2015,4,0,0,4,100.0
410090,2017,3,0,0,3,100.0
410090,2018,5,0,0,5,100.0
410090,2019,1,0,0,1,100.0
410090,2020,3,0,0,3,100.0
410100,2012,7,0,0,7,100.0
410100,2013,2,0,0,2,100.0
410100,2014,4,0,0,4,100.0
410100,2015,2,0,0,2,100.0
410100,2016,4,0,0,4,100.0
410100,2017,3,0,0,3,100.0
410100,2018,5,0,0,5,100.0
410100,2019,4,0,0,4,100.0
410100,2020,5,0,0,5,100.0
410105,2012,2,0,0,2,100.0
410105,2014,1,0,0,1,100.0
410105,2015,1,0,0,1,100.0
410105,2016,1,0,0,1,100.0
410105,2018,3,0,0,3,100.0
410110,2012,4,0,0,4,100.0
410110,2013,2,0,0,2,100.0
410110,2014,8,0,0,8,100.0
410110,2015,11,0,0,11,100.0
410110,2016,4,0,0,4,100.0
410110,2017,9,0,0,9,100.0
410110,2018,6,0,0,6,100.0
410110,2019,6,0,0,6,100.0
410110,2020,2,0,0,2,100.0
410115,2012,1,0,0,1,100.0
410115,2013,1,0,0,1,100.0
410115,2014,2,0,0,2,100.0
410115,2015,1,1,0,2,100.0
410115,2016,1,0,0,1,100.0
410115,2018,1,0,0,1,100.0
410115,2019,1,0,0,1,100.0
410115,2020,2,0,0,2,100.0
410120,2012,11,0,0,11,100.0
410120,2013,10,0,0,10,100.0
410120,2014,6,0,0,6,100.0
410120,2015,9,0,0,9,100.0
410120,2016,6,0,0,6,100.0
410120,2017,8,0,0,8,100.0
410120,2018,5,0,0,5,100.0
410120,2019,3,0,0,3,100.0
410120,2020,3,0,0,3,100.0
410130,2012,3,0,0,3,100.0
410130,2013,1,0,0,1,100.0
410130,2014,2,0,0,2,100.0
410130,2015,5,0,0,5,100.0
410130,2016,2,0,0,2,100.0
410130,2017,1,0,0,1,100.0
410130,2018,2,0,0,2,100.0
410130,2019,2,0,0,2,100.0
410140,2012,47,0,0,47,100.0
410140,2013,45,0,0,45,100.0
410140,2014,45,0,0,45,100.0
410140,2015,42,0,0,42,100.0
410140,2016,38,0,0,38,100.0
410140,2017,33,0,0,33,100.0
410140,2018,32,0,0,32,100.0
410140,2019,33,0,0,33,100.0
410140,2020,41,0,0,41,100.0
410150,2012,45,0,0,45,100.0
410150,2013,32,0,0,32,100.0
410150,2014,33,0,0,33,100.0
410150,2015,40,0,0,40,100.0
410150,2016,36,1,0,37,100.0
410150,2017,31,0,0,31,100.0
410150,2018,27,0,0,27,100.0
410150,2019,27,0,0,27,100.0
410150,2020,42,0,0,42,100.0
410160,2012,9,0,0,9,100.0
410160,2013,7,0,0,7,100.0
410160,2014,11,0,0,11,100.0
410160,2015,10,0,0,10,100.0
410160,2016,12,0,0,12,100.0
410160,2017,7,0,0,7,100.0
410160,2018,14,0,0,14,100.0
410160,2019,8,0,0,8,100.0
410160,2020,7,0,0,7,100.0
410165,2012,1,0,0,1,100.0
410165,2013,1,0,0,1,100.0
410165,2014,1,0,0,1,100.0
410165,2017,0,0,1,1,0.0
410165,2018,1,0,0,1,100.0
410165,2019,2,0,0,2,100.0
410165,2020,2,0,0,2,100.0
410170,2012,3,0,0,3,100.0
410170,2013,3,0,0,3,100.0
410170,2014,3,0,0,3,100.0
410170,2015,2,0,0,2,100.0
410170,2016,6,0,0,6,100.0
410170,2017,2,0,0,2,100.0
410170,2018,2,0,0,2,100.0
410170,2019,5,0,0,5,100.0
410170,2020,8,0,0,8,100.0
410180,2012,45,0,0,45,100.0
410180,2013,44,0,0,44,100.0
410180,2014,31,0,0,31,100.0
410180,2015,37,0,0,37,100.0
410180,2016,47,0,0,47,100.0
410180,2017,46,0,0,46,100.0
410180,2018,52,0,0,52,100.0
410180,2019,39,0,0,39,100.0
410180,2020,46,0,0,46,100.0
410185,2014,2,0,0,2,100.0
410185,2016,1,0,0,1,100.0
410185,2018,1,0,1,2,50.0
410185,2019,1,0,0,1,100.0
410190,2012,6,0,0,6,100.0
410190,2013,7,0,0,7,100.0
410190,2014,4,0,0,4,100.0
410190,2015,12,0,0,12,100.0
410190,2016,6,0,0,6,100.0
410190,2017,3,0,0,3,100.0
410190,2018,7,0,0,7,100.0
410190,2019,5,0,0,5,100.0
410190,2020,5,0,0,5,100.0
410200,2012,15,0,0,15,100.0
410200,2013,12,0,0,12,100.0
410200,2014,9,0,0,9,100.0
410200,2015,14,0,0,14,100.0
410200,2016,14,0,0,14,100.0
410200,2017,15,0,0,15,100.0
410200,2018,9,0,0,9,100.0
410200,2019,8,0,0,8,100.0
410200,2020,14,0,0,14,100.0
410210,2012,4,0,0,4,100.0
410210,2013,6,0,0,6,100.0
410210,2014,8,0,0,8,100.0
410210,2015,5,0,0,5,100.0
410210,2016,3,0,0,3,100.0
410210,2017,11,0,0,11,100.0
410210,2018,8,0,0,8,100.0
410210,2019,9,0,0,9,100.0
410210,2020,7,0,0,7,100.0
410220,2012,2,0,0,2,100.0
410220,2013,1,0,0,1,100.0
410220,2014,1,0,0,1,100.0
410220,2015,1,0,0,1,100.0
410220,2017,2,0,0,2,100.0
410220,2018,1,0,0,1,100.0
410220,2019,2,0,0,2,100.0
410220,2020,3,0,0,3,100.0
410230,2012,4,0,0,4,100.0
410230,2013,2,0,0,2,100.0
410230,2014,2,0,0,2,100.0
410230,2015,7,0,0,7,100.0
410230,2016,8,0,0,8,100.0
410230,2017,5,0,0,5,100.0
410230,2018,2,0,0,2,100.0
410230,2019,2,0,0,2,100.0
410230,2020,0,1,1,2,50.0
410240,2012,11,0,0,11,100.0
410240,2013,15,0,0,15,100.0
410240,2014,18,0,0,18,100.0
410240,2015,9,0,0,9,100.0
410240,2016,9,0,0,9,100.0
410240,2017,10,0,0,10,100.0
410240,2018,14,1,0,15,100.0
410240,2019,9,0,0,9,100.0
410240,2020,11,0,0,11,100.0
410250,2012,8,0,0,8,100.0
410250,2013,4,0,0,4,100.0
410250,2014,4,0,0,4,100.0
410250,2015,1,0,0,1,100.0
410250,2016,7,0,0,7,100.0
410250,2017,1,0,0,1,100.0
410250,2018,2,0,0,2,100.0
410250,2019,3,0,0,3,100.0
410250,2020,3,0,0,3,100.0
410260,2012,5,0,0,5,100.0
410260,2013,5,0,0,5,100.0
410260,2014,5,0,0,5,100.0
410260,2015,2,0,0,2,100.0
410260,2016,5,0,0,5,100.0
410260,2017,4,0,0,4,100.0
410260,2018,2,0,0,2,100.0
410260,2019,3,0,0,3,100.0
410260,2020,2,0,0,2,100.0
410270,2012,1,0,0,1,100.0
410270,2015,1,0,0,1,100.0
410270,2018,2,0,0,2,100.0
410270,2019,1,0,0,1,100.0
410275,2012,2,0,0,2,100.0
410275,2016,1,0,0,1,100.0
410275,2017,1,0,0,1,100.0
410275,2018,1,0,0,1,100.0
410280,2012,2,0,0,2,100.0
410280,2013,9,0,0,9,100.0
410280,2014,5,0,0,5,100.0
410280,2015,4,0,1,5,80.0
410280,2016,8,0,0,8,100.0
410280,2017,4,0,0,4,100.0
410280,2018,3,0,0,3,100.0
410280,2019,5,0,0,5,100.0
410280,2020,6,0,0,6,100.0
410290,2012,5,0,0,5,100.0
410290,2013,5,0,0,5,100.0
410290,2014,2,0,0,2,100.0
410290,2015,2,0,0,2,100.0
410290,2016,7,0,0,7,100.0
410290,2017,4,0,0,4,100.0
410290,2018,5,0,0,5,100.0
410290,2019,4,0,0,4,100.0
410290,2020,4,0,0,4,100.0
410300,2013,5,0,0,5,100.0
410300,2014,1,0,0,1,100.0
410300,2015,1,0,0,1,100.0
410300,2016,2,0,0,2,100.0
410300,2017,2,0,0,2,100.0
410300,2018,3,0,0,3,100.0
410300,2019,1,0,0,1,100.0
410300,2020,1,1,0,2,100.0
410302,2012,2,0,0,2,100.0
410302,2013,1,0,0,1,100.0
410302,2014,1,0,0,1,100.0
410302,2016,2,0,0,2,100.0
410302,2018,1,0,0,1,100.0
410304,2012,1,0,0,1,100.0
410304,2013,2,0,0,2,100.0
410304,2014,1,0,0,1,100.0
410304,2016,1,0,0,1,100.0
410304,2017,1,0,0,1,100.0
410304,2019,1,0,0,1,100.0
410304,2020,3,0,0,3,100.0
410305,2012,2,0,0,2,100.0
410305,2013,3,0,0,3,100.0
410305,2014,2,0,0,2,100.0
410305,2015,6,0,0,6,100.0
410305,2016,2,0,0,2,100.0
410305,2017,1,0,0,1,100.0
410305,2018,3,0,0,3,100.0
410305,2019,1,0,0,1,100.0
410310,2012,5,0,0,5,100.0
410310,2013,4,0,0,4,100.0
410310,2014,4,0,0,4,100.0
410310,2015,4,0,0,4,100.0
410310,2016,9,0,0,9,100.0
410310,2017,4,0,0,4,100.0
410310,2018,1,1,0,2,100.0
410310,2019,2,1,0,3,100.0
410310,2020,6,0,0,6,100.0
410315,2012,3,0,0,3,100.0
410315,2013,2,0,0,2,100.0
410315,2014,1,0,0,1,100.0
410315,2015,1,0,0,1,100.0
410315,2016,1,0,0,1,100.0
410315,2017,2,0,0,2,100.0
410315,2019,1,0,0,1,100.0
410320,2012,1,0,0,1,100.0
410320,2013,3,0,0,3,100.0
410320,2014,3,0,0,3,100.0
410320,2015,2,0,0,2,100.0
410320,2016,5,0,0,5,100.0
410320,2017,2,0,0,2,100.0
410320,2018,2,0,0,2,100.0
410320,2019,1,0,0,1,100.0
410320,2020,2,0,0,2,100.0
410322,2012,2,0,0,2,100.0
410322,2014,1,0,0,1,100.0
410322,2016,1,0,0,1,100.0
410322,2018,2,0,0,2,100.0
410322,2020,2,0,0,2,100.0
410330,2012,3,0,0,3,100.0
410330,2013,2,0,0,2,100.0
410330,2014,4,0,0,4,100.0
410330,2015,3,0,0,3,100.0
410330,2016,3,0,0,3,100.0
410330,2017,5,0,0,5,100.0
410330,2018,1,0,0,1,100.0
410330,2019,1,0,0,1,100.0
410330,2020,5,0,0,5,100.0
410335,2012,1,0,0,1,100.0
410335,2013,4,0,0,4,100.0
410335,2014,2,0,0,2,100.0
410335,2015,3,0,0,3,100.0
410335,2016,3,0,0,3,100.0
410335,2018,3,0,0,3,100.0
410335,2019,2,0,0,2,100.0
410335,2020,4,0,0,4,100.0
410337,2012,1,0,0,1,100.0
410337,2013,3,0,0,3,100.0
410337,2014,1,0,0,1,100.0
410337,2016,2,0,1,3,66.66666666666666
410337,2018,1,0,0,1,100.0
410337,2020,1,0,0,1,100.0
410340,2013,1,0,0,1,100.0
410340,2014,2,0,0,2,100.0
410340,2016,1,0,0,1,100.0
410340,2017,1,0,0,1,100.0
410340,2018,1,0,0,1,100.0
410345,2012,3,0,0,3,100.0
410345,2013,1,0,0,1,100.0
410345,2014,6,0,0,6,100.0
410345,2015,3,0,0,3,100.0
410345,2016,2,0,0,2,100.0
410345,2017,5,0,0,5,100.0
410345,2018,6,0,0,6,100.0
410345,2019,4,0,0,4,100.0
410345,2020,6,0,0,6,100.0
410347,2012,1,0,0,1,100.0
410347,2013,3,0,0,3,100.0
410347,2014,3,0,0,3,100.0
410347,2015,3,0,0,3,100.0
410347,2016,4,0,0,4,100.0
410347,2017,1,0,0,1,100.0
410347,2019,1,0,0,1,100.0
410347,2020,1,0,0,1,100.0
410350,2012,2,0,0,2,100.0
410350,2013,2,0,0,2,100.0
410350,2014,4,0,0,4,100.0
410350,2015,2,0,0,2,100.0
410350,2016,2,0,0,2,100.0
410350,2017,3,0,0,3,100.0
410350,2018,3,0,0,3,100.0
410350,2019,4,0,0,4,100.0
410350,2020,2,0,0,2,100.0
410360,2012,7,0,0,7,100.0
410360,2013,7,0,0,7,100.0
410360,2014,11,0,0,11,100.0
410360,2015,10,0,0,10,100.0
410360,2016,10,0,1,11,90.9090909090909
410360,2017,12,0,0,12,100.0
410360,2018,3,0,0,3,100.0
410360,2019,11,0,0,11,100.0
410360,2020,7,0,0,7,100.0
410370,2012,28,0,0,28,100.0
410370,2013,36,0,0,36,100.0
410370,2014,25,0,0,25,100.0
410370,2015,29,0,0,29,100.0
410370,2016,32,1,0,33,100.0
410370,2017,29,0,0,29,100.0
410370,2018,31,0,0,31,100.0
410370,2019,34,0,0,34,100.0
410370,2020,33,0,0,33,100.0
410380,2012,2,0,0,2,100.0
410380,2013,3,0,0,3,100.0
410380,2014,1,0,0,1,100.0
410380,2015,2,0,0,2,100.0
410380,2016,4,0,0,4,100.0
410380,2017,1,0,0,1,100.0
410380,2018,1,0,0,1,100.0
410380,2019,2,0,0,2,100.0
410380,2020,4,0,0,4,100.0
410390,2012,11,0,0,11,100.0
410390,2013,4,0,0,4,100.0
410390,2014,6,0,0,6,100.0
410390,2015,3,0,0,3,100.0
410390,2016,4,1,0,5,100.0
410390,2017,12,0,0,12,100.0
410390,2018,6,0,0,6,100.0
410390,2019,10,0,0,10,100.0
410390,2020,4,0,0,4,100.0
410395,2012,2,0,0,2,100.0
410395,2013,2,0,0,2,100.0
410395,2014,2,0,0,2,100.0
410395,2015,1,0,0,1,100.0
410395,2017,2,0,0,2,100.0
410395,2019,4,0,0,4,100.0
410395,2020,3,0,0,3,100.0
410400,2012,19,0,0,19,100.0
410400,2013,15,0,0,15,100.0
410400,2014,14,0,0,14,100.0
410400,2015,15,0,0,15,100.0
410400,2016,13,0,0,13,100.0
410400,2017,16,0,0,16,100.0
410400,2018,16,0,0,16,100.0
410400,2019,4,4,3,11,72.72727272727273
410400,2020,10,8,4,22,81.81818181818183
410405,2013,2,0,0,2,100.0
410405,2014,2,0,0,2,100.0
410405,2015,2,0,0,2,100.0
410405,2016,4,0,0,4,100.0
410405,2018,3,0,0,3,100.0
410405,2019,2,0,0,2,100.0
410405,2020,2,0,0,2,100.0
410410,2012,2,0,0,2,100.0
410410,2013,2,0,0,2,100.0
410410,2014,1,0,0,1,100.0
410410,2015,2,0,0,2,100.0
410410,2016,4,0,0,4,100.0
410410,2017,2,0,0,2,100.0
410410,2018,5,1,0,6,100.0
410410,2019,2,0,0,2,100.0
410410,2020,3,0,0,3,100.0
410420,2012,34,0,0,34,100.0
410420,2013,35,0,0,35,100.0
410420,2014,29,0,0,29,100.0
410420,2015,27,0,0,27,100.0
410420,2016,44,0,0,44,100.0
410420,2017,36,0,0,36,100.0
410420,2018,42,0,0,42,100.0
410420,2019,38,0,0,38,100.0
410420,2020,42,0,0,42,100.0
410425,2012,8,0,0,8,100.0
410425,2013,7,0,0,7,100.0
410425,2014,20,0,0,20,100.0
410425,2015,12,0,0,12,100.0
410425,2016,5,0,0,5,100.0
410425,2017,12,0,0,12,100.0
410425,2018,7,0,0,7,100.0
410425,2019,11,0,0,11,100.0
410425,2020,8,1,1,10,90.0
410430,2012,40,0,0,40,100.0
410430,2013,41,0,0,41,100.0
410430,2014,38,0,0,38,100.0
410430,2015,40,0,0,40,100.0
410430,2016,44,0,0,44,100.0
410430,2017,38,0,0,38,100.0
410430,2018,38,0,0,38,100.0
410430,2019,28,0,0,28,100.0
410430,2020,28,0,0,28,100.0
410440,2012,6,0,0,6,100.0
410440,2013,3,0,2,5,60.0
410440,2014,6,0,0,6,100.0
410440,2015,3,0,0,3,100.0
410440,2016,4,1,0,5,100.0
410440,2017,4,0,0,4,100.0
410440,2018,5,0,0,5,100.0
410440,2019,6,0,0,6,100.0
410440,2020,4,0,0,4,100.0
410442,2012,5,0,0,5,100.0
410442,2013,5,0,0,5,100.0
410442,2014,7,0,0,7,100.0
410442,2015,6,0,0,6,100.0
410442,2016,9,0,0,9,100.0
410442,2017,3,0,0,3,100.0
410442,2018,8,0,0,8,100.0
410442,2019,8,0,0,8,100.0
410442,2020,5,0,0,5,100.0
410445,2012,5,0,0,5,100.0
410445,2013,7,0,0,7,100.0
410445,2014,7,0,0,7,100.0
410445,2015,8,0,0,8,100.0
410445,2016,2,0,0,2,100.0
410445,2017,7,0,0,7,100.0
410445,2018,5,0,0,5,100.0
410445,2019,4,0,0,4,100.0
410445,2020,6,0,0,6,100.0
410450,2012,8,0,0,8,100.0
410450,2013,4,0,0,4,100.0
410450,2014,4,0,0,4,100.0
410450,2015,4,0,0,4,100.0
410450,2016,4,0,0,4,100.0
410450,2017,6,0,0,6,100.0
410450,2018,1,0,0,1,100.0
410450,2019,3,0,0,3,100.0
410450,2020,4,0,0,4,100.0
410460,2012,5,0,0,5,100.0
410460,2013,8,0,0,8,100.0
410460,2014,5,0,0,5,100.0
410460,2015,5,0,0,5,100.0
410460,2016,3,0,0,3,100.0
410460,2017,2,0,0,2,100.0
410460,2018,6,0,0,6,100.0
410460,2019,3,0,0,3,100.0
410460,2020,6,0,0,6,100.0
410465,2012,6,0,0,6,100.0
410465,2013,6,0,0,6,100.0
410465,2014,2,0,0,2,100.0
410465,2015,6,0,0,6,100.0
410465,2016,6,0,0,6,100.0
410465,2017,9,0,0,9,100.0
410465,2018,6,0,0,6,100.0
410465,2019,12,0,0,12,100.0
410465,2020,7,0,0,7,100.0
410470,2012,4,0,0,4,100.0
410470,2013,3,0,0,3,100.0
410470,2014,4,0,0,4,100.0
410470,2015,9,0,0,9,100.0
410470,2016,11,0,0,11,100.0
410470,2017,3,0,0,3,100.0
410470,2018,5,0,0,5,100.0
410470,2019,5,0,0,5,100.0
410470,2020,4,0,0,4,100.0
410480,2012,94,0,0,94,100.0
410480,2013,80,0,0,80,100.0
410480,2014,95,0,0,95,100.0
410480,2015,99,0,0,99,100.0
410480,2016,124,0,0,124,100.0
410480,2017,78,0,0,78,100.0
410480,2018,109,0,0,109,100.0
410480,2019,86,0,0,86,100.0
410480,2020,98,0,0,98,100.0
410490,2012,25,0,0,25,100.0
410490,2013,20,0,0,20,100.0
410490,2014,19,0,0,19,100.0
410490,2015,18,1,3,22,86.36363636363636
410490,2016,22,0,1,23,95.65217391304348
410490,2017,28,0,0,28,100.0
410490,2018,21,0,0,21,100.0
410490,2019,30,0,0,30,100.0
410490,2020,26,0,0,26,100.0
410500,2012,4,0,0,4,100.0
410500,2013,2,0,0,2,100.0
410500,2014,1,0,0,1,100.0
410500,2015,3,0,0,3,100.0
410500,2016,3,0,0,3,100.0
410500,2017,1,0,0,1,100.0
410500,2018,2,0,0,2,100.0
410500,2019,3,0,0,3,100.0
410500,2020,1,0,0,1,100.0
410510,2012,5,0,0,5,100.0
410510,2013,4,0,0,4,100.0
410510,2014,3,0,0,3,100.0
410510,2015,3,0,0,3,100.0
410510,2016,3,0,0,3,100.0
410510,2017,5,0,0,5,100.0
410510,2018,6,0,0,6,100.0
410510,2019,4,0,0,4,100.0
410510,2020,4,0,0,4,100.0
410520,2012,7,0,0,7,100.0
410520,2013,4,0,0,4,100.0
410520,2014,5,0,0,5,100.0
410520,2015,8,0,0,8,100.0
410520,2016,5,0,0,5,100.0
410520,2017,3,0,0,3,100.0
410520,2018,3,0,0,3,100.0
410520,2019,6,0,0,6,100.0
410520,2020,8,0,0,8,100.0
410530,2012,5,0,0,5,100.0
410530,2013,3,0,0,3,100.0
410530,2014,4,0,0,4,100.0
410530,2015,3,0,0,3,100.0
410530,2016,2,0,0,2,100.0
410530,2017,8,0,0,8,100.0
410530,2018,6,0,0,6,100.0
410530,2019,2,0,0,2,100.0
410530,2020,5,0,0,5,100.0
410540,2012,8,0,0,8,100.0
410540,2013,6,0,0,6,100.0
410540,2014,8,0,0,8,100.0
410540,2015,6,0,0,6,100.0
410540,2016,8,0,0,8,100.0
410540,2017,3,0,0,3,100.0
410540,2018,7,0,0,7,100.0
410540,2019,7,0,0,7,100.0
410540,2020,3,0,0,3,100.0
410550,2012,16,0,0,16,100.0
410550,2013,21,0,0,21,100.0
410550,2014,20,0,0,20,100.0
410550,2015,29,0,0,29,100.0
410550,2016,16,0,0,16,100.0
410550,2017,16,0,0,16,100.0
410550,2018,28,0,0,28,100.0
410550,2019,31,0,0,31,100.0
410550,2020,19,0,0,19,100.0
410560,2012,2,0,0,2,100.0
410560,2013,8,0,0,8,100.0
410560,2014,5,0,0,5,100.0
410560,2015,2,0,0,2,100.0
410560,2016,3,0,0,3,100.0
410560,2017,5,0,0,5,100.0
410560,2018,1,0,0,1,100.0
410560,2019,6,0,0,6,100.0
410560,2020,4,0,0,4,100.0
410570,2012,7,0,0,7,100.0
410570,2013,8,0,0,8,100.0
410570,2014,8,0,0,8,100.0
410570,2015,6,0,0,6,100.0
410570,2016,8,0,0,8,100.0
410570,2017,9,0,0,9,100.0
410570,2018,4,0,0,4,100.0
410570,2019,11,1,0,12,100.0
410570,2020,5,0,0,5,100.0
410580,2012,84,0,0,84,100.0
410580,2013,110,0,0,110,100.0
410580,2014,90,0,0,90,100.0
410580,2015,95,0,0,95,100.0
410580,2016,65,0,0,65,100.0
410580,2017,87,1,0,88,100.0
410580,2018,71,0,0,71,100.0
410580,2019,85,1,0,86,100.0
410580,2020,99,0,0,99,100.0
410590,2012,9,0,0,9,100.0
410590,2013,6,0,0,6,100.0
410590,2014,3,0,0,3,100.0
410590,2015,7,0,0,7,100.0
410590,2016,4,0,0,4,100.0
410590,2017,11,0,0,11,100.0
410590,2018,5,0,0,5,100.0
410590,2019,10,0,0,10,100.0
410590,2020,5,0,0,5,100.0
410600,2012,3,0,0,3,100.0
410600,2013,4,0,0,4,100.0
410600,2014,1,0,0,1,100.0
410600,2015,1,0,0,1,100.0
410600,2016,2,0,0,2,100.0
410600,2017,1,0,0,1,100.0
410600,2018,2,0,0,2,100.0
410600,2019,4,0,0,4,100.0
410600,2020,3,0,0,3,100.0
410610,2012,1,0,0,1,100.0
410610,2013,2,0,0,2,100.0
410610,2014,3,0,0,3,100.0
410610,2015,4,0,0,4,100.0
410610,2016,2,0,0,2,100.0
410610,2018,2,0,0,2,100.0
410610,2019,1,0,0,1,100.0
410620,2012,7,0,0,7,100.0
410620,2013,5,0,0,5,100.0
410620,2014,5,0,0,5,100.0
410620,2015,9,0,0,9,100.0
410620,2016,2,0,0,2,100.0
410620,2017,5,0,0,5,100.0
410620,2018,8,0,0,8,100.0
410620,2019,4,0,0,4,100.0
410620,2020,8,0,0,8,100.0
410630,2012,6,0,0,6,100.0
410630,2013,10,0,0,10,100.0
410630,2014,3,0,0,3,100.0
410630,2015,3,0,0,3,100.0
410630,2016,5,0,0,5,100.0
410630,2017,2,0,0,2,100.0
410630,2018,10,0,0,10,100.0
410630,2019,4,0,0,4,100.0
410630,2020,3,0,0,3,100.0
410640,2012,9,0,0,9,100.0
410640,2013,7,0,0,7,100.0
410640,2014,8,0,0,8,100.0
410640,2015,8,0,0,8,100.0
410640,2016,8,0,0,8,100.0
410640,2017,10,0,0,10,100.0
410640,2018,9,0,0,9,100.0
410640,2019,11,0,0,11,100.0
410640,2020,16,0,0,16,100.0
410645,2012,1,0,0,1,100.0
410645,2013,4,0,0,4,100.0
410645,2014,3,0,0,3,100.0
410645,2017,3,0,0,3,100.0
410645,2018,1,0,0,1,100.0
410645,2019,4,0,0,4,100.0
410645,2020,4,0,0,4,100.0
410650,2012,10,0,0,10,100.0
410650,2013,2,0,0,2,100.0
410650,2014,8,0,0,8,100.0
410650,2015,11,0,0,11,100.0
410650,2016,2,0,0,2,100.0
410650,2017,4,0,0,4,100.0
410650,2018,4,0,0,4,100.0
410650,2019,6,0,0,6,100.0
410650,2020,6,0,0,6,100.0
410655,2012,2,0,0,2,100.0
410655,2014,1,0,0,1,100.0
410655,2015,2,0,0,2,100.0
410655,2016,2,0,0,2,100.0
410655,2017,1,0,0,1,100.0
410655,2019,1,0,0,1,100.0
410657,2012,2,0,0,2,100.0
410657,2015,1,0,0,1,100.0
410657,2017,1,0,0,1,100.0
410657,2018,3,0,0,3,100.0
410657,2019,1,0,0,1,100.0
410657,2020,4,0,0,4,100.0
410660,2012,8,0,0,8,100.0
410660,2013,10,0,0,10,100.0
410660,2014,12,0,0,12,100.0
410660,2015,6,0,0,6,100.0
410660,2016,9,0,0,9,100.0
410660,2017,4,0,0,4,100.0
410660,2018,10,0,0,10,100.0
410660,2019,9,0,0,9,100.0
410660,2020,6,0,0,6,100.0
410670,2012,1,0,0,1,100.0
410670,2013,3,0,0,3,100.0
410670,2014,1,0,0,1,100.0
410670,2016,5,0,0,5,100.0
410670,2020,1,0,0,1,100.0
410680,2012,5,0,0,5,100.0
410680,2013,4,0,0,4,100.0
410680,2014,8,0,0,8,100.0
410680,2015,4,0,0,4,100.0
410680,2016,3,0,0,3,100.0
410680,2017,4,0,0,4,100.0
410680,2018,4,0,0,4,100.0
410680,2019,5,0,0,5,100.0
410680,2020,2,0,0,2,100.0
410685,2012,1,0,0,1,100.0
410685,2013,0,0,1,1,0.0
410685,2014,4,0,0,4,100.0
410685,2015,1,0,0,1,100.0
410685,2016,1,0,0,1,100.0
410685,2017,2,0,0,2,100.0
410685,2018,1,0,0,1,100.0
410685,2019,1,0,0,1,100.0
410685,2020,1,0,0,1,100.0
410690,2012,519,0,0,519,100.0
410690,2013,513,0,0,513,100.0
410690,2014,474,0,0,474,100.0
410690,2015,482,1,0,483,100.0
410690,2016,478,0,0,478,100.0
410690,2017,450,0,1,451,99.77827050997783
410690,2018,452,0,0,452,100.0
410690,2019,439,0,0,439,100.0
410690,2020,472,2,0,474,100.0
410700,2012,8,0,0,8,100.0
410700,2013,6,0,0,6,100.0
410700,2014,5,0,0,5,100.0
410700,2015,3,0,0,3,100.0
410700,2016,3,0,0,3,100.0
410700,2017,10,0,0,10,100.0
410700,2018,5,0,0,5,100.0
410700,2019,4,0,0,4,100.0
410700,2020,3,0,1,4,75.0
410710,2012,1,0,0,1,100.0
410710,2013,3,0,0,3,100.0
410710,2014,2,0,0,2,100.0
410710,2015,2,0,0,2,100.0
410710,2016,2,0,0,2,100.0
410710,2017,1,0,0,1,100.0
410710,2018,1,0,0,1,100.0
410710,2020,5,0,0,5,100.0
410712,2012,1,0,0,1,100.0
410712,2016,2,0,0,2,100.0
410712,2017,3,0,0,3,100.0
410712,2018,1,0,0,1,100.0
410712,2019,1,0,0,1,100.0
410712,2020,3,0,0,3,100.0
410715,2013,1,0,0,1,100.0
410715,2014,1,0,0,1,100.0
410715,2016,1,0,0,1,100.0
410715,2017,2,0,0,2,100.0
410715,2018,4,0,0,4,100.0
410715,2020,2,0,0,2,100.0
410720,2012,20,0,0,20,100.0
410720,2013,14,0,0,14,100.0
410720,2014,14,0,0,14,100.0
410720,2015,11,0,0,11,100.0
410720,2016,14,0,0,14,100.0
410720,2017,9,0,0,9,100.0
410720,2018,9,0,0,9,100.0
410720,2019,10,0,0,10,100.0
410720,2020,17,0,0,17,100.0
410725,2012,3,0,0,3,100.0
410725,2013,5,0,0,5,100.0
410725,2015,4,0,0,4,100.0
410725,2016,2,0,0,2,100.0
410725,2017,5,0,0,5,100.0
410725,2018,2,0,0,2,100.0
410725,2019,5,0,0,5,100.0
410725,2020,3,0,0,3,100.0
410730,2012,3,0,0,3,100.0
410730,2013,5,0,0,5,100.0
410730,2014,3,0,0,3,100.0
410730,2015,4,0,0,4,100.0
410730,2016,2,0,0,2,100.0
410730,2017,1,0,0,1,100.0
410730,2018,2,0,0,2,100.0
410730,2019,3,0,0,3,100.0
410730,2020,1,0,0,1,100.0
410740,2012,3,0,0,3,100.0
410740,2013,5,0,0,5,100.0
410740,2014,1,0,0,1,100.0
410740,2015,1,0,0,1,100.0
410740,2016,3,0,0,3,100.0
410740,2017,3,0,0,3,100.0
410740,2018,1,0,0,1,100.0
410740,2019,2,0,0,2,100.0
410750,2012,5,0,0,5,100.0
410750,2013,3,0,0,3,100.0
410750,2014,1,2,1,4,75.0
410750,2015,7,0,0,7,100.0
410750,2016,4,0,0,4,100.0
410750,2017,2,0,0,2,100.0
410750,2018,2,0,0,2,100.0
410750,2019,1,0,0,1,100.0
410750,2020,6,0,0,6,100.0
410752,2012,1,0,0,1,100.0
410752,2013,1,0,0,1,100.0
410752,2017,1,0,0,1,100.0
410752,2019,1,0,0,1,100.0
410752,2020,1,0,0,1,100.0
410753,2012,1,0,0,1,100.0
410753,2014,1,0,0,1,100.0
410753,2015,1,0,0,1,100.0
410753,2016,3,0,0,3,100.0
410753,2017,2,0,0,2,100.0
410753,2018,1,0,0,1,100.0
410753,2020,2,0,0,2,100.0
410754,2012,1,0,0,1,100.0
410754,2013,2,0,0,2,100.0
410754,2014,2,0,0,2,100.0
410754,2015,5,0,0,5,100.0
410754,2016,1,0,0,1,100.0
410754,2017,3,0,0,3,100.0
410754,2018,3,0,0,3,100.0
410754,2019,4,0,0,4,100.0
410754,2020,2,0,0,2,100.0
410755,2012,1,0,0,1,100.0
410755,2013,0,1,0,1,100.0
410755,2014,0,1,0,1,100.0
410755,2015,1,0,0,1,100.0
410755,2016,1,1,0,2,100.0
410755,2017,1,0,0,1,100.0
410755,2018,1,0,0,1,100.0
410755,2019,0,1,0,1,100.0
410755,2020,0,1,1,2,50.0
410760,2012,4,0,0,4,100.0
410760,2013,10,0,0,10,100.0
410760,2014,8,0,0,8,100.0
410760,2015,4,0,0,4,100.0
410760,2016,6,0,0,6,100.0
410760,2017,7,0,0,7,100.0
410760,2018,8,0,0,8,100.0
410760,2019,7,0,0,7,100.0
410760,2020,6,0,0,6,100.0
410765,2012,55,0,0,55,100.0
410765,2013,44,0,0,44,100.0
410765,2014,40,0,0,40,100.0
410765,2015,33,0,0,33,100.0
410765,2016,35,0,0,35,100.0
410765,2017,40,0,0,40,100.0
410765,2018,36,0,0,36,100.0
410765,2019,32,0,0,32,100.0
410765,2020,58,0,0,58,100.0
410770,2012,3,0,0,3,100.0
410770,2014,3,0,2,5,60.0
410770,2015,3,0,0,3,100.0
410770,2016,4,0,0,4,100.0
410770,2017,3,0,0,3,100.0
410770,2018,3,0,0,3,100.0
410770,2020,2,0,0,2,100.0
410773,2012,1,0,0,1,100.0
410773,2013,2,0,0,2,100.0
410773,2014,2,0,0,2,100.0
410773,2015,1,0,0,1,100.0
410773,2016,4,0,0,4,100.0
410773,2017,2,0,0,2,100.0
410773,2018,2,0,0,2,100.0
410773,2019,1,0,0,1,100.0
410775,2012,3,0,0,3,100.0
410775,2013,3,0,0,3,100.0
410775,2014,1,0,0,1,100.0
410775,2015,2,0,0,2,100.0
410775,2016,3,0,0,3,100.0
410775,2017,5,0,0,5,100.0
410775,2018,6,0,0,6,100.0
410775,2019,4,0,0,4,100.0
410775,2020,1,0,0,1,100.0
410780,2012,4,0,0,4,100.0
410780,2013,1,0,0,1,100.0
410780,2014,2,0,0,2,100.0
410780,2016,3,0,0,3,100.0
410780,2017,1,0,0,1,100.0
410780,2018,1,0,0,1,100.0
410780,2019,4,0,0,4,100.0
410780,2020,1,0,0,1,100.0
410785,2012,1,0,0,1,100.0
410785,2013,2,0,0,2,100.0
410785,2014,1,0,0,1,100.0
410785,2015,1,0,0,1,100.0
410785,2016,2,0,0,2,100.0
410785,2017,3,0,0,3,100.0
410785,2018,1,0,0,1,100.0
410785,2019,2,0,0,2,100.0
410790,2012,3,0,0,3,100.0
410790,2013,2,0,0,2,100.0
410790,2014,1,0,0,1,100.0
410790,2015,2,0,0,2,100.0
410790,2016,1,0,0,1,100.0
410790,2017,1,0,0,1,100.0
410790,2018,1,0,0,1,100.0
410790,2019,1,0,0,1,100.0
410790,2020,2,0,0,2,100.0
410800,2012,6,0,0,6,100.0
410800,2013,5,0,0,5,100.0
410800,2014,1,0,0,1,100.0
410800,2015,7,0,0,7,100.0
410800,2016,6,0,0,6,100.0
410800,2017,4,0,0,4,100.0
410800,2018,1,0,0,1,100.0
410800,2019,1,0,0,1,100.0
410800,2020,4,0,0,4,100.0
410810,2012,3,0,0,3,100.0
410810,2013,1,0,0,1,100.0
410810,2014,1,0,0,1,100.0
410810,2015,2,0,0,2,100.0
410810,2016,1,0,0,1,100.0
410810,2017,1,0,0,1,100.0
410810,2019,2,0,0,2,100.0
410810,2020,1,0,0,1,100.0
410820,2012,3,0,0,3,100.0
410820,2013,3,0,0,3,100.0
410820,2014,3,0,0,3,100.0
410820,2016,2,0,0,2,100.0
410820,2017,3,0,0,3,100.0
410820,2018,1,0,0,1,100.0
410820,2019,2,0,0,2,100.0
410820,2020,3,0,0,3,100.0
410830,2012,88,0,0,88,100.0
410830,2013,107,0,0,107,100.0
410830,2014,94,3,4,101,96.03960396039604
410830,2015,86,13,4,103,96.11650485436894
410830,2016,95,0,0,95,100.0
410830,2017,89,0,0,89,100.0
410830,2018,83,0,0,83,100.0
410830,2019,98,0,0,98,100.0
410830,2020,93,2,1,96,98.95833333333334
410832,2012,2,0,0,2,100.0
410832,2014,2,0,0,2,100.0
410832,2015,0,1,2,3,33.33333333333333
410832,2016,5,0,0,5,100.0
410832,2017,0,0,1,1,0.0
410832,2018,2,0,0,2,100.0
410832,2019,1,0,0,1,100.0
410832,2020,3,0,0,3,100.0
410840,2012,34,0,0,34,100.0
410840,2013,16,0,0,16,100.0
410840,2014,27,0,0,27,100.0
410840,2015,34,0,0,34,100.0
410840,2016,28,0,0,28,100.0
410840,2017,21,0,0,21,100.0
410840,2018,25,0,0,25,100.0
410840,2019,19,0,0,19,100.0
410840,2020,22,0,0,22,100.0
410845,2012,2,0,0,2,100.0
410845,2013,3,0,0,3,100.0
410845,2014,4,0,0,4,100.0
410845,2016,5,0,0,5,100.0
410845,2017,1,0,0,1,100.0
410845,2018,3,0,0,3,100.0
410845,2019,1,0,0,1,100.0
410845,2020,2,0,0,2,100.0
410850,2012,11,0,0,11,100.0
410850,2013,5,0,0,5,100.0
410850,2014,5,0,0,5,100.0
410850,2015,10,0,0,10,100.0
410850,2016,5,0,0,5,100.0
410850,2017,7,0,0,7,100.0
410850,2018,3,0,0,3,100.0
410850,2019,6,0,0,6,100.0
410850,2020,9,0,0,9,100.0
410855,2014,1,0,0,1,100.0
410855,2016,1,0,0,1,100.0
410855,2017,1,0,0,1,100.0
410855,2020,1,0,0,1,100.0
410860,2012,15,0,0,15,100.0
410860,2013,12,0,0,12,100.0
410860,2014,12,1,0,13,100.0
410860,2015,8,4,0,12,100.0
410860,2016,12,0,0,12,100.0
410860,2017,10,0,0,10,100.0
410860,2018,7,0,0,7,100.0
410860,2019,6,0,0,6,100.0
410860,2020,14,0,0,14,100.0
410865,2012,1,0,0,1,100.0
410865,2014,3,0,0,3,100.0
410865,2015,2,0,0,2,100.0
410865,2016,4,0,0,4,100.0
410865,2017,2,0,0,2,100.0
410865,2018,2,0,0,2,100.0
410865,2019,3,0,0,3,100.0
410865,2020,1,0,0,1,100.0
410870,2012,5,0,0,5,100.0
410870,2013,2,0,0,2,100.0
410870,2014,1,0,0,1,100.0
410870,2015,3,0,0,3,100.0
410870,2016,2,0,0,2,100.0
410870,2018,3,0,0,3,100.0
410870,2019,2,0,0,2,100.0
410880,2012,18,0,0,18,100.0
410880,2013,16,0,0,16,100.0
410880,2014,12,0,0,12,100.0
410880,2015,17,0,0,17,100.0
410880,2016,17,0,0,17,100.0
410880,2017,11,0,0,11,100.0
410880,2018,17,0,0,17,100.0
410880,2019,12,0,0,12,100.0
410880,2020,9,0,0,9,100.0
410890,2012,2,0,0,2,100.0
410890,2013,3,0,0,3,100.0
410890,2014,1,0,0,1,100.0
410890,2015,1,0,0,1,100.0
410890,2016,2,0,0,2,100.0
410890,2017,2,0,0,2,100.0
410890,2019,3,0,0,3,100.0
410895,2012,1,0,0,1,100.0
410895,2013,4,0,0,4,100.0
410895,2014,3,0,0,3,100.0
410895,2016,2,0,0,2,100.0
410895,2017,4,0,0,4,100.0
410895,2018,3,0,0,3,100.0
410895,2020,3,0,0,3,100.0
410900,2012,2,0,0,2,100.0
410900,2013,4,0,0,4,100.0
410900,2014,4,0,0,4,100.0
410900,2015,1,0,0,1,100.0
410900,2016,1,0,0,1,100.0
410900,2017,3,0,0,3,100.0
410900,2018,3,0,0,3,100.0
410900,2019,1,0,0,1,100.0
410910,2013,1,0,0,1,100.0
410910,2014,1,0,0,1,100.0
410910,2015,1,0,0,1,100.0
410910,2016,1,0,0,1,100.0
410920,2012,2,0,0,2,100.0
410920,2014,3,0,0,3,100.0
410920,2015,1,0,0,1,100.0
410920,2016,2,0,0,2,100.0
410920,2017,2,0,0,2,100.0
410920,2018,3,0,0,3,100.0
410920,2019,2,0,0,2,100.0
410920,2020,1,0,0,1,100.0
410930,2012,7,0,0,7,100.0
410930,2013,11,0,0,11,100.0
410930,2014,6,0,0,6,100.0
410930,2015,5,0,0,5,100.0
410930,2016,6,0,0,6,100.0
410930,2017,5,0,0,5,100.0
410930,2018,3,0,0,3,100.0
410930,2019,4,0,0,4,100.0
410930,2020,4,0,0,4,100.0
410940,2012,63,0,0,63,100.0
410940,2013,76,0,0,76,100.0
410940,2014,71,0,0,71,100.0
410940,2015,69,0,0,69,100.0
410940,2016,55,0,0,55,100.0
410940,2017,65,0,0,65,100.0
410940,2018,69,0,0,69,100.0
410940,2019,65,0,0,65,100.0
410940,2020,70,0,0,70,100.0
410950,2012,1,0,0,1,100.0
410950,2013,2,0,0,2,100.0
410950,2014,1,0,0,1,100.0
410950,2016,1,0,0,1,100.0
410950,2017,1,0,0,1,100.0
410950,2018,2,0,0,2,100.0
410950,2019,3,0,0,3,100.0
410960,2012,17,0,0,17,100.0
410960,2013,14,0,0,14,100.0
410960,2014,15,0,0,15,100.0
410960,2015,15,0,0,15,100.0
410960,2016,15,0,0,15,100.0
410960,2017,7,0,0,7,100.0
410960,2018,17,0,0,17,100.0
410960,2019,8,0,0,8,100.0
410960,2020,13,0,0,13,100.0
410965,2013,1,0,0,1,100.0
410965,2014,2,0,0,2,100.0
410965,2015,1,0,0,1,100.0
410965,2016,2,0,0,2,100.0
410965,2018,2,0,0,2,100.0
410965,2019,2,0,0,2,100.0
410965,2020,2,0,0,2,100.0
410970,2012,11,0,0,11,100.0
410970,2013,8,0,0,8,100.0
410970,2014,7,0,0,7,100.0
410970,2015,14,0,0,14,100.0
410970,2016,13,0,0,13,100.0
410970,2017,17,0,0,17,100.0
410970,2018,11,0,0,11,100.0
410970,2019,13,0,0,13,100.0
410970,2020,3,0,0,3,100.0
410975,2013,2,0,0,2,100.0
410975,2015,2,0,0,2,100.0
410975,2016,2,0,0,2,100.0
410975,2017,2,0,0,2,100.0
410975,2018,4,0,0,4,100.0
410975,2019,2,0,0,2,100.0
410975,2020,1,0,0,1,100.0
410980,2012,17,0,0,17,100.0
410980,2013,25,0,0,25,100.0
410980,2014,12,0,0,12,100.0
410980,2015,21,0,0,21,100.0
410980,2016,19,0,0,19,100.0
410980,2017,11,0,0,11,100.0
410980,2018,11,0,0,11,100.0
410980,2019,14,0,0,14,100.0
410980,2020,19,0,0,19,100.0
410990,2012,6,0,0,6,100.0
410990,2013,4,0,0,4,100.0
410990,2014,1,0,0,1,100.0
410990,2015,4,0,0,4,100.0
410990,2016,2,0,0,2,100.0
410990,2017,2,0,0,2,100.0
410990,2019,2,0,0,2,100.0
410990,2020,2,0,0,2,100.0
411000,2012,2,0,0,2,100.0
411000,2013,1,0,0,1,100.0
411000,2014,2,0,0,2,100.0
411000,2015,1,0,0,1,100.0
411000,2016,1,0,0,1,100.0
411000,2017,2,0,0,2,100.0
411000,2018,3,0,0,3,100.0
411000,2019,4,0,0,4,100.0
411000,2020,2,0,0,2,100.0
411005,2013,1,0,0,1,100.0
411005,2015,1,0,0,1,100.0
411007,2012,3,0,0,3,100.0
411007,2013,4,0,0,4,100.0
411007,2014,5,0,0,5,100.0
411007,2015,7,0,0,7,100.0
411007,2016,6,0,0,6,100.0
411007,2017,5,0,0,5,100.0
411007,2018,0,2,1,3,66.66666666666666
411007,2019,3,0,0,3,100.0
411007,2020,8,0,0,8,100.0
411010,2012,7,0,0,7,100.0
411010,2013,9,0,0,9,100.0
411010,2014,14,0,0,14,100.0
411010,2015,13,0,0,13,100.0
411010,2016,12,0,0,12,100.0
411010,2017,11,0,0,11,100.0
411010,2018,16,0,0,16,100.0
411010,2019,6,0,0,6,100.0
411010,2020,13,0,0,13,100.0
411020,2012,4,0,0,4,100.0
411020,2013,3,0,0,3,100.0
411020,2014,5,0,0,5,100.0
411020,2016,1,0,0,1,100.0
411020,2017,4,0,0,4,100.0
411020,2018,1,0,0,1,100.0
411020,2019,2,0,0,2,100.0
411020,2020,2,0,0,2,100.0
411030,2013,2,0,0,2,100.0
411030,2014,3,0,0,3,100.0
411030,2016,2,0,0,2,100.0
411030,2017,1,0,0,1,100.0
411030,2018,2,0,0,2,100.0
411030,2019,1,0,0,1,100.0
411030,2020,1,0,0,1,100.0
411040,2012,1,0,0,1,100.0
411040,2013,2,0,0,2,100.0
411040,2014,2,0,0,2,100.0
411040,2015,3,0,0,3,100.0
411040,2016,1,0,0,1,100.0
411040,2017,2,0,0,2,100.0
411040,2019,1,0,1,2,50.0
411040,2020,2,0,0,2,100.0
411050,2012,9,0,0,9,100.0
411050,2013,8,0,0,8,100.0
411050,2014,5,0,0,5,100.0
411050,2015,3,0,0,3,100.0
411050,2016,1,0,0,1,100.0
411050,2017,4,0,0,4,100.0
411050,2018,4,0,0,4,100.0
411050,2019,5,0,0,5,100.0
411050,2020,3,0,0,3,100.0
411060,2012,7,0,0,7,100.0
411060,2013,9,0,0,9,100.0
411060,2014,5,0,0,5,100.0
411060,2015,4,1,2,7,71.42857142857143
411060,2016,7,0,0,7,100.0
411060,2017,1,0,0,1,100.0
411060,2018,8,0,0,8,100.0
411060,2019,3,0,0,3,100.0
411060,2020,2,0,0,2,100.0
411065,2012,1,0,0,1,100.0
411065,2014,2,0,0,2,100.0
411065,2015,1,0,0,1,100.0
411065,2017,2,0,0,2,100.0
411065,2019,1,0,0,1,100.0
411065,2020,1,0,0,1,100.0
411070,2012,10,0,0,10,100.0
411070,2013,20,0,0,20,100.0
411070,2014,13,0,0,13,100.0
411070,2015,18,0,0,18,100.0
411070,2016,19,0,0,19,100.0
411070,2017,22,0,0,22,100.0
411070,2018,15,0,0,15,100.0
411070,2019,25,0,0,25,100.0
411070,2020,22,0,0,22,100.0
411080,2012,4,0,0,4,100.0
411080,2013,3,0,0,3,100.0
411080,2014,1,2,0,3,100.0
411080,2015,3,0,0,3,100.0
411080,2016,4,0,0,4,100.0
411080,2017,4,0,0,4,100.0
411080,2018,1,0,0,1,100.0
411080,2019,7,0,0,7,100.0
411090,2013,2,0,0,2,100.0
411090,2014,1,0,0,1,100.0
411090,2015,2,0,0,2,100.0
411090,2016,2,0,0,2,100.0
411090,2017,1,0,0,1,100.0
411090,2018,2,0,0,2,100.0
411090,2019,2,0,0,2,100.0
411090,2020,2,0,0,2,100.0
411095,2012,2,0,0,2,100.0
411095,2013,8,0,0,8,100.0
411095,2014,4,0,0,4,100.0
411095,2015,1,0,0,1,100.0
411095,2016,7,0,0,7,100.0
411095,2017,1,0,0,1,100.0
411095,2018,5,0,0,5,100.0
411095,2019,5,0,0,5,100.0
411095,2020,6,1,0,7,100.0
411100,2012,3,0,0,3,100.0
411100,2013,2,0,0,2,100.0
411100,2014,2,0,0,2,100.0
411100,2018,1,0,0,1,100.0
411100,2019,1,0,0,1,100.0
411110,2013,3,0,0,3,100.0
411110,2014,1,0,0,1,100.0
411110,2015,1,0,0,1,100.0
411110,2016,1,0,0,1,100.0
411110,2017,1,0,0,1,100.0
411110,2018,2,0,0,2,100.0
411110,2019,2,0,0,2,100.0
411120,2012,4,0,0,4,100.0
411120,2013,4,0,0,4,100.0
411120,2014,5,0,0,5,100.0
411120,2015,3,0,0,3,100.0
411120,2016,2,0,0,2,100.0
411120,2017,3,0,0,3,100.0
411120,2018,7,0,0,7,100.0
411120,2019,2,0,0,2,100.0
411120,2020,3,0,0,3,100.0
411125,2012,13,0,0,13,100.0
411125,2013,13,0,0,13,100.0
411125,2014,9,0,0,9,100.0
411125,2015,6,0,0,6,100.0
411125,2016,11,0,0,11,100.0
411125,2017,13,0,0,13,100.0
411125,2018,8,0,0,8,100.0
411125,2019,11,0,0,11,100.0
411125,2020,18,0,2,20,90.0
411130,2012,2,0,0,2,100.0
411130,2013,1,0,0,1,100.0
411130,2014,1,0,0,1,100.0
411130,2015,1,0,0,1,100.0
411130,2016,3,0,0,3,100.0
411130,2017,1,0,0,1,100.0
411130,2018,2,0,0,2,100.0
411130,2020,2,0,0,2,100.0
411140,2012,3,0,0,3,100.0
411140,2013,1,0,3,4,25.0
411140,2014,3,0,0,3,100.0
411140,2015,6,0,0,6,100.0
411140,2016,1,0,0,1,100.0
411140,2017,2,0,0,2,100.0
411140,2018,3,0,0,3,100.0
411140,2019,4,0,0,4,100.0
411140,2020,3,0,1,4,75.0
411150,2012,8,0,0,8,100.0
411150,2013,13,0,0,13,100.0
411150,2014,10,0,0,10,100.0
411150,2015,11,0,0,11,100.0
411150,2016,6,0,0,6,100.0
411150,2017,11,0,0,11,100.0
411150,2018,10,0,0,10,100.0
411150,2019,10,0,0,10,100.0
411150,2020,7,0,0,7,100.0
411155,2012,3,0,0,3,100.0
411155,2013,3,0,0,3,100.0
411155,2014,3,0,0,3,100.0
411155,2015,1,0,0,1,100.0
411155,2016,1,0,0,1,100.0
411155,2017,2,0,0,2,100.0
411155,2018,2,0,0,2,100.0
411155,2019,2,0,0,2,100.0
411155,2020,3,0,0,3,100.0
411160,2016,3,0,0,3,100.0
411160,2017,1,0,0,1,100.0
411160,2018,1,0,0,1,100.0
411160,2020,2,0,0,2,100.0
411170,2015,2,0,0,2,100.0
411170,2016,1,0,0,1,100.0
411170,2017,1,0,0,1,100.0
411170,2018,1,0,0,1,100.0
411170,2019,3,0,0,3,100.0
411180,2012,14,0,0,14,100.0
411180,2013,16,0,0,16,100.0
411180,2014,16,0,0,16,100.0
411180,2015,13,0,0,13,100.0
411180,2016,25,0,0,25,100.0
411180,2017,11,0,0,11,100.0
411180,2018,14,0,0,14,100.0
411180,2019,18,0,0,18,100.0
411180,2020,12,0,0,12,100.0
411190,2012,2,0,0,2,100.0
411190,2013,5,0,0,5,100.0
411190,2014,6,0,0,6,100.0
411190,2015,7,0,0,7,100.0
411190,2016,5,0,0,5,100.0
411190,2017,4,0,0,4,100.0
411190,2018,2,0,0,2,100.0
411190,2019,9,0,0,9,100.0
411190,2020,4,0,0,4,100.0
411200,2012,7,0,0,7,100.0
411200,2013,15,0,1,16,93.75
411200,2014,11,0,0,11,100.0
411200,2015,11,0,0,11,100.0
411200,2016,11,0,0,11,100.0
411200,2017,11,0,0,11,100.0
411200,2018,12,0,0,12,100.0
411200,2019,15,0,0,15,100.0
411200,2020,16,0,0,16,100.0
411210,2012,5,0,0,5,100.0
411210,2013,6,0,0,6,100.0
411210,2014,3,0,0,3,100.0
411210,2015,8,0,0,8,100.0
411210,2016,10,0,0,10,100.0
411210,2017,8,0,0,8,100.0
411210,2018,10,0,0,10,100.0
411210,2019,6,0,0,6,100.0
411210,2020,8,0,0,8,100.0
411220,2012,3,0,0,3,100.0
411220,2013,4,0,1,5,80.0
411220,2014,3,1,0,4,100.0
411220,2015,3,0,0,3,100.0
411220,2016,3,0,0,3,100.0
411220,2017,2,0,0,2,100.0
411220,2018,4,0,0,4,100.0
411220,2019,4,0,0,4,100.0
411220,2020,3,0,0,3,100.0
411230,2013,3,0,0,3,100.0
411230,2014,2,0,0,2,100.0
411230,2015,2,0,0,2,100.0
411230,2016,4,0,0,4,100.0
411230,2017,2,0,0,2,100.0
411230,2018,1,0,0,1,100.0
411240,2013,4,0,0,4,100.0
411240,2015,2,0,0,2,100.0
411240,2016,4,0,0,4,100.0
411240,2018,4,0,0,4,100.0
411240,2019,7,0,0,7,100.0
411240,2020,3,0,0,3,100.0
411250,2012,1,0,0,1,100.0
411250,2013,1,0,2,3,33.33333333333333
411250,2014,3,0,0,3,100.0
411250,2015,1,0,4,5,20.0
411250,2016,1,0,0,1,100.0
411250,2017,0,0,1,1,0.0
411250,2018,1,0,2,3,33.33333333333333
411250,2019,3,0,0,3,100.0
411250,2020,4,0,0,4,100.0
411260,2012,1,0,0,1,100.0
411260,2020,2,0,0,2,100.0
411270,2012,5,0,0,5,100.0
411270,2013,5,0,0,5,100.0
411270,2014,4,0,0,4,100.0
411270,2015,7,0,0,7,100.0
411270,2016,9,0,0,9,100.0
411270,2017,3,0,0,3,100.0
411270,2018,3,0,0,3,100.0
411270,2019,5,0,0,5,100.0
411270,2020,4,0,0,4,100.0
411275,2012,3,0,0,3,100.0
411275,2013,1,0,0,1,100.0
411275,2014,2,0,0,2,100.0
411275,2015,3,0,0,3,100.0
411275,2016,5,0,0,5,100.0
411275,2017,3,0,0,3,100.0
411275,2018,2,0,0,2,100.0
411275,2019,2,0,0,2,100.0
411275,2020,1,0,0,1,100.0
411280,2012,4,0,0,4,100.0
411280,2013,4,0,0,4,100.0
411280,2014,6,0,0,6,100.0
411280,2015,4,0,0,4,100.0
411280,2016,9,0,0,9,100.0
411280,2017,6,0,0,6,100.0
411280,2018,5,0,0,5,100.0
411280,2019,5,0,0,5,100.0
411280,2020,5,0,0,5,100.0
411290,2012,4,0,0,4,100.0
411290,2013,2,0,0,2,100.0
411290,2014,1,0,0,1,100.0
411290,2015,2,0,0,2,100.0
411290,2016,1,0,1,2,50.0
411290,2017,1,0,0,1,100.0
411290,2018,1,0,0,1,100.0
411295,2012,4,0,0,4,100.0
411295,2013,7,0,0,7,100.0
411295,2014,2,0,0,2,100.0
411295,2015,2,0,0,2,100.0
411295,2016,3,0,0,3,100.0
411295,2017,3,0,0,3,100.0
411295,2018,1,0,0,1,100.0
411295,2019,3,0,0,3,100.0
411295,2020,2,0,0,2,100.0
411300,2012,2,0,0,2,100.0
411300,2014,3,0,0,3,100.0
411300,2015,1,0,0,1,100.0
411300,2017,3,0,0,3,100.0
411300,2019,5,0,0,5,100.0
411300,2020,1,0,0,1,100.0
411310,2012,1,0,0,1,100.0
411310,2013,3,0,0,3,100.0
411310,2015,1,0,0,1,100.0
411310,2017,1,0,0,1,100.0
411310,2018,1,0,0,1,100.0
411310,2019,1,0,0,1,100.0
411320,2012,14,0,0,14,100.0
411320,2013,15,0,0,15,100.0
411320,2014,16,0,0,16,100.0
411320,2015,8,0,0,8,100.0
411320,2016,17,0,0,17,100.0
411320,2017,13,0,0,13,100.0
411320,2018,15,0,0,15,100.0
411320,2019,13,0,0,13,100.0
411320,2020,12,0,0,12,100.0
411325,2012,3,0,0,3,100.0
411325,2013,2,0,0,2,100.0
411325,2014,1,0,0,1,100.0
411325,2015,1,0,0,1,100.0
411325,2016,1,0,0,1,100.0
411325,2018,1,0,0,1,100.0
411325,2020,3,0,0,3,100.0
411330,2012,13,0,0,13,100.0
411330,2013,17,0,0,17,100.0
411330,2014,10,0,0,10,100.0
411330,2015,11,0,0,11,100.0
411330,2016,7,0,0,7,100.0
411330,2017,20,0,0,20,100.0
411330,2018,14,0,0,14,100.0
411330,2019,10,0,0,10,100.0
411330,2020,12,0,0,12,100.0
411340,2013,3,0,0,3,100.0
411340,2014,3,0,0,3,100.0
411340,2015,1,0,0,1,100.0
411340,2016,1,0,0,1,100.0
411340,2019,1,0,0,1,100.0
411342,2012,1,0,0,1,100.0
411342,2013,2,0,1,3,66.66666666666666
411342,2015,2,0,0,2,100.0
411342,2016,1,0,0,1,100.0
411342,2017,3,0,0,3,100.0
411342,2019,1,0,0,1,100.0
411342,2020,1,0,0,1,100.0
411345,2012,5,0,0,5,100.0
411345,2013,1,0,0,1,100.0
411345,2015,1,0,0,1,100.0
411345,2017,2,0,0,2,100.0
411345,2019,4,0,0,4,100.0
411350,2012,9,0,0,9,100.0
411350,2013,8,0,0,8,100.0
411350,2014,9,0,0,9,100.0
411350,2015,9,0,1,10,90.0
411350,2016,10,0,0,10,100.0
411350,2017,6,0,0,6,100.0
411350,2018,11,0,0,11,100.0
411350,2019,8,0,0,8,100.0
411350,2020,8,0,0,8,100.0
411360,2013,3,0,0,3,100.0
411360,2014,4,0,0,4,100.0
411360,2016,3,0,0,3,100.0
411360,2017,1,0,0,1,100.0
411360,2018,1,0,0,1,100.0
411360,2019,2,0,0,2,100.0
411360,2020,2,0,0,2,100.0
411370,2012,139,0,0,139,100.0
411370,2013,155,0,0,155,100.0
411370,2014,190,0,0,190,100.0
411370,2015,151,0,0,151,100.0
411370,2016,171,0,0,171,100.0
411370,2017,150,0,0,150,100.0
411370,2018,112,0,1,113,99.11504424778761
411370,2019,132,0,0,132,100.0
411370,2020,146,0,0,146,100.0
411373,2012,1,0,0,1,100.0
411373,2014,1,0,0,1,100.0
411373,2015,4,0,0,4,100.0
411373,2016,3,0,0,3,100.0
411373,2017,3,0,0,3,100.0
411373,2019,5,0,0,5,100.0
411373,2020,1,0,0,1,100.0
411375,2012,3,0,0,3,100.0
411375,2014,1,0,0,1,100.0
411375,2016,1,0,0,1,100.0
411375,2017,1,0,1,2,50.0
411375,2018,2,0,0,2,100.0
411375,2020,2,0,0,2,100.0
411380,2012,3,0,0,3,100.0
411380,2013,3,0,0,3,100.0
411380,2016,1,0,0,1,100.0
411380,2017,3,0,0,3,100.0
411380,2019,1,0,0,1,100.0
411380,2020,2,0,0,2,100.0
411390,2012,1,0,0,1,100.0
411390,2013,3,0,0,3,100.0
411390,2014,4,0,0,4,100.0
411390,2015,2,0,0,2,100.0
411390,2016,4,0,0,4,100.0
411390,2018,4,0,0,4,100.0
411390,2019,3,0,0,3,100.0
411390,2020,1,0,0,1,100.0
411400,2012,4,0,0,4,100.0
411400,2013,5,0,0,5,100.0
411400,2014,3,0,0,3,100.0
411400,2015,8,0,0,8,100.0
411400,2016,6,0,0,6,100.0
411400,2017,4,0,0,4,100.0
411400,2018,3,0,0,3,100.0
411400,2019,5,0,0,5,100.0
411400,2020,2,0,0,2,100.0
411410,2012,9,0,0,9,100.0
411410,2013,7,0,0,7,100.0
411410,2014,3,0,0,3,100.0
411410,2015,8,0,0,8,100.0
411410,2016,5,0,0,5,100.0
411410,2017,9,0,0,9,100.0
411410,2018,5,0,0,5,100.0
411410,2019,11,0,0,11,100.0
411410,2020,6,0,0,6,100.0
411420,2012,11,0,0,11,100.0
411420,2013,13,0,0,13,100.0
411420,2014,10,0,0,10,100.0
411420,2015,8,0,0,8,100.0
411420,2016,9,0,0,9,100.0
411420,2017,16,0,0,16,100.0
411420,2018,15,0,0,15,100.0
411420,2019,6,0,0,6,100.0
411420,2020,8,0,0,8,100.0
411430,2012,12,0,0,12,100.0
411430,2013,11,0,0,11,100.0
411430,2014,12,0,0,12,100.0
411430,2015,12,0,0,12,100.0
411430,2016,4,0,0,4,100.0
411430,2017,8,0,0,8,100.0
411430,2018,5,0,0,5,100.0
411430,2019,8,0,0,8,100.0
411430,2020,4,3,3,10,70.0
411435,2012,3,0,0,3,100.0
411435,2013,1,0,0,1,100.0
411435,2014,1,0,0,1,100.0
411435,2015,0,1,1,2,50.0
411435,2016,3,0,0,3,100.0
411435,2017,1,0,0,1,100.0
411435,2018,1,0,0,1,100.0
411440,2012,4,0,0,4,100.0
411440,2013,11,0,0,11,100.0
411440,2014,4,0,0,4,100.0
411440,2015,2,0,0,2,100.0
411440,2016,11,0,0,11,100.0
411440,2017,7,0,0,7,100.0
411440,2018,6,0,0,6,100.0
411440,2019,8,0,0,8,100.0
411440,2020,6,0,0,6,100.0
411450,2012,5,0,0,5,100.0
411450,2013,5,0,0,5,100.0
411450,2014,4,0,0,4,100.0
411450,2015,7,0,0,7,100.0
411450,2016,2,0,0,2,100.0
411450,2017,4,0,0,4,100.0
411450,2018,8,0,0,8,100.0
411450,2019,3,0,0,3,100.0
411450,2020,4,0,0,4,100.0
411460,2012,10,0,0,10,100.0
411460,2013,11,0,0,11,100.0
411460,2014,21,0,0,21,100.0
411460,2015,18,0,0,18,100.0
411460,2016,22,0,0,22,100.0
411460,2017,13,0,0,13,100.0
411460,2018,13,0,0,13,100.0
411460,2019,16,0,0,16,100.0
411460,2020,10,0,0,10,100.0
411470,2012,1,0,0,1,100.0
411470,2013,2,0,0,2,100.0
411470,2015,2,0,0,2,100.0
411470,2016,1,0,0,1,100.0
411470,2017,3,0,0,3,100.0
411470,2018,2,0,0,2,100.0
411470,2019,2,0,0,2,100.0
411470,2020,4,0,0,4,100.0
411480,2012,10,0,0,10,100.0
411480,2013,9,0,0,9,100.0
411480,2014,5,0,0,5,100.0
411480,2015,6,0,0,6,100.0
411480,2016,10,0,0,10,100.0
411480,2017,7,0,0,7,100.0
411480,2018,9,0,0,9,100.0
411480,2019,15,0,0,15,100.0
411480,2020,4,0,0,4,100.0
411490,2012,3,0,0,3,100.0
411490,2013,2,0,0,2,100.0
411490,2014,1,0,0,1,100.0
411490,2015,2,0,0,2,100.0
411490,2016,4,0,0,4,100.0
411490,2017,1,0,0,1,100.0
411490,2018,2,0,0,2,100.0
411490,2019,4,0,0,4,100.0
411490,2020,3,0,0,3,100.0
411500,2012,1,0,0,1,100.0
411500,2013,2,0,0,2,100.0
411500,2014,2,0,0,2,100.0
411500,2015,2,0,0,2,100.0
411500,2016,1,1,0,2,100.0
411500,2017,3,0,0,3,100.0
411500,2018,3,0,0,3,100.0
411500,2019,3,0,0,3,100.0
411500,2020,5,0,0,5,100.0
411510,2012,5,0,0,5,100.0
411510,2013,8,0,0,8,100.0
411510,2014,1,0,0,1,100.0
411510,2015,6,0,0,6,100.0
411510,2016,3,0,0,3,100.0
411510,2017,4,0,0,4,100.0
411510,2018,3,0,0,3,100.0
411510,2019,4,0,0,4,100.0
411510,2020,5,0,0,5,100.0
411520,2012,130,0,0,130,100.0
411520,2013,95,0,0,95,100.0
411520,2014,106,0,0,106,100.0
411520,2015,90,0,0,90,100.0
411520,2016,105,0,0,105,100.0
411520,2017,82,0,0,82,100.0
411520,2018,101,0,0,101,100.0
411520,2019,77,0,0,77,100.0
411520,2020,85,0,0,85,100.0
411530,2012,7,0,0,7,100.0
411530,2013,1,0,0,1,100.0
411530,2014,2,0,0,2,100.0
411530,2015,1,0,0,1,100.0
411530,2016,5,0,0,5,100.0
411530,2017,3,0,0,3,100.0
411530,2018,5,0,0,5,100.0
411530,2019,2,0,0,2,100.0
411530,2020,1,0,0,1,100.0
411535,2012,1,0,0,1,100.0
411535,2013,1,0,0,1,100.0
411535,2014,2,0,0,2,100.0
411535,2017,3,0,0,3,100.0
411535,2018,1,0,0,1,100.0
411535,2019,2,0,0,2,100.0
411535,2020,3,0,0,3,100.0
411540,2012,5,0,0,5,100.0
411540,2013,5,0,0,5,100.0
411540,2014,7,0,0,7,100.0
411540,2015,4,0,0,4,100.0
411540,2016,6,0,0,6,100.0
411540,2018,2,0,0,2,100.0
411540,2019,5,0,0,5,100.0
411540,2020,5,0,0,5,100.0
411545,2012,2,0,0,2,100.0
411545,2015,2,0,0,2,100.0
411545,2018,1,0,0,1,100.0
411545,2019,1,0,0,1,100.0
411545,2020,2,0,0,2,100.0
411550,2012,2,0,0,2,100.0
411550,2013,3,0,0,3,100.0
411550,2015,3,0,0,3,100.0
411550,2016,1,0,0,1,100.0
411550,2018,1,0,0,1,100.0
411550,2019,3,0,0,3,100.0
411550,2020,4,0,0,4,100.0
411560,2012,8,0,0,8,100.0
411560,2013,7,0,0,7,100.0
411560,2014,9,0,0,9,100.0
411560,2015,1,0,0,1,100.0
411560,2016,4,0,0,4,100.0
411560,2017,7,0,0,7,100.0
411560,2018,6,1,0,7,100.0
411560,2019,5,0,0,5,100.0
411560,2020,5,0,0,5,100.0
411570,2012,10,0,0,10,100.0
411570,2013,9,0,0,9,100.0
411570,2014,13,0,0,13,100.0
411570,2015,15,0,0,15,100.0
411570,2016,10,0,0,10,100.0
411570,2017,13,1,0,14,100.0
411570,2018,19,0,0,19,100.0
411570,2019,13,0,0,13,100.0
411570,2020,15,2,1,18,94.44444444444444
411573,2012,2,0,0,2,100.0
411573,2014,1,0,0,1,100.0
411573,2016,1,0,0,1,100.0
411573,2017,0,1,0,1,100.0
411573,2020,3,0,1,4,75.0
411575,2012,3,0,0,3,100.0
411575,2013,6,0,0,6,100.0
411575,2014,3,0,0,3,100.0
411575,2015,7,0,0,7,100.0
411575,2016,3,0,0,3,100.0
411575,2017,1,0,0,1,100.0
411575,2018,3,0,0,3,100.0
411575,2019,5,0,0,5,100.0
411575,2020,3,0,0,3,100.0
411580,2012,16,0,0,16,100.0
411580,2013,8,0,0,8,100.0
411580,2014,9,0,0,9,100.0
411580,2015,14,0,0,14,100.0
411580,2016,20,0,0,20,100.0
411580,2017,14,0,0,14,100.0
411580,2018,13,0,0,13,100.0
411580,2019,13,0,1,14,92.85714285714286
411580,2020,20,0,0,20,100.0
411585,2012,3,0,0,3,100.0
411585,2013,2,0,0,2,100.0
411585,2014,4,0,0,4,100.0
411585,2015,2,0,0,2,100.0
411585,2016,1,0,0,1,100.0
411585,2017,3,0,0,3,100.0
411585,2018,4,0,0,4,100.0
411585,2019,1,0,0,1,100.0
411590,2014,2,0,0,2,100.0
411590,2016,1,0,0,1,100.0
411590,2017,3,0,0,3,100.0
411590,2019,1,0,0,1,100.0
411590,2020,1,0,0,1,100.0
411600,2014,2,0,0,2,100.0
411600,2017,1,0,0,1,100.0
411600,2019,1,0,0,1,100.0
411605,2012,6,0,0,6,100.0
411605,2013,2,0,2,4,50.0
411605,2014,4,0,0,4,100.0
411605,2015,1,0,0,1,100.0
411605,2016,1,0,0,1,100.0
411605,2017,5,0,0,5,100.0
411605,2018,6,0,0,6,100.0
411605,2019,2,0,0,2,100.0
411605,2020,3,0,0,3,100.0
411610,2012,5,0,0,5,100.0
411610,2013,2,0,0,2,100.0
411610,2014,4,0,0,4,100.0
411610,2015,3,0,0,3,100.0
411610,2016,2,0,0,2,100.0
411610,2017,6,0,0,6,100.0
411610,2018,4,0,0,4,100.0
411610,2019,5,0,0,5,100.0
411610,2020,1,1,3,5,40.0
411620,2012,7,0,0,7,100.0
411620,2013,12,0,0,12,100.0
411620,2014,12,0,0,12,100.0
411620,2015,3,0,0,3,100.0
411620,2016,9,1,0,10,100.0
411620,2017,6,0,0,6,100.0
411620,2018,8,0,0,8,100.0
411620,2019,6,0,0,6,100.0
411620,2020,8,2,1,11,90.9090909090909
411630,2013,1,0,0,1,100.0
411630,2014,2,0,0,2,100.0
411630,2015,1,0,0,1,100.0
411630,2016,2,0,0,2,100.0
411640,2012,5,0,0,5,100.0
411640,2013,2,0,0,2,100.0
411640,2014,1,0,0,1,100.0
411640,2015,1,0,0,1,100.0
411640,2016,4,0,0,4,100.0
411640,2017,1,0,0,1,100.0
411640,2018,2,0,0,2,100.0
411640,2020,2,0,0,2,100.0
411650,2020,1,0,0,1,100.0
411660,2013,1,0,0,1,100.0
411660,2014,2,0,0,2,100.0
411660,2015,1,0,0,1,100.0
411660,2017,1,0,0,1,100.0
411660,2019,2,0,0,2,100.0
411660,2020,1,0,0,1,100.0
411670,2012,6,0,0,6,100.0
411670,2013,6,0,0,6,100.0
411670,2014,4,0,0,4,100.0
411670,2015,2,0,0,2,100.0
411670,2016,2,0,0,2,100.0
411670,2017,3,0,0,3,100.0
411670,2018,7,0,0,7,100.0
411670,2019,3,0,0,3,100.0
411670,2020,10,0,0,10,100.0
411680,2014,4,0,0,4,100.0
411680,2015,3,2,0,5,100.0
411680,2017,1,0,0,1,100.0
411680,2018,4,0,0,4,100.0
411680,2019,3,0,0,3,100.0
411680,2020,5,0,0,5,100.0
411690,2012,5,0,0,5,100.0
411690,2013,6,0,0,6,100.0
411690,2014,11,0,0,11,100.0
411690,2015,7,0,0,7,100.0
411690,2016,3,0,0,3,100.0
411690,2017,8,0,0,8,100.0
411690,2018,10,0,0,10,100.0
411690,2019,10,0,0,10,100.0
411690,2020,7,0,0,7,100.0
411695,2012,2,0,0,2,100.0
411695,2013,2,0,0,2,100.0
411695,2014,1,0,0,1,100.0
411695,2016,0,0,1,1,0.0
411695,2017,0,0,2,2,0.0
411695,2018,0,0,1,1,0.0
411695,2020,1,0,0,1,100.0
411700,2012,4,0,0,4,100.0
411700,2013,4,0,0,4,100.0
411700,2014,1,0,0,1,100.0
411700,2015,2,0,0,2,100.0
411700,2016,4,0,0,4,100.0
411700,2017,2,0,0,2,100.0
411700,2018,1,0,0,1,100.0
411700,2019,2,0,0,2,100.0
411700,2020,1,0,0,1,100.0
411705,2012,7,0,0,7,100.0
411705,2013,4,0,0,4,100.0
411705,2014,3,0,0,3,100.0
411705,2015,5,0,0,5,100.0
411705,2016,8,0,0,8,100.0
411705,2017,4,0,0,4,100.0
411705,2018,4,0,0,4,100.0
411705,2019,10,0,0,10,100.0
411705,2020,8,0,0,8,100.0
411710,2012,7,0,0,7,100.0
411710,2013,6,0,0,6,100.0
411710,2014,3,0,0,3,100.0
411710,2015,3,0,0,3,100.0
411710,2016,1,0,0,1,100.0
411710,2017,4,0,0,4,100.0
411710,2018,5,0,0,5,100.0
411710,2019,2,0,0,2,100.0
411720,2012,3,0,0,3,100.0
411720,2013,1,0,0,1,100.0
411720,2014,1,0,0,1,100.0
411720,2015,3,0,0,3,100.0
411720,2016,2,0,0,2,100.0
411720,2017,2,0,0,2,100.0
411720,2018,1,0,0,1,100.0
411720,2019,2,0,0,2,100.0
411720,2020,4,0,0,4,100.0
411721,2012,2,0,0,2,100.0
411721,2013,2,0,0,2,100.0
411721,2016,3,0,0,3,100.0
411721,2018,1,0,0,1,100.0
411721,2019,1,0,0,1,100.0
411722,2012,2,0,0,2,100.0
411722,2013,1,0,0,1,100.0
411722,2014,2,0,0,2,100.0
411722,2015,2,0,0,2,100.0
411722,2016,3,0,0,3,100.0
411722,2017,1,0,0,1,100.0
411722,2018,1,0,0,1,100.0
411722,2020,3,0,0,3,100.0
411725,2012,4,0,0,4,100.0
411725,2013,5,0,0,5,100.0
411725,2014,7,0,0,7,100.0
411725,2015,4,0,0,4,100.0
411725,2016,2,0,0,2,100.0
411725,2017,3,0,0,3,100.0
411725,2018,4,0,0,4,100.0
411725,2019,1,0,0,1,100.0
411725,2020,2,0,0,2,100.0
411727,2012,6,0,0,6,100.0
411727,2013,6,0,1,7,85.71428571428571
411727,2014,3,0,0,3,100.0
411727,2015,4,0,0,4,100.0
411727,2016,1,0,0,1,100.0
411727,2017,2,0,0,2,100.0
411727,2018,5,0,0,5,100.0
411727,2020,2,0,0,2,100.0
411729,2014,1,0,0,1,100.0
411729,2016,1,0,0,1,100.0
411729,2017,1,0,0,1,100.0
411729,2018,1,0,0,1,100.0
411729,2019,2,0,0,2,100.0
411729,2020,1,0,0,1,100.0
411730,2012,4,0,0,4,100.0
411730,2013,18,0,0,18,100.0
411730,2014,10,0,0,10,100.0
411730,2015,7,0,0,7,100.0
411730,2016,3,0,0,3,100.0
411730,2017,9,0,0,9,100.0
411730,2018,8,0,0,8,100.0
411730,2019,8,0,0,8,100.0
411730,2020,11,0,1,12,91.66666666666666
411740,2013,1,0,0,1,100.0
411740,2014,1,0,0,1,100.0
411740,2015,1,0,0,1,100.0
411740,2019,1,0,0,1,100.0
411745,2012,3,0,0,3,100.0
411745,2013,1,0,0,1,100.0
411745,2014,1,0,0,1,100.0
411745,2015,1,0,0,1,100.0
411745,2016,4,0,0,4,100.0
411745,2017,2,0,0,2,100.0
411745,2019,2,0,0,2,100.0
411745,2020,2,0,0,2,100.0
411750,2012,12,0,0,12,100.0
411750,2013,15,0,0,15,100.0
411750,2014,9,0,0,9,100.0
411750,2015,12,0,0,12,100.0
411750,2016,8,0,0,8,100.0
411750,2017,11,0,0,11,100.0
411750,2018,13,0,0,13,100.0
411750,2019,8,0,0,8,100.0
411750,2020,16,0,0,16,100.0
411760,2012,30,0,0,30,100.0
411760,2013,21,0,0,21,100.0
411760,2014,21,0,0,21,100.0
411760,2015,16,0,0,16,100.0
411760,2016,24,1,0,25,100.0
411760,2017,22,0,0,22,100.0
411760,2018,18,0,0,18,100.0
411760,2019,14,0,0,14,100.0
411760,2020,11,0,0,11,100.0
411770,2012,9,0,0,9,100.0
411770,2013,13,0,0,13,100.0
411770,2014,10,0,0,10,100.0
411770,2015,9,0,0,9,100.0
411770,2016,9,0,0,9,100.0
411770,2017,13,0,0,13,100.0
411770,2018,6,0,0,6,100.0
411770,2019,15,0,1,16,93.75
411770,2020,9,0,0,9,100.0
411780,2012,2,0,0,2,100.0
411780,2013,3,0,0,3,100.0
411780,2014,6,0,0,6,100.0
411780,2015,7,0,0,7,100.0
411780,2016,7,0,0,7,100.0
411780,2017,7,0,0,7,100.0
411780,2018,4,0,0,4,100.0
411780,2019,3,0,0,3,100.0
411780,2020,6,0,0,6,100.0
411790,2012,5,0,0,5,100.0
411790,2013,7,0,0,7,100.0
411790,2014,4,0,0,4,100.0
411790,2015,10,0,0,10,100.0
411790,2016,9,0,0,9,100.0
411790,2017,11,0,0,11,100.0
411790,2018,10,0,0,10,100.0
411790,2019,8,0,0,8,100.0
411790,2020,8,0,0,8,100.0
411800,2012,4,0,0,4,100.0
411800,2013,3,0,0,3,100.0
411800,2014,2,0,0,2,100.0
411800,2015,5,0,0,5,100.0
411800,2016,3,0,0,3,100.0
411800,2017,5,0,0,5,100.0
411800,2018,3,0,0,3,100.0
411800,2019,2,0,0,2,100.0
411800,2020,6,0,0,6,100.0
411810,2012,3,0,0,3,100.0
411810,2013,5,0,0,5,100.0
411810,2014,1,0,0,1,100.0
411810,2015,2,0,0,2,100.0
411810,2016,2,0,0,2,100.0
411810,2017,3,0,0,3,100.0
411810,2018,7,0,0,7,100.0
411810,2019,1,0,0,1,100.0
411810,2020,3,0,0,3,100.0
411820,2012,56,0,0,56,100.0
411820,2013,62,0,0,62,100.0
411820,2014,62,0,0,62,100.0
411820,2015,54,0,0,54,100.0
411820,2016,68,0,0,68,100.0
411820,2017,60,3,2,65,96.92307692307692
411820,2018,66,0,0,66,100.0
411820,2019,58,0,0,58,100.0
411820,2020,67,0,0,67,100.0
411830,2013,2,0,0,2,100.0
411830,2014,1,0,0,1,100.0
411830,2015,1,0,0,1,100.0
411830,2016,1,0,0,1,100.0
411830,2017,1,0,0,1,100.0
411830,2018,1,0,0,1,100.0
411830,2020,3,0,0,3,100.0
411840,2012,36,0,0,36,100.0
411840,2013,27,0,0,27,100.0
411840,2014,33,0,0,33,100.0
411840,2015,31,0,0,31,100.0
411840,2016,28,0,0,28,100.0
411840,2017,20,0,0,20,100.0
411840,2018,22,0,0,22,100.0
411840,2019,28,0,0,28,100.0
411840,2020,24,0,0,24,100.0
411845,2012,1,0,0,1,100.0
411845,2013,1,0,0,1,100.0
411845,2014,1,0,0,1,100.0
411845,2015,2,0,0,2,100.0
411845,2016,1,0,0,1,100.0
411845,2017,2,0,0,2,100.0
411845,2018,1,0,0,1,100.0
411845,2019,2,0,0,2,100.0
411845,2020,2,0,0,2,100.0
411850,2012,20,0,0,20,100.0
411850,2013,29,0,0,29,100.0
411850,2014,23,0,0,23,100.0
411850,2015,17,0,0,17,100.0
411850,2016,31,0,0,31,100.0
411850,2017,23,0,0,23,100.0
411850,2018,28,0,0,28,100.0
411850,2019,27,0,0,27,100.0
411850,2020,23,0,0,23,100.0
411860,2012,2,0,0,2,100.0
411860,2013,1,0,0,1,100.0
411860,2014,3,0,0,3,100.0
411860,2015,1,0,0,1,100.0
411860,2016,1,0,0,1,100.0
411860,2017,4,0,0,4,100.0
411860,2018,2,0,0,2,100.0
411860,2019,2,0,0,2,100.0
411860,2020,2,0,0,2,100.0
411870,2012,4,0,0,4,100.0
411870,2014,1,0,0,1,100.0
411870,2015,3,0,0,3,100.0
411870,2016,2,0,0,2,100.0
411870,2017,3,0,0,3,100.0
411870,2018,2,0,0,2,100.0
411870,2019,2,0,0,2,100.0
411870,2020,1,0,0,1,100.0
411880,2012,5,0,0,5,100.0
411880,2013,5,0,0,5,100.0
411880,2014,7,0,0,7,100.0
411880,2015,4,0,0,4,100.0
411880,2016,2,0,0,2,100.0
411880,2017,6,0,0,6,100.0
411880,2018,4,0,0,4,100.0
411880,2019,4,0,0,4,100.0
411880,2020,5,0,0,5,100.0
411885,2012,3,0,0,3,100.0
411885,2013,1,0,0,1,100.0
411885,2014,1,0,0,1,100.0
411885,2015,1,0,0,1,100.0
411885,2016,1,0,0,1,100.0
411885,2017,3,0,0,3,100.0
411885,2018,2,0,0,2,100.0
411885,2019,2,0,0,2,100.0
411885,2020,1,0,0,1,100.0
411890,2012,3,0,0,3,100.0
411890,2013,4,0,0,4,100.0
411890,2014,3,0,0,3,100.0
411890,2015,7,0,0,7,100.0
411890,2016,5,0,0,5,100.0
411890,2017,3,0,0,3,100.0
411890,2018,5,0,1,6,83.33333333333334
411890,2019,3,0,0,3,100.0
411890,2020,4,0,0,4,100.0
411900,2013,2,0,0,2,100.0
411900,2014,1,0,0,1,100.0
411900,2015,0,0,3,3,0.0
411900,2016,1,0,0,1,100.0
411900,2017,3,0,0,3,100.0
411900,2019,1,0,0,1,100.0
411900,2020,2,0,0,2,100.0
411910,2012,4,0,0,4,100.0
411910,2013,2,0,0,2,100.0
411910,2014,5,0,0,5,100.0
411910,2015,3,0,0,3,100.0
411910,2016,2,0,0,2,100.0
411910,2017,6,0,0,6,100.0
411910,2018,2,0,0,2,100.0
411910,2019,3,0,0,3,100.0
411910,2020,5,0,0,5,100.0
411915,2012,44,0,0,44,100.0
411915,2013,47,0,0,47,100.0
411915,2014,42,0,0,42,100.0
411915,2015,48,0,0,48,100.0
411915,2016,48,0,0,48,100.0
411915,2017,37,0,0,37,100.0
411915,2018,38,0,0,38,100.0
411915,2019,44,0,0,44,100.0
411915,2020,37,0,0,37,100.0
411920,2012,1,0,0,1,100.0
411920,2013,2,0,0,2,100.0
411920,2014,3,0,0,3,100.0
411920,2015,1,0,0,1,100.0
411920,2016,4,0,0,4,100.0
411920,2017,2,0,0,2,100.0
411920,2018,4,0,0,4,100.0
411920,2019,1,0,0,1,100.0
411920,2020,3,0,0,3,100.0
411925,2012,1,0,0,1,100.0
411925,2014,1,0,0,1,100.0
411925,2015,2,0,0,2,100.0
411925,2017,1,0,0,1,100.0
411925,2018,1,0,0,1,100.0
411925,2019,1,0,0,1,100.0
411930,2012,15,0,0,15,100.0
411930,2013,8,0,0,8,100.0
411930,2014,13,0,0,13,100.0
411930,2015,17,0,0,17,100.0
411930,2016,17,0,0,17,100.0
411930,2017,18,0,0,18,100.0
411930,2018,17,0,0,17,100.0
411930,2019,12,0,0,12,100.0
411930,2020,17,0,0,17,100.0
411940,2012,11,0,0,11,100.0
411940,2013,8,0,0,8,100.0
411940,2014,14,0,0,14,100.0
411940,2015,7,0,0,7,100.0
411940,2016,11,0,0,11,100.0
411940,2017,7,0,0,7,100.0
411940,2018,4,0,0,4,100.0
411940,2019,12,0,0,12,100.0
411940,2020,7,0,0,7,100.0
411950,2012,47,0,0,47,100.0
411950,2013,48,0,0,48,100.0
411950,2014,39,0,0,39,100.0
411950,2015,35,0,0,35,100.0
411950,2016,32,0,0,32,100.0
411950,2017,42,0,0,42,100.0
411950,2018,35,0,0,35,100.0
411950,2019,30,0,0,30,100.0
411950,2020,51,0,1,52,98.07692307692307
411960,2012,14,0,0,14,100.0
411960,2013,15,0,0,15,100.0
411960,2014,5,0,0,5,100.0
411960,2015,9,0,0,9,100.0
411960,2016,8,0,0,8,100.0
411960,2017,14,0,0,14,100.0
411960,2018,6,0,0,6,100.0
411960,2019,11,0,0,11,100.0
411960,2020,7,0,0,7,100.0
411965,2012,1,0,0,1,100.0
411965,2014,2,0,0,2,100.0
411965,2015,2,0,0,2,100.0
411965,2016,4,0,0,4,100.0
411965,2017,1,0,0,1,100.0
411965,2018,1,0,0,1,100.0
411965,2019,3,0,0,3,100.0
411965,2020,1,0,0,1,100.0
411970,2012,2,0,0,2,100.0
411970,2013,4,0,0,4,100.0
411970,2014,4,0,0,4,100.0
411970,2016,1,0,0,1,100.0
411970,2017,3,0,0,3,100.0
411970,2018,1,0,0,1,100.0
411970,2019,2,0,0,2,100.0
411970,2020,5,0,0,5,100.0
411980,2012,3,0,0,3,100.0
411980,2013,3,0,0,3,100.0
411980,2014,5,0,0,5,100.0
411980,2015,7,0,0,7,100.0
411980,2016,3,0,0,3,100.0
411980,2017,3,0,0,3,100.0
411980,2018,5,0,0,5,100.0
411980,2019,6,0,0,6,100.0
411980,2020,5,0,0,5,100.0
411990,2012,99,0,0,99,100.0
411990,2013,105,0,0,105,100.0
411990,2014,101,1,2,104,98.07692307692307
411990,2015,124,1,0,125,100.0
411990,2016,124,0,0,124,100.0
411990,2017,101,0,0,101,100.0
411990,2018,105,0,0,105,100.0
411990,2019,96,0,0,96,100.0
411990,2020,112,0,0,112,100.0
411995,2012,8,0,0,8,100.0
411995,2013,8,0,0,8,100.0
411995,2014,10,0,0,10,100.0
411995,2015,9,0,0,9,100.0
411995,2016,8,3,4,15,73.33333333333333
411995,2017,12,0,0,12,100.0
411995,2018,11,0,0,11,100.0
411995,2019,13,0,0,13,100.0
411995,2020,8,0,3,11,72.72727272727273
412000,2012,8,0,0,8,100.0
412000,2013,9,0,0,9,100.0
412000,2014,4,0,0,4,100.0
412000,2015,8,0,0,8,100.0
412000,2016,3,0,0,3,100.0
412000,2018,7,0,0,7,100.0
412000,2019,3,0,0,3,100.0
412000,2020,3,0,0,3,100.0
412010,2012,2,0,0,2,100.0
412010,2013,3,0,0,3,100.0
412010,2014,2,0,0,2,100.0
412010,2015,2,0,0,2,100.0
412010,2016,1,0,1,2,50.0
412010,2018,2,0,0,2,100.0
412010,2020,1,0,0,1,100.0
412015,2013,1,0,0,1,100.0
412015,2014,2,0,0,2,100.0
412015,2015,2,0,0,2,100.0
412015,2017,3,0,0,3,100.0
412015,2018,2,0,0,2,100.0
412015,2019,2,0,0,2,100.0
412015,2020,2,0,0,2,100.0
412020,2013,2,0,0,2,100.0
412020,2014,2,0,0,2,100.0
412020,2015,1,0,0,1,100.0
412020,2016,2,0,0,2,100.0
412020,2018,1,0,0,1,100.0
412020,2019,1,0,0,1,100.0
412020,2020,3,0,0,3,100.0
412030,2013,1,0,0,1,100.0
412030,2014,1,0,0,1,100.0
412030,2015,5,0,0,5,100.0
412030,2016,2,0,0,2,100.0
412030,2018,2,0,0,2,100.0
412030,2019,2,0,0,2,100.0
412030,2020,1,0,0,1,100.0
412033,2013,1,0,0,1,100.0
412033,2014,4,0,0,4,100.0
412033,2016,2,0,0,2,100.0
412033,2017,1,0,0,1,100.0
412033,2020,3,0,0,3,100.0
412035,2014,3,0,0,3,100.0
412035,2015,1,0,0,1,100.0
412035,2017,6,0,0,6,100.0
412035,2018,1,0,0,1,100.0
412035,2020,3,0,0,3,100.0
412040,2012,1,0,0,1,100.0
412040,2013,2,0,0,2,100.0
412040,2014,1,0,0,1,100.0
412040,2015,3,0,0,3,100.0
412040,2016,1,0,0,1,100.0
412040,2019,1,0,0,1,100.0
412040,2020,1,0,0,1,100.0
412050,2012,6,0,0,6,100.0
412050,2013,3,0,0,3,100.0
412050,2014,1,0,0,1,100.0
412050,2015,7,0,0,7,100.0
412050,2016,0,1,1,2,50.0
412050,2017,3,0,1,4,75.0
412050,2018,7,0,0,7,100.0
412050,2019,2,0,0,2,100.0
412050,2020,6,0,0,6,100.0
412060,2012,26,0,0,26,100.0
412060,2013,20,0,0,20,100.0
412060,2014,10,0,0,10,100.0
412060,2015,18,0,0,18,100.0
412060,2016,5,1,0,6,100.0
412060,2017,14,0,0,14,100.0
412060,2018,12,0,0,12,100.0
412060,2019,12,0,0,12,100.0
412060,2020,16,0,0,16,100.0
412065,2012,2,0,0,2,100.0
412065,2013,1,0,0,1,100.0
412065,2014,1,0,2,3,33.33333333333333
412065,2015,1,0,0,1,100.0
412065,2016,1,0,1,2,50.0
412065,2017,3,0,0,3,100.0
412065,2018,2,0,0,2,100.0
412065,2019,4,0,0,4,100.0
412065,2020,3,0,0,3,100.0
412070,2012,2,0,0,2,100.0
412070,2013,4,0,0,4,100.0
412070,2014,3,0,0,3,100.0
412070,2015,5,0,0,5,100.0
412070,2016,5,0,0,5,100.0
412070,2017,3,0,0,3,100.0
412070,2018,5,0,0,5,100.0
412070,2019,4,0,0,4,100.0
412070,2020,2,0,0,2,100.0
412080,2012,11,0,0,11,100.0
412080,2013,8,0,0,8,100.0
412080,2014,8,0,0,8,100.0
412080,2015,8,0,0,8,100.0
412080,2016,12,0,0,12,100.0
412080,2017,6,0,0,6,100.0
412080,2018,4,0,0,4,100.0
412080,2019,6,0,0,6,100.0
412080,2020,5,0,0,5,100.0
412085,2012,2,0,0,2,100.0
412085,2013,1,0,0,1,100.0
412085,2014,1,0,0,1,100.0
412085,2015,3,0,0,3,100.0
412085,2016,4,0,0,4,100.0
412085,2019,2,0,0,2,100.0
412085,2020,4,0,0,4,100.0
412090,2012,17,0,0,17,100.0
412090,2013,10,0,0,10,100.0
412090,2014,12,0,0,12,100.0
412090,2015,8,1,0,9,100.0
412090,2016,14,0,0,14,100.0
412090,2017,12,0,0,12,100.0
412090,2018,11,0,0,11,100.0
412090,2019,10,0,0,10,100.0
412090,2020,8,0,0,8,100.0
412100,2012,2,0,0,2,100.0
412100,2013,3,0,0,3,100.0
412100,2014,7,0,0,7,100.0
412100,2015,2,0,0,2,100.0
412100,2016,6,0,0,6,100.0
412100,2017,3,0,0,3,100.0
412100,2018,2,0,0,2,100.0
412100,2019,6,0,0,6,100.0
412100,2020,3,0,0,3,100.0
412110,2012,1,0,0,1,100.0
412110,2013,3,0,0,3,100.0
412110,2014,2,0,0,2,100.0
412110,2015,2,0,0,2,100.0
412110,2016,4,0,0,4,100.0
412110,2017,1,0,0,1,100.0
412110,2018,1,0,0,1,100.0
412110,2020,1,0,0,1,100.0
412120,2012,5,0,0,5,100.0
412120,2013,7,0,0,7,100.0
412120,2014,7,0,0,7,100.0
412120,2015,9,0,0,9,100.0
412120,2016,8,0,0,8,100.0
412120,2017,5,0,0,5,100.0
412120,2018,4,0,0,4,100.0
412120,2019,7,0,0,7,100.0
412120,2020,10,0,0,10,100.0
412125,2012,2,0,0,2,100.0
412125,2013,1,0,0,1,100.0
412125,2014,0,0,1,1,0.0
412125,2015,1,0,1,2,50.0
412125,2018,1,0,0,1,100.0
412130,2012,1,0,0,1,100.0
412130,2014,1,0,0,1,100.0
412130,2015,3,0,0,3,100.0
412130,2016,2,0,0,2,100.0
412130,2017,1,0,0,1,100.0
412130,2019,2,0,0,2,100.0
412130,2020,1,0,0,1,100.0
412135,2013,2,0,0,2,100.0
412135,2015,0,0,1,1,0.0
412135,2017,1,0,0,1,100.0
412135,2018,1,0,0,1,100.0
412135,2020,1,0,1,2,50.0
412140,2012,2,0,0,2,100.0
412140,2013,8,0,0,8,100.0
412140,2014,10,0,0,10,100.0
412140,2015,2,0,0,2,100.0
412140,2016,4,0,0,4,100.0
412140,2017,6,0,0,6,100.0
412140,2018,7,0,0,7,100.0
412140,2019,8,0,0,8,100.0
412140,2020,4,0,0,4,100.0
412150,2012,4,0,0,4,100.0
412150,2013,4,0,0,4,100.0
412150,2014,8,0,0,8,100.0
412150,2015,1,0,0,1,100.0
412150,2016,7,0,0,7,100.0
412150,2017,3,0,0,3,100.0
412150,2018,7,0,0,7,100.0
412150,2019,7,0,0,7,100.0
412150,2020,1,0,0,1,100.0
412160,2012,1,0,0,1,100.0
412160,2013,1,0,0,1,100.0
412160,2014,1,0,0,1,100.0
412160,2015,1,0,0,1,100.0
412160,2016,1,0,0,1,100.0
412160,2017,1,0,0,1,100.0
412160,2018,1,0,0,1,100.0
412160,2019,3,0,0,3,100.0
412170,2012,12,0,0,12,100.0
412170,2013,3,0,0,3,100.0
412170,2014,9,0,0,9,100.0
412170,2015,9,0,0,9,100.0
412170,2016,8,0,0,8,100.0
412170,2017,10,0,0,10,100.0
412170,2018,11,0,0,11,100.0
412170,2019,9,0,0,9,100.0
412170,2020,11,0,0,11,100.0
412175,2012,2,0,0,2,100.0
412175,2013,2,0,0,2,100.0
412175,2014,1,0,0,1,100.0
412175,2015,2,0,0,2,100.0
412175,2016,2,0,0,2,100.0
412175,2018,3,0,0,3,100.0
412175,2019,2,0,0,2,100.0
412175,2020,2,0,0,2,100.0
412180,2012,2,0,0,2,100.0
412180,2014,3,0,0,3,100.0
412180,2015,5,0,0,5,100.0
412180,2016,5,0,0,5,100.0
412180,2017,3,0,0,3,100.0
412180,2018,6,0,0,6,100.0
412180,2019,4,0,0,4,100.0
412180,2020,2,0,0,2,100.0
412190,2012,6,0,0,6,100.0
412190,2013,1,0,0,1,100.0
412190,2014,3,0,0,3,100.0
412190,2015,7,0,0,7,100.0
412190,2016,10,0,0,10,100.0
412190,2017,4,0,0,4,100.0
412190,2018,2,0,0,2,100.0
412190,2019,5,0,0,5,100.0
412190,2020,8,0,0,8,100.0
412200,2012,3,0,0,3,100.0
412200,2013,3,0,0,3,100.0
412200,2014,3,0,0,3,100.0
412200,2015,4,0,0,4,100.0
412200,2016,5,0,0,5,100.0
412200,2017,1,0,0,1,100.0
412200,2018,4,0,0,4,100.0
412200,2019,4,0,0,4,100.0
412200,2020,3,0,0,3,100.0
412210,2012,2,0,0,2,100.0
412210,2015,1,0,0,1,100.0
412210,2017,2,0,0,2,100.0
412210,2018,2,0,0,2,100.0
412210,2019,3,0,0,3,100.0
412210,2020,1,0,0,1,100.0
412215,2012,8,0,0,8,100.0
412215,2013,5,0,0,5,100.0
412215,2014,3,0,0,3,100.0
412215,2015,4,0,0,4,100.0
412215,2016,3,0,0,3,100.0
412215,2017,3,0,0,3,100.0
412215,2018,4,0,0,4,100.0
412215,2019,12,0,0,12,100.0
412215,2020,5,0,0,5,100.0
412217,2014,2,0,0,2,100.0
412217,2015,1,0,0,1,100.0
412217,2016,1,0,0,1,100.0
412217,2018,3,0,0,3,100.0
412217,2019,1,0,0,1,100.0
412220,2012,11,0,0,11,100.0
412220,2013,15,0,0,15,100.0
412220,2014,10,0,0,10,100.0
412220,2015,6,0,0,6,100.0
412220,2016,14,0,0,14,100.0
412220,2017,9,0,0,9,100.0
412220,2018,8,0,0,8,100.0
412220,2019,10,0,0,10,100.0
412220,2020,12,0,0,12,100.0
412230,2012,10,0,0,10,100.0
412230,2013,12,0,0,12,100.0
412230,2014,4,0,0,4,100.0
412230,2015,9,0,0,9,100.0
412230,2016,18,0,0,18,100.0
412230,2017,6,0,0,6,100.0
412230,2018,11,0,0,11,100.0
412230,2019,8,0,0,8,100.0
412230,2020,5,0,0,5,100.0
412240,2012,17,0,0,17,100.0
412240,2013,25,0,0,25,100.0
412240,2014,20,0,0,20,100.0
412240,2015,22,0,0,22,100.0
412240,2016,23,0,0,23,100.0
412240,2017,19,0,0,19,100.0
412240,2018,18,0,0,18,100.0
412240,2019,17,0,0,17,100.0
412240,2020,18,0,0,18,100.0
412250,2012,4,0,0,4,100.0
412250,2013,2,0,0,2,100.0
412250,2014,2,0,0,2,100.0
412250,2015,8,0,0,8,100.0
412250,2016,3,0,0,3,100.0
412250,2017,4,0,0,4,100.0
412250,2018,5,0,0,5,100.0
412250,2019,2,0,0,2,100.0
412250,2020,2,0,0,2,100.0
412260,2012,1,0,0,1,100.0
412260,2013,2,0,0,2,100.0
412260,2014,3,0,0,3,100.0
412260,2015,3,0,0,3,100.0
412260,2016,5,0,0,5,100.0
412260,2017,3,0,0,3,100.0
412260,2018,7,0,0,7,100.0
412260,2019,3,0,0,3,100.0
412260,2020,3,0,0,3,100.0
412265,2012,2,0,0,2,100.0
412265,2013,2,0,0,2,100.0
412265,2014,1,0,0,1,100.0
412265,2016,2,0,0,2,100.0
412265,2017,1,0,0,1,100.0
412265,2019,2,0,0,2,100.0
412265,2020,1,0,0,1,100.0
412270,2012,5,0,0,5,100.0
412270,2013,2,0,0,2,100.0
412270,2014,3,0,0,3,100.0
412270,2015,5,0,0,5,100.0
412270,2016,2,0,0,2,100.0
412270,2017,2,0,0,2,100.0
412270,2018,3,0,0,3,100.0
412270,2019,2,0,0,2,100.0
412270,2020,1,0,0,1,100.0
412280,2012,1,0,0,1,100.0
412280,2013,2,0,0,2,100.0
412280,2014,3,0,0,3,100.0
412280,2015,1,0,0,1,100.0
412280,2016,1,0,0,1,100.0
412280,2017,2,0,0,2,100.0
412280,2018,3,0,0,3,100.0
412280,2019,1,0,0,1,100.0
412290,2012,2,0,0,2,100.0
412290,2013,1,0,0,1,100.0
412290,2014,4,0,0,4,100.0
412290,2016,4,0,0,4,100.0
412290,2017,1,0,0,1,100.0
412290,2018,2,0,0,2,100.0
412290,2019,2,0,0,2,100.0
412290,2020,3,0,0,3,100.0
412300,2012,5,0,0,5,100.0
412300,2013,4,0,0,4,100.0
412300,2014,5,0,0,5,100.0
412300,2015,6,0,0,6,100.0
412300,2016,1,0,1,2,50.0
412300,2017,3,0,0,3,100.0
412300,2018,8,0,0,8,100.0
412300,2019,1,0,0,1,100.0
412300,2020,5,0,0,5,100.0
412310,2012,3,0,0,3,100.0
412310,2013,3,0,0,3,100.0
412310,2014,1,0,0,1,100.0
412310,2015,3,0,0,3,100.0
412310,2016,2,0,0,2,100.0
412310,2017,1,0,0,1,100.0
412310,2019,2,0,0,2,100.0
412310,2020,1,0,0,1,100.0
412320,2012,2,0,0,2,100.0
412320,2013,2,0,0,2,100.0
412320,2014,5,0,0,5,100.0
412320,2017,1,0,0,1,100.0
412320,2018,2,0,0,2,100.0
412320,2019,4,0,0,4,100.0
412320,2020,2,0,0,2,100.0
412330,2012,2,0,0,2,100.0
412330,2013,3,0,0,3,100.0
412330,2014,1,0,0,1,100.0
412330,2015,4,0,0,4,100.0
412330,2016,2,0,0,2,100.0
412330,2017,4,0,0,4,100.0
412330,2018,3,0,0,3,100.0
412330,2019,2,0,0,2,100.0
412330,2020,3,0,0,3,100.0
412340,2012,3,0,0,3,100.0
412340,2013,6,0,0,6,100.0
412340,2014,4,0,0,4,100.0
412340,2015,3,0,0,3,100.0
412340,2016,4,0,0,4,100.0
412340,2017,5,0,0,5,100.0
412340,2018,4,0,0,4,100.0
412340,2019,4,0,0,4,100.0
412340,2020,7,0,0,7,100.0
412350,2012,11,0,0,11,100.0
412350,2013,14,0,0,14,100.0
412350,2014,6,0,0,6,100.0
412350,2015,6,0,0,6,100.0
412350,2016,9,0,0,9,100.0
412350,2017,5,0,0,5,100.0
412350,2018,4,0,0,4,100.0
412350,2019,8,0,0,8,100.0
412350,2020,12,0,0,12,100.0
412360,2012,3,0,0,3,100.0
412360,2013,1,0,0,1,100.0
412360,2015,1,0,0,1,100.0
412360,2016,1,0,0,1,100.0
412360,2017,1,0,0,1,100.0
412360,2019,1,0,0,1,100.0
412360,2020,1,0,0,1,100.0
412370,2012,2,0,0,2,100.0
412370,2013,5,0,0,5,100.0
412370,2014,4,0,0,4,100.0
412370,2015,1,0,0,1,100.0
412370,2016,2,0,0,2,100.0
412370,2017,4,0,0,4,100.0
412370,2018,1,0,0,1,100.0
412370,2019,1,0,0,1,100.0
412370,2020,4,0,0,4,100.0
412380,2012,4,0,0,4,100.0
412380,2013,4,0,0,4,100.0
412380,2014,6,0,0,6,100.0
412380,2015,7,0,0,7,100.0
412380,2016,2,0,0,2,100.0
412380,2017,4,0,0,4,100.0
412380,2018,2,0,0,2,100.0
412380,2019,5,0,0,5,100.0
412380,2020,2,0,0,2,100.0
412382,2012,2,0,0,2,100.0
412382,2013,2,0,0,2,100.0
412382,2017,1,0,0,1,100.0
412382,2019,3,0,0,3,100.0
412385,2012,3,0,0,3,100.0
412385,2013,3,0,0,3,100.0
412385,2014,3,0,0,3,100.0
412385,2015,2,0,0,2,100.0
412385,2016,2,0,1,3,66.66666666666666
412385,2017,5,0,0,5,100.0
412385,2019,2,0,0,2,100.0
412385,2020,7,0,1,8,87.5
412390,2012,7,0,0,7,100.0
412390,2013,6,0,0,6,100.0
412390,2014,6,0,0,6,100.0
412390,2015,4,0,0,4,100.0
412390,2016,9,0,0,9,100.0
412390,2017,3,0,0,3,100.0
412390,2018,6,0,0,6,100.0
412390,2019,2,0,0,2,100.0
412390,2020,7,0,0,7,100.0
412395,2013,1,0,0,1,100.0
412395,2016,1,0,0,1,100.0
412395,2017,3,0,0,3,100.0
412395,2018,4,0,0,4,100.0
412395,2019,1,0,0,1,100.0
412395,2020,1,0,0,1,100.0
412400,2013,1,0,0,1,100.0
412400,2015,4,0,0,4,100.0
412400,2016,1,0,0,1,100.0
412400,2017,2,0,0,2,100.0
412400,2018,4,0,0,4,100.0
412400,2019,1,0,0,1,100.0
412402,2012,6,0,0,6,100.0
412402,2013,5,0,0,5,100.0
412402,2014,3,0,0,3,100.0
412402,2015,9,0,0,9,100.0
412402,2016,2,0,0,2,100.0
412402,2017,4,0,0,4,100.0
412402,2018,1,0,0,1,100.0
412402,2019,4,0,0,4,100.0
412402,2020,5,0,0,5,100.0
412405,2012,11,0,0,11,100.0
412405,2013,1,0,0,1,100.0
412405,2014,8,0,0,8,100.0
412405,2015,11,0,0,11,100.0
412405,2016,8,0,0,8,100.0
412405,2017,12,0,0,12,100.0
412405,2018,11,0,0,11,100.0
412405,2019,4,0,1,5,80.0
412405,2020,2,0,2,4,50.0
412410,2012,21,0,0,21,100.0
412410,2013,20,0,0,20,100.0
412410,2014,24,0,0,24,100.0
412410,2015,12,0,0,12,100.0
412410,2016,21,0,0,21,100.0
412410,2017,17,0,0,17,100.0
412410,2018,6,0,0,6,100.0
412410,2019,12,0,0,12,100.0
412410,2020,20,0,0,20,100.0
412420,2013,2,0,0,2,100.0
412420,2015,3,0,0,3,100.0
412420,2016,1,0,0,1,100.0
412420,2017,1,0,0,1,100.0
412420,2018,1,0,0,1,100.0
412420,2020,1,0,0,1,100.0
412430,2012,1,0,0,1,100.0
412430,2016,2,0,0,2,100.0
412430,2017,1,0,0,1,100.0
412430,2020,2,0,0,2,100.0
412440,2012,5,0,0,5,100.0
412440,2013,8,0,0,8,100.0
412440,2014,5,0,0,5,100.0
412440,2015,5,0,0,5,100.0
412440,2016,7,0,0,7,100.0
412440,2017,3,0,0,3,100.0
412440,2018,4,0,0,4,100.0
412440,2019,6,0,0,6,100.0
412440,2020,7,0,1,8,87.5
412450,2012,1,0,0,1,100.0
412450,2015,0,1,0,1,100.0
412450,2017,3,0,0,3,100.0
412450,2018,1,0,0,1,100.0
412450,2019,2,0,0,2,100.0
412450,2020,2,0,0,2,100.0
412460,2012,2,0,0,2,100.0
412460,2013,3,0,0,3,100.0
412460,2014,5,0,0,5,100.0
412460,2015,2,0,0,2,100.0
412460,2016,4,0,0,4,100.0
412460,2017,1,0,0,1,100.0
412460,2018,2,0,0,2,100.0
412460,2019,1,0,0,1,100.0
412460,2020,2,0,0,2,100.0
412470,2012,2,0,0,2,100.0
412470,2013,2,0,0,2,100.0
412470,2014,3,0,0,3,100.0
412470,2015,1,0,0,1,100.0
412470,2016,7,0,0,7,100.0
412470,2017,3,0,1,4,75.0
412470,2018,5,0,0,5,100.0
412470,2019,5,0,0,5,100.0
412470,2020,5,0,0,5,100.0
412480,2013,3,0,0,3,100.0
412480,2014,3,0,0,3,100.0
412480,2015,2,0,0,2,100.0
412480,2016,4,0,0,4,100.0
412480,2017,4,0,0,4,100.0
412480,2018,4,0,0,4,100.0
412480,2019,2,0,0,2,100.0
412480,2020,4,0,0,4,100.0
412490,2012,1,0,0,1,100.0
412490,2013,2,0,0,2,100.0
412490,2014,2,0,0,2,100.0
412490,2015,3,0,0,3,100.0
412490,2016,5,0,0,5,100.0
412490,2017,2,0,0,2,100.0
412490,2018,1,0,0,1,100.0
412490,2019,3,0,0,3,100.0
412490,2020,2,0,0,2,100.0
412500,2012,3,0,0,3,100.0
412500,2014,5,0,0,5,100.0
412500,2015,5,0,0,5,100.0
412500,2016,5,0,0,5,100.0
412500,2017,5,0,0,5,100.0
412500,2018,3,0,0,3,100.0
412500,2019,2,0,0,2,100.0
412500,2020,5,0,0,5,100.0
412510,2012,3,0,0,3,100.0
412510,2013,6,1,0,7,100.0
412510,2014,5,0,0,5,100.0
412510,2015,5,0,0,5,100.0
412510,2016,5,0,0,5,100.0
412510,2017,4,0,0,4,100.0
412510,2018,6,0,0,6,100.0
412510,2019,4,0,0,4,100.0
412510,2020,5,0,0,5,100.0
412520,2012,4,0,0,4,100.0
412520,2013,3,0,0,3,100.0
412520,2014,2,0,0,2,100.0
412520,2015,4,0,0,4,100.0
412520,2016,2,0,0,2,100.0
412520,2017,1,0,0,1,100.0
412520,2018,7,0,0,7,100.0
412520,2019,2,0,0,2,100.0
412530,2012,2,0,0,2,100.0
412530,2013,3,0,0,3,100.0
412530,2015,1,0,0,1,100.0
412530,2016,1,0,0,1,100.0
412530,2018,2,0,0,2,100.0
412535,2012,2,0,0,2,100.0
412535,2013,3,0,0,3,100.0
412535,2014,6,0,0,6,100.0
412535,2015,1,0,0,1,100.0
412535,2016,4,0,0,4,100.0
412535,2017,3,0,0,3,100.0
412535,2018,2,0,0,2,100.0
412535,2019,1,0,0,1,100.0
412540,2012,1,0,0,1,100.0
412540,2013,2,0,0,2,100.0
412540,2014,4,0,0,4,100.0
412540,2015,2,0,0,2,100.0
412540,2016,1,0,0,1,100.0
412540,2017,2,0,0,2,100.0
412540,2018,4,0,0,4,100.0
412540,2019,2,0,0,2,100.0
412540,2020,1,0,0,1,100.0
412545,2012,2,0,0,2,100.0
412545,2013,2,0,0,2,100.0
412545,2014,2,0,0,2,100.0
412545,2015,1,0,0,1,100.0
412545,2016,3,0,0,3,100.0
412545,2017,1,0,0,1,100.0
412545,2019,1,0,0,1,100.0
412545,2020,1,0,0,1,100.0
412550,2012,95,1,0,96,100.0
412550,2013,87,0,0,87,100.0
412550,2014,86,0,0,86,100.0
412550,2015,104,0,0,104,100.0
412550,2016,87,0,0,87,100.0
412550,2017,96,0,0,96,100.0
412550,2018,80,0,0,80,100.0
412550,2019,95,0,0,95,100.0
412550,2020,115,0,0,115,100.0
412555,2017,1,0,0,1,100.0
412555,2018,1,0,0,1,100.0
412555,2019,2,0,0,2,100.0
412560,2012,12,0,0,12,100.0
412560,2013,9,0,0,9,100.0
412560,2014,13,0,0,13,100.0
412560,2015,10,1,0,11,100.0
412560,2016,13,0,0,13,100.0
412560,2017,6,0,0,6,100.0
412560,2018,16,0,0,16,100.0
412560,2019,13,0,0,13,100.0
412560,2020,13,0,0,13,100.0
412570,2012,10,0,0,10,100.0
412570,2013,8,0,0,8,100.0
412570,2014,8,0,0,8,100.0
412570,2015,16,0,0,16,100.0
412570,2016,10,0,0,10,100.0
412570,2017,11,0,0,11,100.0
412570,2018,12,0,0,12,100.0
412570,2019,7,0,0,7,100.0
412570,2020,10,0,0,10,100.0
412575,2012,1,0,0,1,100.0
412575,2013,1,0,0,1,100.0
412575,2014,2,0,0,2,100.0
412575,2015,2,0,0,2,100.0
412575,2016,4,0,0,4,100.0
412575,2017,3,0,0,3,100.0
412575,2019,4,0,0,4,100.0
412575,2020,3,0,0,3,100.0
412580,2012,3,0,0,3,100.0
412580,2014,5,0,0,5,100.0
412580,2015,3,0,0,3,100.0
412580,2016,4,0,1,5,80.0
412580,2017,1,0,0,1,100.0
412580,2018,5,0,0,5,100.0
412580,2019,3,0,0,3,100.0
412580,2020,4,0,0,4,100.0
412590,2012,1,0,0,1,100.0
412590,2015,1,0,0,1,100.0
412590,2016,1,0,0,1,100.0
412590,2017,1,0,0,1,100.0
412590,2020,2,0,0,2,100.0
412600,2012,2,0,0,2,100.0
412600,2013,4,0,0,4,100.0
412600,2014,1,0,0,1,100.0
412600,2016,2,0,0,2,100.0
412600,2017,3,0,0,3,100.0
412600,2018,2,0,0,2,100.0
412600,2019,2,0,0,2,100.0
412600,2020,2,0,0,2,100.0
412610,2012,3,0,0,3,100.0
412610,2013,2,0,0,2,100.0
412610,2014,3,0,0,3,100.0
412610,2015,2,0,0,2,100.0
412610,2016,1,0,0,1,100.0
412610,2017,2,0,0,2,100.0
412610,2019,2,0,0,2,100.0
412610,2020,4,0,0,4,100.0
412620,2012,4,0,0,4,100.0
412620,2013,2,0,0,2,100.0
412620,2014,2,0,0,2,100.0
412620,2015,2,0,0,2,100.0
412620,2016,4,0,0,4,100.0
412620,2017,6,0,0,6,100.0
412620,2018,1,0,0,1,100.0
412620,2019,5,0,0,5,100.0
412620,2020,2,0,0,2,100.0
412625,2012,36,0,0,36,100.0
412625,2013,34,0,0,34,100.0
412625,2014,26,0,0,26,100.0
412625,2015,21,0,0,21,100.0
412625,2016,27,0,0,27,100.0
412625,2017,36,0,0,36,100.0
412625,2018,32,0,0,32,100.0
412625,2019,49,0,0,49,100.0
412625,2020,50,0,0,50,100.0
412627,2012,1,0,0,1,100.0
412627,2013,1,0,0,1,100.0
412627,2014,1,0,0,1,100.0
412627,2015,2,0,0,2,100.0
412627,2016,2,0,0,2,100.0
412627,2017,1,0,0,1,100.0
412627,2018,1,0,0,1,100.0
412627,2019,2,0,0,2,100.0
412627,2020,3,0,0,3,100.0
412630,2012,7,0,0,7,100.0
412630,2013,8,0,0,8,100.0
412630,2014,10,0,0,10,100.0
412630,2015,6,0,0,6,100.0
412630,2016,4,0,0,4,100.0
412630,2017,8,0,0,8,100.0
412630,2018,3,0,0,3,100.0
412630,2019,5,0,0,5,100.0
412630,2020,7,0,0,7,100.0
412635,2012,3,0,0,3,100.0
412635,2015,2,0,0,2,100.0
412635,2017,1,0,0,1,100.0
412635,2019,1,0,0,1,100.0
412635,2020,1,0,0,1,100.0
412640,2012,4,0,0,4,100.0
412640,2013,3,0,0,3,100.0
412640,2014,1,0,0,1,100.0
412640,2016,4,0,0,4,100.0
412640,2017,1,0,0,1,100.0
412640,2018,1,0,0,1,100.0
412640,2020,1,0,0,1,100.0
412650,2012,5,0,0,5,100.0
412650,2013,3,0,0,3,100.0
412650,2014,7,0,0,7,100.0
412650,2015,4,0,0,4,100.0
412650,2016,2,0,0,2,100.0
412650,2017,4,0,0,4,100.0
412650,2018,8,0,0,8,100.0
412650,2019,4,0,0,4,100.0
412650,2020,7,0,0,7,100.0
412660,2012,4,0,0,4,100.0
412660,2013,7,0,0,7,100.0
412660,2014,6,0,0,6,100.0
412660,2015,6,0,0,6,100.0
412660,2016,9,0,0,9,100.0
412660,2017,4,0,0,4,100.0
412660,2018,8,0,0,8,100.0
412660,2019,6,0,0,6,100.0
412660,2020,5,0,0,5,100.0
412665,2012,2,0,0,2,100.0
412665,2013,1,0,0,1,100.0
412665,2016,1,0,0,1,100.0
412665,2020,1,0,0,1,100.0
412667,2012,4,0,0,4,100.0
412667,2013,2,0,0,2,100.0
412667,2014,1,0,0,1,100.0
412667,2015,1,0,0,1,100.0
412667,2016,4,0,0,4,100.0
412667,2017,5,0,0,5,100.0
412667,2018,1,0,0,1,100.0
412667,2019,4,0,0,4,100.0
412667,2020,4,0,0,4,100.0
412670,2012,2,0,0,2,100.0
412670,2014,2,0,0,2,100.0
412670,2016,1,0,0,1,100.0
412670,2017,2,0,0,2,100.0
412670,2018,1,0,0,1,100.0
412670,2019,3,0,0,3,100.0
412670,2020,1,0,0,1,100.0
412680,2012,8,0,0,8,100.0
412680,2013,4,0,0,4,100.0
412680,2014,4,0,0,4,100.0
412680,2015,7,0,0,7,100.0
412680,2016,3,0,0,3,100.0
412680,2017,11,0,0,11,100.0
412680,2018,8,0,0,8,100.0
412680,2019,3,0,0,3,100.0
412680,2020,9,0,0,9,100.0
412690,2013,3,0,0,3,100.0
412690,2014,2,0,0,2,100.0
412690,2015,2,0,0,2,100.0
412690,2016,1,0,0,1,100.0
412690,2017,2,0,0,2,100.0
412690,2018,2,0,0,2,100.0
412690,2019,2,0,0,2,100.0
412690,2020,6,0,0,6,100.0
412700,2012,5,0,0,5,100.0
412700,2013,3,0,0,3,100.0
412700,2014,2,0,0,2,100.0
412700,2015,4,0,0,4,100.0
412700,2016,1,0,0,1,100.0
412700,2017,2,0,0,2,100.0
412700,2018,1,0,0,1,100.0
412700,2019,2,0,0,2,100.0
412710,2012,29,0,0,29,100.0
412710,2013,28,0,0,28,100.0
412710,2014,30,0,0,30,100.0
412710,2015,38,0,0,38,100.0
412710,2016,19,0,0,19,100.0
412710,2017,26,0,0,26,100.0
412710,2018,26,0,0,26,100.0
412710,2019,25,1,0,26,100.0
412710,2020,36,0,0,36,100.0
412720,2012,5,0,0,5,100.0
412720,2013,10,0,0,10,100.0
412720,2014,5,0,0,5,100.0
412720,2015,6,0,0,6,100.0
412720,2016,9,0,0,9,100.0
412720,2017,6,0,0,6,100.0
412720,2018,5,0,0,5,100.0
412720,2019,3,0,0,3,100.0
412720,2020,4,0,0,4,100.0
412730,2012,6,0,0,6,100.0
412730,2013,2,0,0,2,100.0
412730,2014,5,0,0,5,100.0
412730,2015,2,0,0,2,100.0
412730,2016,2,0,0,2,100.0
412730,2017,6,0,0,6,100.0
412730,2018,7,0,0,7,100.0
412730,2019,5,0,0,5,100.0
412730,2020,4,0,0,4,100.0
412740,2012,4,0,0,4,100.0
412740,2013,2,0,0,2,100.0
412740,2014,5,0,0,5,100.0
412740,2015,9,0,0,9,100.0
412740,2016,2,0,0,2,100.0
412740,2017,6,0,0,6,100.0
412740,2018,9,0,0,9,100.0
412740,2019,5,0,0,5,100.0
412740,2020,2,0,0,2,100.0
412750,2012,7,0,0,7,100.0
412750,2013,4,0,0,4,100.0
412750,2014,9,0,0,9,100.0
412750,2015,6,0,0,6,100.0
412750,2016,10,0,0,10,100.0
412750,2017,4,0,0,4,100.0
412750,2018,12,0,0,12,100.0
412750,2019,5,0,0,5,100.0
412750,2020,4,0,0,4,100.0
412760,2012,4,0,0,4,100.0
412760,2013,3,0,0,3,100.0
412760,2014,3,0,0,3,100.0
412760,2015,7,0,0,7,100.0
412760,2016,9,0,0,9,100.0
412760,2017,4,0,0,4,100.0
412760,2018,2,0,0,2,100.0
412760,2019,3,0,0,3,100.0
412760,2020,6,0,0,6,100.0
412770,2012,43,0,0,43,100.0
412770,2013,45,0,0,45,100.0
412770,2014,45,0,0,45,100.0
412770,2015,39,0,3,42,92.85714285714286
412770,2016,40,0,0,40,100.0
412770,2017,29,0,0,29,100.0
412770,2018,26,0,0,26,100.0
412770,2019,31,0,0,31,100.0
412770,2020,52,0,0,52,100.0
412780,2012,2,0,0,2,100.0
412780,2014,1,0,0,1,100.0
412780,2017,2,0,0,2,100.0
412780,2018,1,0,0,1,100.0
412780,2019,1,0,0,1,100.0
412780,2020,3,0,0,3,100.0
412785,2012,3,0,0,3,100.0
412785,2013,3,0,0,3,100.0
412785,2014,2,0,0,2,100.0
412785,2015,2,0,0,2,100.0
412785,2016,1,0,0,1,100.0
412785,2017,2,0,0,2,100.0
412785,2018,4,0,0,4,100.0
412785,2019,3,0,0,3,100.0
412785,2020,6,0,0,6,100.0
412788,2012,6,0,0,6,100.0
412788,2013,4,0,0,4,100.0
412788,2014,7,0,0,7,100.0
412788,2015,4,0,0,4,100.0
412788,2016,1,0,0,1,100.0
412788,2017,2,0,0,2,100.0
412788,2018,2,0,0,2,100.0
412788,2019,3,2,0,5,100.0
412788,2020,0,1,1,2,50.0
412790,2012,2,0,0,2,100.0
412790,2013,5,0,0,5,100.0
412790,2015,2,0,0,2,100.0
412790,2016,4,0,0,4,100.0
412790,2017,2,0,0,2,100.0
412790,2018,5,0,0,5,100.0
412790,2019,7,0,0,7,100.0
412790,2020,5,0,0,5,100.0
412795,2012,1,0,0,1,100.0
412795,2013,2,0,0,2,100.0
412795,2014,3,0,0,3,100.0
412795,2015,1,0,0,1,100.0
412795,2016,2,0,0,2,100.0
412795,2017,3,0,0,3,100.0
412795,2018,4,0,0,4,100.0
412795,2019,1,0,0,1,100.0
412795,2020,2,0,0,2,100.0
412796,2012,5,0,0,5,100.0
412796,2013,4,0,0,4,100.0
412796,2014,5,0,0,5,100.0
412796,2015,5,0,0,5,100.0
412796,2016,3,0,0,3,100.0
412796,2017,2,0,0,2,100.0
412796,2018,3,0,0,3,100.0
412796,2019,2,0,0,2,100.0
412796,2020,5,0,0,5,100.0
412800,2012,7,0,0,7,100.0
412800,2013,4,0,0,4,100.0
412800,2014,14,0,0,14,100.0
412800,2015,7,0,0,7,100.0
412800,2016,1,0,0,1,100.0
412800,2017,5,0,0,5,100.0
412800,2018,6,0,0,6,100.0
412800,2019,7,0,0,7,100.0
412800,2020,6,0,0,6,100.0
412810,2012,33,0,0,33,100.0
412810,2013,31,0,0,31,100.0
412810,2014,39,0,0,39,100.0
412810,2015,29,0,0,29,100.0
412810,2016,37,0,0,37,100.0
412810,2017,30,0,0,30,100.0
412810,2018,23,0,0,23,100.0
412810,2019,29,0,0,29,100.0
412810,2020,30,0,0,30,100.0
412820,2012,11,0,0,11,100.0
412820,2013,22,0,0,22,100.0
412820,2014,16,0,0,16,100.0
412820,2015,37,0,0,37,100.0
412820,2016,15,0,0,15,100.0
412820,2017,13,0,0,13,100.0
412820,2018,20,0,0,20,100.0
412820,2019,23,0,0,23,100.0
412820,2020,22,0,0,22,100.0
412830,2012,1,0,0,1,100.0
412830,2013,1,0,0,1,100.0
412830,2015,2,0,0,2,100.0
412830,2016,2,0,0,2,100.0
412830,2018,1,0,0,1,100.0
412830,2019,1,0,0,1,100.0
412840,2012,1,0,0,1,100.0
412840,2013,5,0,0,5,100.0
412840,2014,3,0,0,3,100.0
412840,2015,1,0,0,1,100.0
412840,2016,5,0,0,5,100.0
412840,2017,4,0,0,4,100.0
412840,2018,6,0,0,6,100.0
412840,2019,3,0,0,3,100.0
412840,2020,1,0,0,1,100.0
412850,2012,5,0,0,5,100.0
412850,2013,7,0,0,7,100.0
412850,2014,2,0,0,2,100.0
412850,2015,3,0,0,3,100.0
412850,2016,10,0,0,10,100.0
412850,2017,4,0,0,4,100.0
412850,2018,4,1,0,5,100.0
412850,2019,6,0,0,6,100.0
412850,2020,6,0,0,6,100.0
412853,2012,4,0,0,4,100.0
412853,2014,6,0,0,6,100.0
412853,2015,6,0,0,6,100.0
412853,2016,2,0,0,2,100.0
412853,2018,7,0,0,7,100.0
412853,2019,5,0,0,5,100.0
412853,2020,1,0,0,1,100.0
412855,2012,6,0,0,6,100.0
412855,2013,2,0,0,2,100.0
412855,2014,1,0,0,1,100.0
412855,2015,5,0,0,5,100.0
412855,2016,3,0,0,3,100.0
412855,2017,3,0,0,3,100.0
412855,2018,2,0,0,2,100.0
412855,2019,2,0,0,2,100.0
412855,2020,2,0,0,2,100.0
412860,2012,3,0,0,3,100.0
412860,2013,2,0,0,2,100.0
412860,2014,1,0,0,1,100.0
412860,2015,3,0,0,3,100.0
412860,2016,6,0,0,6,100.0
412860,2018,1,0,0,1,100.0
412860,2019,2,0,0,2,100.0
412860,2020,5,0,0,5,100.0
412862,2012,1,0,0,1,100.0
412862,2013,2,0,0,2,100.0
412862,2014,3,0,0,3,100.0
412862,2016,1,0,0,1,100.0
412862,2017,1,0,0,1,100.0
412862,2018,1,0,0,1,100.0
412862,2019,3,0,0,3,100.0
412862,2020,1,0,0,1,100.0
412863,2012,1,0,0,1,100.0
412863,2013,3,0,0,3,100.0
412863,2014,1,0,0,1,100.0
412863,2016,2,0,0,2,100.0
412863,2017,2,0,0,2,100.0
412863,2018,1,0,0,1,100.0
412863,2019,2,0,0,2,100.0
412863,2020,2,0,0,2,100.0
412865,2012,1,0,0,1,100.0
412865,2015,1,0,0,1,100.0
412865,2019,2,0,0,2,100.0
412870,2012,1,0,0,1,100.0
412870,2014,1,0,0,1,100.0
412870,2015,3,0,0,3,100.0
412870,2016,1,0,0,1,100.0
412870,2017,1,0,0,1,100.0
412870,2018,2,0,0,2,100.0
412870,2019,2,0,0,2,100.0
412870,2020,3,0,0,3,100.0
412880,2012,3,0,0,3,100.0
412880,2014,4,0,0,4,100.0
412880,2015,1,0,0,1,100.0
412880,2016,2,0,0,2,100.0
412880,2017,1,0,0,1,100.0
412880,2019,3,0,0,3,100.0
412880,2020,4,0,0,4,100.0
420005,2013,0,0,1,1,0.0
420005,2015,1,0,0,1,100.0
420005,2016,1,0,0,1,100.0
420005,2018,0,0,1,1,0.0
420005,2019,0,0,1,1,0.0
420010,2012,3,0,0,3,100.0
420010,2013,4,0,0,4,100.0
420010,2014,5,0,0,5,100.0
420010,2015,3,0,0,3,100.0
420010,2016,3,0,0,3,100.0
420010,2017,3,0,0,3,100.0
420010,2018,6,0,0,6,100.0
420010,2019,3,0,0,3,100.0
420010,2020,8,0,0,8,100.0
420020,2012,1,0,0,1,100.0
420020,2013,6,0,0,6,100.0
420020,2014,2,0,0,2,100.0
420020,2015,4,0,0,4,100.0
420020,2016,4,0,0,4,100.0
420020,2017,3,0,0,3,100.0
420020,2018,5,0,0,5,100.0
420020,2019,4,0,0,4,100.0
420020,2020,5,0,0,5,100.0
420030,2012,1,0,0,1,100.0
420030,2014,2,0,0,2,100.0
420030,2015,1,0,0,1,100.0
420030,2017,2,0,0,2,100.0
420030,2018,3,0,0,3,100.0
420030,2019,2,0,0,2,100.0
420030,2020,2,0,0,2,100.0
420040,2012,0,0,2,2,0.0
420040,2013,0,0,2,2,0.0
420040,2014,1,0,0,1,100.0
420040,2015,1,0,0,1,100.0
420040,2016,1,0,1,2,50.0
420040,2017,0,0,2,2,0.0
420040,2018,3,0,0,3,100.0
420040,2019,1,1,1,3,66.66666666666666
420040,2020,1,0,1,2,50.0
420050,2012,3,0,0,3,100.0
420050,2013,2,0,0,2,100.0
420050,2014,3,0,0,3,100.0
420050,2015,1,0,0,1,100.0
420050,2016,2,0,0,2,100.0
420050,2017,1,0,0,1,100.0
420050,2018,4,0,0,4,100.0
420050,2020,2,0,0,2,100.0
420055,2013,1,0,0,1,100.0
420055,2014,1,0,0,1,100.0
420055,2016,1,0,0,1,100.0
420055,2017,1,0,0,1,100.0
420055,2018,1,0,0,1,100.0
420055,2020,1,0,0,1,100.0
420060,2012,4,0,0,4,100.0
420060,2013,1,0,0,1,100.0
420060,2014,1,0,0,1,100.0
420060,2016,2,0,0,2,100.0
420060,2017,2,0,0,2,100.0
420060,2018,1,0,0,1,100.0
420060,2019,1,0,0,1,100.0
420060,2020,3,0,0,3,100.0
420070,2012,1,0,0,1,100.0
420070,2013,2,0,1,3,66.66666666666666
420070,2014,2,0,0,2,100.0
420070,2015,2,0,0,2,100.0
420070,2016,5,0,0,5,100.0
420070,2017,1,0,0,1,100.0
420070,2018,3,0,0,3,100.0
420070,2019,1,0,0,1,100.0
420070,2020,2,0,0,2,100.0
420075,2012,0,0,1,1,0.0
420075,2013,1,0,0,1,100.0
420075,2015,0,0,1,1,0.0
420075,2017,1,0,0,1,100.0
420080,2012,3,0,0,3,100.0
420080,2013,1,0,0,1,100.0
420080,2014,1,0,0,1,100.0
420080,2016,2,0,0,2,100.0
420080,2017,1,0,0,1,100.0
420080,2018,4,0,0,4,100.0
420080,2019,2,0,0,2,100.0
420080,2020,2,0,0,2,100.0
420090,2012,1,0,0,1,100.0
420090,2013,2,0,0,2,100.0
420090,2015,1,0,0,1,100.0
420090,2016,1,0,0,1,100.0
420090,2018,2,0,0,2,100.0
420100,2012,0,0,2,2,0.0
420100,2013,9,0,0,9,100.0
420100,2014,6,0,0,6,100.0
420100,2015,2,0,1,3,66.66666666666666
420100,2016,1,0,0,1,100.0
420100,2018,3,0,0,3,100.0
420100,2019,1,0,0,1,100.0
420100,2020,1,0,0,1,100.0
420110,2012,0,0,1,1,0.0
420110,2013,2,0,0,2,100.0
420110,2015,2,0,0,2,100.0
420120,2012,2,0,0,2,100.0
420120,2013,1,0,0,1,100.0
420120,2015,1,0,0,1,100.0
420120,2017,2,0,0,2,100.0
420120,2018,2,0,0,2,100.0
420120,2019,1,0,0,1,100.0
420125,2012,0,2,3,5,40.0
420125,2013,2,1,4,7,42.857142857142854
420125,2014,2,0,1,3,66.66666666666666
420125,2015,2,2,0,4,100.0
420125,2016,1,0,0,1,100.0
420125,2017,1,0,0,1,100.0
420125,2018,4,0,0,4,100.0
420125,2019,3,0,0,3,100.0
420125,2020,1,0,0,1,100.0
420127,2012,1,0,0,1,100.0
420127,2014,1,0,0,1,100.0
420127,2015,0,2,0,2,100.0
420127,2016,2,0,0,2,100.0
420130,2012,15,0,0,15,100.0
420130,2013,3,0,2,5,60.0
420130,2014,6,0,0,6,100.0
420130,2015,7,0,0,7,100.0
420130,2016,6,0,0,6,100.0
420130,2017,9,0,0,9,100.0
420130,2018,9,0,0,9,100.0
420130,2019,12,0,0,12,100.0
420130,2020,12,0,0,12,100.0
420140,2012,13,0,0,13,100.0
420140,2013,26,0,0,26,100.0
420140,2014,20,0,0,20,100.0
420140,2015,15,0,0,15,100.0
420140,2016,21,0,0,21,100.0
420140,2017,15,0,0,15,100.0
420140,2018,22,0,0,22,100.0
420140,2019,19,0,0,19,100.0
420140,2020,13,0,0,13,100.0
420150,2013,1,0,0,1,100.0
420150,2014,3,0,0,3,100.0
420150,2016,2,0,0,2,100.0
420150,2017,1,0,0,1,100.0
420150,2018,3,0,0,3,100.0
420150,2019,2,0,1,3,66.66666666666666
420150,2020,3,0,0,3,100.0
420160,2012,1,0,0,1,100.0
420160,2014,1,0,0,1,100.0
420160,2016,1,0,0,1,100.0
420160,2018,1,0,0,1,100.0
420165,2012,0,1,0,1,100.0
420165,2013,0,1,0,1,100.0
420165,2014,1,0,0,1,100.0
420165,2016,1,0,0,1,100.0
420165,2019,1,0,0,1,100.0
420170,2012,3,2,0,5,100.0
420170,2013,0,0,2,2,0.0
420170,2014,1,2,0,3,100.0
420170,2015,2,1,0,3,100.0
420170,2016,3,0,0,3,100.0
420170,2017,3,0,0,3,100.0
420170,2018,3,0,0,3,100.0
420170,2019,1,0,0,1,100.0
420170,2020,0,1,0,1,100.0
420180,2012,1,0,0,1,100.0
420180,2013,2,0,0,2,100.0
420180,2015,2,0,0,2,100.0
420180,2016,4,0,0,4,100.0
420180,2017,4,0,0,4,100.0
420180,2020,3,0,0,3,100.0
420190,2012,1,0,0,1,100.0
420190,2013,1,0,0,1,100.0
420190,2015,2,0,0,2,100.0
420190,2017,1,0,0,1,100.0
420190,2019,2,0,0,2,100.0
420190,2020,3,0,0,3,100.0
420195,2012,3,0,0,3,100.0
420195,2013,0,0,3,3,0.0
420195,2014,6,0,0,6,100.0
420195,2015,4,0,0,4,100.0
420195,2016,3,0,0,3,100.0
420195,2017,6,0,0,6,100.0
420195,2018,5,0,0,5,100.0
420195,2019,5,1,0,6,100.0
420195,2020,3,0,0,3,100.0
420200,2012,28,0,0,28,100.0
420200,2013,29,0,1,30,96.66666666666667
420200,2014,32,0,0,32,100.0
420200,2015,34,0,0,34,100.0
420200,2016,22,0,0,22,100.0
420200,2017,28,0,0,28,100.0
420200,2018,38,0,0,38,100.0
420200,2019,45,0,0,45,100.0
420200,2020,28,0,0,28,100.0
420205,2012,1,0,0,1,100.0
420205,2013,2,0,1,3,66.66666666666666
420205,2014,3,0,0,3,100.0
420205,2015,4,0,0,4,100.0
420205,2016,5,0,0,5,100.0
420205,2017,2,0,0,2,100.0
420205,2018,1,0,6,7,14.285714285714285
420205,2020,9,0,0,9,100.0
420207,2012,1,0,1,2,50.0
420207,2013,2,0,0,2,100.0
420207,2014,1,0,0,1,100.0
420207,2016,3,0,0,3,100.0
420207,2017,3,0,0,3,100.0
420207,2018,3,0,0,3,100.0
420207,2019,4,0,0,4,100.0
420207,2020,1,0,0,1,100.0
420208,2012,2,0,0,2,100.0
420208,2013,1,0,0,1,100.0
420208,2014,2,0,0,2,100.0
420208,2016,1,0,0,1,100.0
420209,2013,2,0,0,2,100.0
420209,2014,1,0,0,1,100.0
420209,2017,3,0,0,3,100.0
420209,2019,1,0,0,1,100.0
420209,2020,1,0,0,1,100.0
420210,2012,12,0,0,12,100.0
420210,2013,11,0,1,12,91.66666666666666
420210,2014,6,0,0,6,100.0
420210,2015,10,1,0,11,100.0
420210,2016,4,0,3,7,57.14285714285714
420210,2017,12,0,0,12,100.0
420210,2018,10,0,0,10,100.0
420210,2019,10,0,0,10,100.0
420210,2020,1,5,10,16,37.5
420213,2013,2,0,2,4,50.0
420213,2014,1,0,0,1,100.0
420213,2015,1,0,0,1,100.0
420213,2016,0,0,1,1,0.0
420213,2017,1,0,2,3,33.33333333333333
420213,2019,0,0,1,1,0.0
420213,2020,0,1,0,1,100.0
420215,2013,1,0,0,1,100.0
420215,2014,2,0,0,2,100.0
420215,2015,2,0,0,2,100.0
420215,2016,1,0,0,1,100.0
420215,2018,1,0,0,1,100.0
420215,2020,2,0,0,2,100.0
420220,2012,1,0,1,2,50.0
420220,2013,0,0,3,3,0.0
420220,2014,1,1,2,4,50.0
420220,2015,2,0,1,3,66.66666666666666
420220,2016,1,2,2,5,60.0
420220,2017,1,0,0,1,100.0
420220,2018,1,0,0,1,100.0
420220,2019,3,0,0,3,100.0
420220,2020,1,0,0,1,100.0
420230,2012,14,0,1,15,93.33333333333333
420230,2013,31,0,0,31,100.0
420230,2014,17,0,0,17,100.0
420230,2015,17,0,0,17,100.0
420230,2016,22,0,0,22,100.0
420230,2017,20,0,0,20,100.0
420230,2018,19,0,0,19,100.0
420230,2019,16,0,0,16,100.0
420230,2020,23,0,0,23,100.0
420240,2012,87,5,2,94,97.87234042553192
420240,2013,92,7,1,100,99.0
420240,2014,90,1,0,91,100.0
420240,2015,86,5,0,91,100.0
420240,2016,96,0,0,96,100.0
420240,2017,68,0,0,68,100.0
420240,2018,70,0,0,70,100.0
420240,2019,99,0,0,99,100.0
420240,2020,85,1,0,86,100.0
420243,2012,0,0,2,2,0.0
420243,2014,2,0,0,2,100.0
420243,2016,2,0,0,2,100.0
420243,2019,1,0,0,1,100.0
420243,2020,3,0,0,3,100.0
420245,2012,2,1,1,4,75.0
420245,2013,5,0,1,6,83.33333333333334
420245,2014,5,0,0,5,100.0
420245,2015,6,0,0,6,100.0
420245,2016,4,0,0,4,100.0
420245,2017,5,0,0,5,100.0
420245,2018,6,0,0,6,100.0
420245,2019,4,0,0,4,100.0
420245,2020,4,0,0,4,100.0
420250,2012,0,0,1,1,0.0
420250,2014,2,0,0,2,100.0
420250,2015,3,0,0,3,100.0
420250,2016,1,0,0,1,100.0
420250,2019,2,0,0,2,100.0
420253,2013,2,0,1,3,66.66666666666666
420253,2014,1,0,0,1,100.0
420253,2016,2,0,0,2,100.0
420253,2018,1,0,0,1,100.0
420253,2019,0,0,1,1,0.0
420257,2014,1,0,0,1,100.0
420257,2015,1,0,0,1,100.0
420257,2017,1,0,0,1,100.0
420257,2019,1,0,0,1,100.0
420260,2012,1,0,2,3,33.33333333333333
420260,2013,2,0,0,2,100.0
420260,2014,4,0,0,4,100.0
420260,2015,3,0,0,3,100.0
420260,2016,5,0,0,5,100.0
420260,2017,3,0,0,3,100.0
420260,2018,1,0,0,1,100.0
420260,2019,2,0,0,2,100.0
420260,2020,1,0,0,1,100.0
420270,2013,2,1,0,3,100.0
420270,2014,1,3,1,5,80.0
420270,2016,3,0,0,3,100.0
420270,2019,1,0,0,1,100.0
420270,2020,1,0,0,1,100.0
420280,2012,4,1,0,5,100.0
420280,2013,6,0,0,6,100.0
420280,2014,9,0,0,9,100.0
420280,2015,11,0,0,11,100.0
420280,2016,10,0,0,10,100.0
420280,2017,5,1,0,6,100.0
420280,2018,6,0,0,6,100.0
420280,2019,10,0,0,10,100.0
420280,2020,8,0,0,8,100.0
420285,2012,1,1,0,2,100.0
420285,2013,2,0,0,2,100.0
420285,2014,3,0,0,3,100.0
420285,2015,1,0,0,1,100.0
420285,2016,2,0,0,2,100.0
420285,2017,1,0,0,1,100.0
420285,2018,1,0,0,1,100.0
420287,2012,0,0,1,1,0.0
420287,2017,1,0,0,1,100.0
420287,2019,1,0,0,1,100.0
420287,2020,0,1,0,1,100.0
420290,2012,22,1,10,33,69.6969696969697
420290,2013,24,0,0,24,100.0
420290,2014,33,0,0,33,100.0
420290,2015,32,0,0,32,100.0
420290,2016,35,0,0,35,100.0
420290,2017,36,0,0,36,100.0
420290,2018,32,0,0,32,100.0
420290,2019,32,0,0,32,100.0
420290,2020,31,0,0,31,100.0
420300,2012,26,0,0,26,100.0
420300,2013,31,0,0,31,100.0
420300,2014,33,0,0,33,100.0
420300,2015,19,0,1,20,95.0
420300,2016,26,0,0,26,100.0
420300,2017,25,0,0,25,100.0
420300,2018,30,0,0,30,100.0
420300,2019,28,0,0,28,100.0
420300,2020,26,0,0,26,100.0
420310,2012,2,0,0,2,100.0
420310,2013,3,0,0,3,100.0
420310,2014,1,0,0,1,100.0
420310,2016,3,0,0,3,100.0
420310,2017,1,0,0,1,100.0
420310,2018,2,0,0,2,100.0
420310,2019,2,1,0,3,100.0
420315,2012,2,0,1,3,66.66666666666666
420315,2013,1,0,0,1,100.0
420315,2014,2,0,0,2,100.0
420315,2015,1,0,0,1,100.0
420315,2016,0,0,1,1,0.0
420315,2017,1,0,0,1,100.0
420315,2019,1,0,0,1,100.0
420315,2020,2,0,0,2,100.0
420320,2012,3,4,22,29,24.137931034482758
420320,2013,24,1,3,28,89.28571428571429
420320,2014,21,0,0,21,100.0
420320,2015,17,0,0,17,100.0
420320,2016,33,0,0,33,100.0
420320,2017,20,1,0,21,100.0
420320,2018,25,3,0,28,100.0
420320,2019,27,0,0,27,100.0
420320,2020,29,0,0,29,100.0
420325,2013,0,0,2,2,0.0
420325,2014,2,0,0,2,100.0
420325,2017,1,0,0,1,100.0
420325,2018,1,0,0,1,100.0
420325,2019,1,0,0,1,100.0
420325,2020,2,0,0,2,100.0
420330,2012,1,0,1,2,50.0
420330,2013,1,0,1,2,50.0
420330,2014,3,1,1,5,80.0
420330,2015,3,0,0,3,100.0
420330,2016,3,0,0,3,100.0
420330,2017,5,0,0,5,100.0
420330,2018,6,0,0,6,100.0
420330,2019,2,0,0,2,100.0
420330,2020,0,0,1,1,0.0
420340,2012,0,0,5,5,0.0
420340,2013,0,0,1,1,0.0
420340,2014,4,0,0,4,100.0
420340,2015,2,0,0,2,100.0
420340,2016,3,0,0,3,100.0
420340,2017,4,0,0,4,100.0
420340,2018,4,0,0,4,100.0
420340,2019,4,0,0,4,100.0
420340,2020,4,0,0,4,100.0
420350,2012,2,2,1,5,80.0
420350,2013,2,0,0,2,100.0
420350,2015,3,0,0,3,100.0
420350,2016,2,0,0,2,100.0
420350,2017,3,0,0,3,100.0
420350,2018,6,0,0,6,100.0
420350,2019,1,0,0,1,100.0
420350,2020,1,0,0,1,100.0
420360,2012,15,0,0,15,100.0
420360,2013,13,0,0,13,100.0
420360,2014,12,0,4,16,75.0
420360,2015,10,0,3,13,76.92307692307693
420360,2016,18,0,0,18,100.0
420360,2017,14,0,0,14,100.0
420360,2018,11,0,0,11,100.0
420360,2019,10,0,0,10,100.0
420360,2020,13,0,0,13,100.0
420370,2012,1,0,0,1,100.0
420370,2013,2,0,1,3,66.66666666666666
420370,2014,6,0,0,6,100.0
420370,2015,4,0,0,4,100.0
420370,2016,5,0,0,5,100.0
420370,2017,3,0,0,3,100.0
420370,2018,2,0,0,2,100.0
420370,2019,2,0,0,2,100.0
420370,2020,3,0,0,3,100.0
420380,2012,20,1,1,22,95.45454545454545
420380,2013,13,0,0,13,100.0
420380,2014,23,0,0,23,100.0
420380,2015,19,0,0,19,100.0
420380,2016,19,0,0,19,100.0
420380,2017,20,0,0,20,100.0
420380,2018,20,0,0,20,100.0
420380,2019,11,0,0,11,100.0
420380,2020,15,1,0,16,100.0
420390,2012,1,0,6,7,14.285714285714285
420390,2013,5,0,2,7,71.42857142857143
420390,2014,6,0,4,10,60.0
420390,2015,3,0,0,3,100.0
420390,2016,4,0,0,4,100.0
420390,2017,3,0,0,3,100.0
420390,2018,10,0,0,10,100.0
420390,2019,5,0,0,5,100.0
420390,2020,6,0,0,6,100.0
420395,2012,8,2,1,11,90.9090909090909
420395,2013,9,0,0,9,100.0
420395,2014,6,0,1,7,85.71428571428571
420395,2015,7,0,0,7,100.0
420395,2016,11,0,0,11,100.0
420395,2017,7,0,0,7,100.0
420395,2018,6,0,0,6,100.0
420395,2019,9,0,0,9,100.0
420395,2020,11,0,0,11,100.0
420400,2012,1,0,2,3,33.33333333333333
420400,2013,0,1,2,3,33.33333333333333
420400,2014,3,0,4,7,42.857142857142854
420400,2015,2,1,2,5,60.0
420400,2018,5,0,0,5,100.0
420400,2019,3,0,0,3,100.0
420400,2020,4,0,0,4,100.0
420410,2012,1,0,0,1,100.0
420410,2013,3,0,0,3,100.0
420410,2014,2,0,0,2,100.0
420410,2015,1,0,0,1,100.0
420410,2016,3,0,0,3,100.0
420410,2017,4,0,0,4,100.0
420410,2018,1,0,0,1,100.0
420410,2019,1,0,0,1,100.0
420410,2020,3,0,0,3,100.0
420415,2012,1,0,0,1,100.0
420415,2013,0,0,1,1,0.0
420415,2015,1,0,0,1,100.0
420415,2018,1,0,0,1,100.0
420415,2020,1,0,0,1,100.0
420417,2012,0,0,2,2,0.0
420417,2013,1,0,0,1,100.0
420417,2015,2,0,0,2,100.0
420417,2016,1,0,0,1,100.0
420417,2017,1,0,0,1,100.0
420417,2018,1,0,0,1,100.0
420417,2019,3,0,0,3,100.0
420419,2014,1,0,0,1,100.0
420420,2012,57,0,0,57,100.0
420420,2013,68,0,0,68,100.0
420420,2014,50,0,0,50,100.0
420420,2015,58,0,0,58,100.0
420420,2016,69,0,0,69,100.0
420420,2017,64,0,0,64,100.0
420420,2018,62,0,0,62,100.0
420420,2019,43,0,0,43,100.0
420420,2020,44,0,0,44,100.0
420425,2012,4,0,0,4,100.0
420425,2013,8,0,0,8,100.0
420425,2014,3,0,1,4,75.0
420425,2015,5,0,0,5,100.0
420425,2016,5,0,0,5,100.0
420425,2017,5,0,0,5,100.0
420425,2018,2,0,0,2,100.0
420425,2019,4,0,0,4,100.0
420425,2020,1,0,0,1,100.0
420430,2012,9,2,3,14,78.57142857142857
420430,2013,14,0,0,14,100.0
420430,2014,16,0,0,16,100.0
420430,2015,10,0,0,10,100.0
420430,2016,19,0,0,19,100.0
420430,2017,11,0,0,11,100.0
420430,2018,20,0,0,20,100.0
420430,2019,16,0,0,16,100.0
420430,2020,15,0,0,15,100.0
420435,2012,1,0,1,2,50.0
420435,2013,3,0,0,3,100.0
420435,2014,1,0,0,1,100.0
420435,2015,3,0,0,3,100.0
420435,2016,3,0,0,3,100.0
420435,2017,1,0,0,1,100.0
420435,2019,1,0,0,1,100.0
420435,2020,2,0,0,2,100.0
420440,2012,1,2,1,4,75.0
420440,2013,4,0,0,4,100.0
420440,2015,3,0,0,3,100.0
420440,2016,5,0,0,5,100.0
420440,2017,2,0,0,2,100.0
420440,2018,2,0,0,2,100.0
420440,2019,3,0,0,3,100.0
420440,2020,3,0,0,3,100.0
420445,2012,2,0,0,2,100.0
420445,2013,1,1,0,2,100.0
420445,2015,1,0,0,1,100.0
420445,2017,1,0,0,1,100.0
420445,2018,1,0,1,2,50.0
420450,2012,1,2,2,5,60.0
420450,2013,5,0,0,5,100.0
420450,2014,4,0,0,4,100.0
420450,2015,3,0,0,3,100.0
420450,2016,6,0,0,6,100.0
420450,2017,2,0,0,2,100.0
420450,2018,7,0,0,7,100.0
420450,2019,6,0,0,6,100.0
420450,2020,3,0,0,3,100.0
420455,2012,2,0,5,7,28.57142857142857
420455,2013,2,0,0,2,100.0
420455,2014,8,0,0,8,100.0
420455,2015,9,0,0,9,100.0
420455,2016,10,0,0,10,100.0
420455,2017,5,0,0,5,100.0
420455,2018,4,0,0,4,100.0
420455,2019,6,0,0,6,100.0
420455,2020,8,0,0,8,100.0
420460,2012,83,0,0,83,100.0
420460,2013,61,0,0,61,100.0
420460,2014,57,0,1,58,98.27586206896551
420460,2015,60,0,0,60,100.0
420460,2016,55,0,0,55,100.0
420460,2017,47,0,0,47,100.0
420460,2018,53,0,0,53,100.0
420460,2019,65,0,0,65,100.0
420460,2020,45,0,0,45,100.0
420470,2012,2,0,3,5,40.0
420470,2013,2,0,0,2,100.0
420470,2014,5,0,0,5,100.0
420470,2015,4,0,0,4,100.0
420470,2016,6,0,0,6,100.0
420470,2017,5,0,0,5,100.0
420470,2018,2,0,0,2,100.0
420470,2019,2,0,0,2,100.0
420470,2020,3,0,0,3,100.0
420475,2012,1,0,0,1,100.0
420475,2014,1,0,0,1,100.0
420475,2016,1,0,0,1,100.0
420475,2019,0,0,1,1,0.0
420480,2012,15,0,0,15,100.0
420480,2013,18,0,6,24,75.0
420480,2014,12,0,0,12,100.0
420480,2015,5,6,8,19,57.89473684210527
420480,2016,20,0,0,20,100.0
420480,2017,18,0,0,18,100.0
420480,2018,15,0,0,15,100.0
420480,2019,16,0,0,16,100.0
420480,2020,23,1,0,24,100.0
420490,2012,5,0,0,5,100.0
420490,2013,3,0,0,3,100.0
420490,2014,1,0,0,1,100.0
420490,2015,1,0,0,1,100.0
420490,2016,2,0,0,2,100.0
420490,2017,2,0,0,2,100.0
420490,2018,2,0,0,2,100.0
420490,2020,2,0,0,2,100.0
420500,2013,5,0,0,5,100.0
420500,2014,4,0,0,4,100.0
420500,2015,4,0,0,4,100.0
420500,2016,6,0,0,6,100.0
420500,2017,6,0,0,6,100.0
420500,2018,5,0,0,5,100.0
420500,2019,8,0,0,8,100.0
420500,2020,4,0,0,4,100.0
420510,2012,1,0,0,1,100.0
420510,2013,2,0,0,2,100.0
420510,2014,1,0,0,1,100.0
420510,2016,1,0,0,1,100.0
420510,2017,2,0,0,2,100.0
420510,2018,1,0,0,1,100.0
420510,2019,1,0,0,1,100.0
420515,2012,1,0,1,2,50.0
420515,2013,1,0,0,1,100.0
420515,2014,1,0,1,2,50.0
420515,2020,2,0,0,2,100.0
420517,2012,1,0,0,1,100.0
420517,2014,1,0,0,1,100.0
420517,2016,3,0,0,3,100.0
420517,2017,4,0,0,4,100.0
420517,2018,2,0,0,2,100.0
420519,2015,1,0,0,1,100.0
420519,2018,1,0,0,1,100.0
420519,2020,1,0,0,1,100.0
420520,2012,0,0,3,3,0.0
420520,2013,0,0,1,1,0.0
420520,2014,1,0,0,1,100.0
420520,2015,1,0,0,1,100.0
420520,2017,1,0,0,1,100.0
420520,2018,1,0,0,1,100.0
420520,2019,2,0,0,2,100.0
420520,2020,4,0,0,4,100.0
420530,2012,4,0,0,4,100.0
420530,2013,6,0,0,6,100.0
420530,2014,2,0,0,2,100.0
420530,2015,2,0,0,2,100.0
420530,2016,4,0,0,4,100.0
420530,2017,8,0,0,8,100.0
420530,2018,2,0,0,2,100.0
420530,2019,3,0,0,3,100.0
420530,2020,4,0,0,4,100.0
420535,2013,1,0,0,1,100.0
420535,2016,2,0,0,2,100.0
420535,2020,1,0,0,1,100.0
420540,2012,115,0,0,115,100.0
420540,2013,112,1,1,114,99.12280701754386
420540,2014,114,1,1,116,99.13793103448276
420540,2015,115,0,0,115,100.0
420540,2016,111,0,1,112,99.10714285714286
420540,2017,113,0,0,113,100.0
420540,2018,107,0,1,108,99.07407407407408
420540,2019,102,0,0,102,100.0
420540,2020,130,0,0,130,100.0
420543,2012,1,0,1,2,50.0
420543,2013,1,0,0,1,100.0
420543,2015,1,0,0,1,100.0
420543,2019,1,0,0,1,100.0
420543,2020,0,0,1,1,0.0
420545,2012,9,0,0,9,100.0
420545,2013,7,0,0,7,100.0
420545,2014,8,0,0,8,100.0
420545,2015,4,0,1,5,80.0
420545,2016,4,0,0,4,100.0
420545,2017,7,0,1,8,87.5
420545,2018,3,0,0,3,100.0
420545,2019,12,0,0,12,100.0
420545,2020,8,0,0,8,100.0
420550,2012,12,0,0,12,100.0
420550,2013,10,0,0,10,100.0
420550,2014,12,0,0,12,100.0
420550,2015,15,0,0,15,100.0
420550,2016,16,0,0,16,100.0
420550,2017,15,0,0,15,100.0
420550,2018,8,0,0,8,100.0
420550,2019,17,0,0,17,100.0
420550,2020,12,0,0,12,100.0
420555,2012,0,0,1,1,0.0
420555,2013,1,0,0,1,100.0
420555,2014,1,0,0,1,100.0
420555,2016,1,0,0,1,100.0
420555,2017,1,0,0,1,100.0
420555,2019,0,1,0,1,100.0
420560,2012,1,0,0,1,100.0
420560,2013,2,0,0,2,100.0
420560,2015,1,0,1,2,50.0
420560,2016,1,0,0,1,100.0
420560,2017,2,0,0,2,100.0
420560,2018,2,0,0,2,100.0
420560,2020,2,0,0,2,100.0
420570,2012,2,0,0,2,100.0
420570,2014,7,0,0,7,100.0
420570,2015,8,0,0,8,100.0
420570,2016,4,0,0,4,100.0
420570,2017,4,0,0,4,100.0
420570,2018,4,0,0,4,100.0
420570,2019,5,0,0,5,100.0
420570,2020,6,0,0,6,100.0
420580,2012,7,0,0,7,100.0
420580,2013,0,0,1,1,0.0
420580,2014,7,0,1,8,87.5
420580,2015,5,0,0,5,100.0
420580,2016,8,0,0,8,100.0
420580,2017,5,0,0,5,100.0
420580,2018,6,0,0,6,100.0
420580,2019,4,0,1,5,80.0
420580,2020,6,0,1,7,85.71428571428571
420590,2012,12,0,0,12,100.0
420590,2013,21,0,0,21,100.0
420590,2014,16,0,0,16,100.0
420590,2015,19,0,0,19,100.0
420590,2016,18,0,0,18,100.0
420590,2017,29,0,0,29,100.0
420590,2018,12,0,0,12,100.0
420590,2019,12,0,0,12,100.0
420590,2020,21,0,0,21,100.0
420600,2012,5,0,2,7,71.42857142857143
420600,2013,1,0,0,1,100.0
420600,2014,2,0,0,2,100.0
420600,2015,6,0,0,6,100.0
420600,2016,3,0,0,3,100.0
420600,2017,2,0,0,2,100.0
420600,2018,3,0,0,3,100.0
420600,2019,4,0,0,4,100.0
420600,2020,3,0,0,3,100.0
420610,2015,2,0,0,2,100.0
420610,2016,3,0,0,3,100.0
420610,2017,3,0,0,3,100.0
420610,2018,1,0,0,1,100.0
420610,2019,1,0,0,1,100.0
420610,2020,1,0,0,1,100.0
420620,2012,2,1,0,3,100.0
420620,2013,2,0,0,2,100.0
420620,2014,5,0,0,5,100.0
420620,2015,5,0,0,5,100.0
420620,2016,1,0,0,1,100.0
420620,2017,2,0,0,2,100.0
420620,2018,2,0,0,2,100.0
420620,2019,1,0,1,2,50.0
420620,2020,1,0,0,1,100.0
420630,2012,4,0,6,10,40.0
420630,2013,1,2,0,3,100.0
420630,2014,0,1,2,3,33.33333333333333
420630,2015,1,2,0,3,100.0
420630,2016,8,0,0,8,100.0
420630,2017,5,1,0,6,100.0
420630,2018,1,0,0,1,100.0
420630,2019,5,0,0,5,100.0
420630,2020,1,0,0,1,100.0
420640,2012,4,0,0,4,100.0
420640,2013,4,0,0,4,100.0
420640,2015,3,0,0,3,100.0
420640,2016,1,0,0,1,100.0
420640,2018,6,0,0,6,100.0
420640,2019,3,0,0,3,100.0
420640,2020,2,0,0,2,100.0
420650,2012,12,0,0,12,100.0
420650,2013,12,0,0,12,100.0
420650,2014,9,0,0,9,100.0
420650,2015,8,0,0,8,100.0
420650,2016,13,0,0,13,100.0
420650,2017,11,0,0,11,100.0
420650,2018,11,0,0,11,100.0
420650,2019,10,0,0,10,100.0
420650,2020,11,0,0,11,100.0
420660,2013,1,0,0,1,100.0
420660,2015,2,0,0,2,100.0
420660,2016,2,0,0,2,100.0
420660,2017,2,0,0,2,100.0
420660,2018,1,0,0,1,100.0
420660,2019,1,0,0,1,100.0
420660,2020,1,0,0,1,100.0
420665,2012,1,0,0,1,100.0
420665,2013,1,0,0,1,100.0
420665,2014,2,0,0,2,100.0
420665,2015,3,0,0,3,100.0
420665,2016,1,0,0,1,100.0
420665,2017,3,0,0,3,100.0
420665,2018,2,0,0,2,100.0
420665,2019,3,0,0,3,100.0
420665,2020,1,1,0,2,100.0
420670,2012,3,0,2,5,60.0
420670,2013,0,0,5,5,0.0
420670,2014,0,0,7,7,0.0
420670,2015,8,0,0,8,100.0
420670,2016,7,0,0,7,100.0
420670,2017,6,0,0,6,100.0
420670,2018,5,0,0,5,100.0
420670,2019,3,0,5,8,37.5
420670,2020,8,0,0,8,100.0
420675,2012,0,0,1,1,0.0
420675,2016,1,0,0,1,100.0
420675,2017,2,0,0,2,100.0
420675,2019,2,0,0,2,100.0
420675,2020,1,0,0,1,100.0
420680,2012,2,0,0,2,100.0
420680,2013,2,0,0,2,100.0
420680,2015,1,0,0,1,100.0
420680,2018,1,0,0,1,100.0
420690,2012,8,1,0,9,100.0
420690,2013,3,0,0,3,100.0
420690,2014,5,0,0,5,100.0
420690,2015,3,0,0,3,100.0
420690,2016,3,0,0,3,100.0
420690,2017,5,0,0,5,100.0
420690,2018,10,0,0,10,100.0
420690,2019,9,0,0,9,100.0
420690,2020,5,0,0,5,100.0
420700,2012,19,0,1,20,95.0
420700,2013,14,0,0,14,100.0
420700,2014,18,0,0,18,100.0
420700,2015,12,0,0,12,100.0
420700,2016,10,0,0,10,100.0
420700,2017,8,0,0,8,100.0
420700,2018,8,1,0,9,100.0
420700,2019,24,0,1,25,96.0
420700,2020,9,0,0,9,100.0
420710,2012,7,0,0,7,100.0
420710,2013,4,0,1,5,80.0
420710,2014,4,0,0,4,100.0
420710,2015,5,0,0,5,100.0
420710,2016,2,0,0,2,100.0
420710,2017,4,0,0,4,100.0
420710,2018,5,0,0,5,100.0
420710,2019,10,0,0,10,100.0
420710,2020,3,0,0,3,100.0
420720,2012,2,1,1,4,75.0
420720,2013,2,0,0,2,100.0
420720,2014,2,0,0,2,100.0
420720,2015,3,0,0,3,100.0
420720,2016,2,0,0,2,100.0
420720,2017,4,0,0,4,100.0
420720,2018,3,0,0,3,100.0
420720,2019,2,0,0,2,100.0
420720,2020,5,0,0,5,100.0
420730,2012,14,0,0,14,100.0
420730,2013,14,0,0,14,100.0
420730,2014,15,0,0,15,100.0
420730,2015,12,0,0,12,100.0
420730,2016,11,0,0,11,100.0
420730,2017,12,0,0,12,100.0
420730,2018,12,0,0,12,100.0
420730,2019,12,0,2,14,85.71428571428571
420730,2020,19,0,0,19,100.0
420740,2013,1,0,0,1,100.0
420740,2014,3,0,0,3,100.0
420740,2015,2,0,0,2,100.0
420740,2016,2,0,0,2,100.0
420740,2017,3,0,0,3,100.0
420740,2018,1,0,0,1,100.0
420740,2019,2,0,0,2,100.0
420740,2020,1,0,0,1,100.0
420750,2012,16,1,1,18,94.44444444444444
420750,2013,22,0,0,22,100.0
420750,2014,16,0,0,16,100.0
420750,2015,11,0,0,11,100.0
420750,2016,21,0,0,21,100.0
420750,2017,15,0,0,15,100.0
420750,2018,12,0,0,12,100.0
420750,2019,14,0,0,14,100.0
420750,2020,13,0,0,13,100.0
420757,2018,1,0,0,1,100.0
420757,2019,0,0,1,1,0.0
420760,2013,2,0,1,3,66.66666666666666
420760,2018,2,0,0,2,100.0
420760,2019,0,1,0,1,100.0
420760,2020,1,0,0,1,100.0
420765,2012,2,0,0,2,100.0
420765,2015,1,0,0,1,100.0
420765,2016,1,0,1,2,50.0
420765,2018,3,0,0,3,100.0
420765,2019,5,0,0,5,100.0
420765,2020,2,0,0,2,100.0
420768,2012,1,1,3,5,40.0
420768,2013,1,0,0,1,100.0
420768,2014,3,0,0,3,100.0
420768,2015,3,0,0,3,100.0
420768,2016,1,0,0,1,100.0
420768,2017,3,0,0,3,100.0
420768,2018,3,0,0,3,100.0
420768,2019,2,0,0,2,100.0
420768,2020,4,0,0,4,100.0
420770,2012,1,3,0,4,100.0
420770,2013,0,0,1,1,0.0
420770,2014,4,0,0,4,100.0
420770,2016,1,0,0,1,100.0
420770,2017,4,0,0,4,100.0
420770,2020,1,0,0,1,100.0
420775,2012,1,0,0,1,100.0
420775,2015,1,0,0,1,100.0
420775,2017,1,0,0,1,100.0
420775,2018,1,0,0,1,100.0
420775,2020,1,0,0,1,100.0
420780,2012,3,2,1,6,83.33333333333334
420780,2013,1,0,1,2,50.0
420780,2014,3,0,0,3,100.0
420780,2016,3,1,1,5,80.0
420780,2017,3,0,0,3,100.0
420780,2018,3,0,0,3,100.0
420780,2019,2,0,0,2,100.0
420780,2020,2,0,0,2,100.0
420785,2014,1,0,0,1,100.0
420785,2020,0,0,1,1,0.0
420790,2012,0,0,1,1,0.0
420790,2013,2,0,1,3,66.66666666666666
420790,2014,8,0,0,8,100.0
420790,2015,2,0,0,2,100.0
420790,2016,1,1,1,3,66.66666666666666
420790,2017,4,0,0,4,100.0
420790,2018,3,0,0,3,100.0
420790,2019,2,0,0,2,100.0
420790,2020,2,0,0,2,100.0
420800,2012,0,0,1,1,0.0
420800,2013,1,0,0,1,100.0
420800,2014,1,0,0,1,100.0
420800,2015,1,1,1,3,66.66666666666666
420800,2016,1,0,0,1,100.0
420800,2017,1,0,0,1,100.0
420800,2018,0,1,0,1,100.0
420800,2020,1,0,0,1,100.0
420810,2012,4,0,5,9,44.44444444444444
420810,2013,5,0,1,6,83.33333333333334
420810,2014,2,1,0,3,100.0
420810,2015,3,0,1,4,75.0
420810,2016,3,2,1,6,83.33333333333334
420810,2017,8,0,0,8,100.0
420810,2018,5,0,0,5,100.0
420810,2019,2,0,0,2,100.0
420810,2020,4,0,0,4,100.0
420820,2012,72,2,1,75,98.66666666666667
420820,2013,64,0,0,64,100.0
420820,2014,80,0,0,80,100.0
420820,2015,68,0,1,69,98.55072463768117
420820,2016,65,0,0,65,100.0
420820,2017,73,1,3,77,96.1038961038961
420820,2018,75,2,4,81,95.06172839506173
420820,2019,63,0,0,63,100.0
420820,2020,76,0,0,76,100.0
420830,2012,5,3,8,16,50.0
420830,2013,7,9,2,18,88.88888888888889
420830,2014,13,0,0,13,100.0
420830,2015,16,1,0,17,100.0
420830,2016,14,0,0,14,100.0
420830,2017,17,0,0,17,100.0
420830,2018,14,1,0,15,100.0
420830,2019,19,0,0,19,100.0
420830,2020,31,0,0,31,100.0
420840,2012,2,0,0,2,100.0
420840,2013,2,0,0,2,100.0
420840,2014,2,0,2,4,50.0
420840,2015,5,0,0,5,100.0
420840,2016,5,0,0,5,100.0
420840,2017,4,0,0,4,100.0
420840,2018,2,0,0,2,100.0
420840,2019,3,0,0,3,100.0
420840,2020,3,0,0,3,100.0
420845,2012,5,0,0,5,100.0
420845,2013,5,0,4,9,55.55555555555556
420845,2014,5,0,0,5,100.0
420845,2015,8,0,0,8,100.0
420845,2016,3,0,0,3,100.0
420845,2017,6,0,0,6,100.0
420845,2018,2,0,0,2,100.0
420845,2019,10,0,2,12,83.33333333333334
420845,2020,10,0,0,10,100.0
420850,2012,6,0,0,6,100.0
420850,2013,9,0,0,9,100.0
420850,2014,6,0,0,6,100.0
420850,2015,11,0,0,11,100.0
420850,2016,4,0,0,4,100.0
420850,2017,11,0,0,11,100.0
420850,2018,5,0,1,6,83.33333333333334
420850,2019,10,0,0,10,100.0
420850,2020,10,0,0,10,100.0
420860,2013,1,0,0,1,100.0
420860,2014,0,0,1,1,0.0
420860,2015,2,0,0,2,100.0
420860,2017,4,0,0,4,100.0
420860,2018,1,0,0,1,100.0
420860,2019,1,0,0,1,100.0
420860,2020,3,0,0,3,100.0
420870,2012,2,1,0,3,100.0
420870,2013,1,0,1,2,50.0
420870,2014,3,0,1,4,75.0
420870,2015,3,0,0,3,100.0
420870,2016,4,0,0,4,100.0
420870,2017,2,0,0,2,100.0
420870,2018,2,0,0,2,100.0
420870,2019,2,0,0,2,100.0
420870,2020,3,0,0,3,100.0
420880,2012,4,0,0,4,100.0
420880,2013,6,0,0,6,100.0
420880,2014,7,0,0,7,100.0
420880,2015,7,0,0,7,100.0
420880,2016,2,0,0,2,100.0
420880,2017,8,0,0,8,100.0
420880,2018,4,0,0,4,100.0
420880,2019,3,0,0,3,100.0
420880,2020,12,0,0,12,100.0
420890,2012,62,0,0,62,100.0
420890,2013,45,0,0,45,100.0
420890,2014,36,0,0,36,100.0
420890,2015,38,0,0,38,100.0
420890,2016,47,0,0,47,100.0
420890,2017,44,0,0,44,100.0
420890,2018,46,0,0,46,100.0
420890,2019,25,0,0,25,100.0
420890,2020,45,0,0,45,100.0
420895,2012,2,0,0,2,100.0
420895,2016,1,0,0,1,100.0
420895,2018,2,0,0,2,100.0
420895,2019,1,0,0,1,100.0
420895,2020,0,0,1,1,0.0
420900,2012,7,1,0,8,100.0
420900,2013,13,0,0,13,100.0
420900,2014,6,0,0,6,100.0
420900,2015,6,0,0,6,100.0
420900,2016,4,0,0,4,100.0
420900,2017,8,0,0,8,100.0
420900,2018,13,0,0,13,100.0
420900,2019,5,0,0,5,100.0
420900,2020,4,0,1,5,80.0
420910,2012,153,1,0,154,100.0
420910,2013,134,0,0,134,100.0
420910,2014,137,0,0,137,100.0
420910,2015,132,0,0,132,100.0
420910,2016,158,0,0,158,100.0
420910,2017,138,0,0,138,100.0
420910,2018,146,0,3,149,97.98657718120806
420910,2019,148,0,0,148,100.0
420910,2020,128,0,0,128,100.0
420915,2012,1,0,1,2,50.0
420915,2013,2,0,0,2,100.0
420915,2014,1,0,0,1,100.0
420915,2015,3,0,0,3,100.0
420915,2017,1,0,0,1,100.0
420915,2018,2,0,0,2,100.0
420915,2019,3,0,0,3,100.0
420915,2020,4,0,0,4,100.0
420917,2012,1,0,0,1,100.0
420917,2017,1,0,0,1,100.0
420917,2020,1,0,0,1,100.0
420920,2012,0,0,1,1,0.0
420930,2012,63,1,5,69,92.7536231884058
420930,2013,59,1,0,60,100.0
420930,2014,70,0,0,70,100.0
420930,2015,61,0,0,61,100.0
420930,2016,75,0,0,75,100.0
420930,2017,55,0,0,55,100.0
420930,2018,57,1,0,58,100.0
420930,2019,70,0,0,70,100.0
420930,2020,64,1,0,65,100.0
420940,2012,27,0,0,27,100.0
420940,2013,24,0,0,24,100.0
420940,2014,18,0,0,18,100.0
420940,2015,20,0,0,20,100.0
420940,2016,14,1,0,15,100.0
420940,2017,22,0,0,22,100.0
420940,2018,14,0,0,14,100.0
420940,2019,9,0,0,9,100.0
420940,2020,13,0,0,13,100.0
420945,2013,1,0,0,1,100.0
420945,2016,1,0,0,1,100.0
420945,2017,1,0,0,1,100.0
420945,2020,1,0,0,1,100.0
420950,2012,1,0,0,1,100.0
420950,2015,3,0,0,3,100.0
420950,2016,2,0,0,2,100.0
420950,2017,2,0,0,2,100.0
420950,2018,3,0,0,3,100.0
420950,2019,2,0,0,2,100.0
420950,2020,2,0,0,2,100.0
420960,2012,4,0,0,4,100.0
420960,2013,3,0,0,3,100.0
420960,2014,3,0,1,4,75.0
420960,2015,6,0,0,6,100.0
420960,2016,6,0,0,6,100.0
420960,2017,2,0,0,2,100.0
420960,2018,5,0,0,5,100.0
420960,2019,6,0,0,6,100.0
420960,2020,3,0,0,3,100.0
420970,2012,1,0,4,5,20.0
420970,2013,6,0,0,6,100.0
420970,2014,4,0,0,4,100.0
420970,2015,7,0,0,7,100.0
420970,2016,3,0,0,3,100.0
420970,2017,8,0,0,8,100.0
420970,2018,7,0,0,7,100.0
420970,2019,5,0,0,5,100.0
420970,2020,6,0,0,6,100.0
420980,2012,1,0,0,1,100.0
420980,2013,2,0,0,2,100.0
420980,2014,1,0,0,1,100.0
420980,2015,0,0,1,1,0.0
420980,2016,1,0,0,1,100.0
420980,2017,1,0,0,1,100.0
420980,2018,3,0,0,3,100.0
420980,2020,0,0,1,1,0.0
420985,2012,0,0,1,1,0.0
420985,2013,0,0,1,1,0.0
420985,2015,0,0,1,1,0.0
420985,2016,1,0,0,1,100.0
420985,2018,1,0,0,1,100.0
420985,2019,0,1,0,1,100.0
420990,2012,4,0,0,4,100.0
420990,2013,6,0,0,6,100.0
420990,2014,6,0,0,6,100.0
420990,2015,2,0,0,2,100.0
420990,2016,6,0,0,6,100.0
420990,2017,5,0,0,5,100.0
420990,2018,4,0,0,4,100.0
420990,2019,5,0,0,5,100.0
420990,2020,3,0,0,3,100.0
421000,2012,3,1,0,4,100.0
421000,2013,2,0,0,2,100.0
421000,2014,2,0,0,2,100.0
421000,2015,4,0,0,4,100.0
421000,2016,3,0,0,3,100.0
421000,2017,3,0,0,3,100.0
421000,2018,2,0,0,2,100.0
421000,2019,2,0,0,2,100.0
421000,2020,5,0,0,5,100.0
421003,2012,0,0,3,3,0.0
421003,2013,0,0,1,1,0.0
421003,2014,2,0,0,2,100.0
421003,2017,0,0,1,1,0.0
421003,2018,0,0,1,1,0.0
421003,2020,0,0,1,1,0.0
421005,2013,1,0,0,1,100.0
421005,2014,1,0,0,1,100.0
421005,2015,1,0,0,1,100.0
421005,2016,1,0,0,1,100.0
421005,2019,1,0,0,1,100.0
421010,2012,31,2,0,33,100.0
421010,2013,19,0,0,19,100.0
421010,2014,13,0,0,13,100.0
421010,2015,22,0,0,22,100.0
421010,2016,16,0,0,16,100.0
421010,2017,18,0,1,19,94.73684210526315
421010,2018,22,0,0,22,100.0
421010,2019,13,0,0,13,100.0
421010,2020,17,0,0,17,100.0
421020,2013,1,0,0,1,100.0
421020,2016,1,0,0,1,100.0
421020,2017,2,0,0,2,100.0
421020,2018,1,0,0,1,100.0
421020,2019,1,0,0,1,100.0
421020,2020,1,0,0,1,100.0
421030,2012,0,1,5,6,16.666666666666664
421030,2014,1,0,0,1,100.0
421030,2015,1,0,0,1,100.0
421030,2016,3,0,0,3,100.0
421030,2017,3,1,0,4,100.0
421030,2018,1,0,1,2,50.0
421030,2020,5,0,0,5,100.0
421040,2012,2,0,0,2,100.0
421040,2013,2,0,0,2,100.0
421040,2014,2,0,0,2,100.0
421040,2015,5,0,0,5,100.0
421040,2016,3,0,0,3,100.0
421040,2017,1,0,0,1,100.0
421040,2018,2,0,0,2,100.0
421040,2019,5,0,0,5,100.0
421040,2020,2,0,0,2,100.0
421050,2012,6,3,1,10,90.0
421050,2013,6,0,0,6,100.0
421050,2014,5,0,0,5,100.0
421050,2015,5,0,0,5,100.0
421050,2016,8,0,0,8,100.0
421050,2017,5,0,0,5,100.0
421050,2018,9,0,1,10,90.0
421050,2019,8,0,0,8,100.0
421050,2020,7,0,0,7,100.0
421055,2017,1,0,0,1,100.0
421055,2019,0,0,2,2,0.0
421060,2012,5,0,1,6,83.33333333333334
421060,2013,5,0,0,5,100.0
421060,2014,6,0,0,6,100.0
421060,2015,3,0,0,3,100.0
421060,2016,4,0,0,4,100.0
421060,2017,5,0,0,5,100.0
421060,2018,2,0,0,2,100.0
421060,2019,5,0,0,5,100.0
421060,2020,7,0,0,7,100.0
421070,2014,1,0,0,1,100.0
421070,2015,1,0,0,1,100.0
421070,2016,0,2,0,2,100.0
421080,2012,3,0,0,3,100.0
421080,2013,1,0,1,2,50.0
421080,2014,1,0,0,1,100.0
421080,2015,1,0,0,1,100.0
421080,2016,2,0,0,2,100.0
421080,2017,3,0,0,3,100.0
421080,2019,2,0,0,2,100.0
421080,2020,1,0,0,1,100.0
421085,2014,2,0,0,2,100.0
421085,2017,2,0,0,2,100.0
421090,2012,1,0,1,2,50.0
421090,2017,1,1,0,2,100.0
421090,2019,2,0,0,2,100.0
421100,2014,2,0,0,2,100.0
421100,2015,3,0,0,3,100.0
421100,2016,5,0,0,5,100.0
421100,2017,3,0,0,3,100.0
421100,2019,2,0,0,2,100.0
421100,2020,2,0,0,2,100.0
421105,2012,2,0,2,4,50.0
421105,2013,2,0,1,3,66.66666666666666
421105,2014,4,0,1,5,80.0
421105,2015,6,0,0,6,100.0
421105,2016,4,0,0,4,100.0
421105,2017,1,0,0,1,100.0
421105,2018,2,0,1,3,66.66666666666666
421105,2019,0,3,1,4,75.0
421105,2020,6,0,0,6,100.0
421110,2012,0,0,2,2,0.0
421110,2013,4,0,2,6,66.66666666666666
421110,2014,4,0,0,4,100.0
421110,2015,1,0,1,2,50.0
421110,2016,5,0,0,5,100.0
421110,2017,1,0,1,2,50.0
421110,2018,2,1,0,3,100.0
421110,2019,2,0,0,2,100.0
421110,2020,6,0,0,6,100.0
421120,2012,6,0,0,6,100.0
421120,2013,4,0,0,4,100.0
421120,2014,6,0,0,6,100.0
421120,2015,6,0,0,6,100.0
421120,2016,5,0,0,5,100.0
421120,2017,5,0,0,5,100.0
421120,2018,4,0,0,4,100.0
421120,2019,2,0,0,2,100.0
421120,2020,0,0,6,6,0.0
421125,2013,0,0,1,1,0.0
421125,2016,1,0,0,1,100.0
421125,2017,2,0,0,2,100.0
421125,2018,1,0,0,1,100.0
421130,2012,14,12,4,30,86.66666666666667
421130,2013,26,1,3,30,90.0
421130,2014,31,0,0,31,100.0
421130,2015,24,4,0,28,100.0
421130,2016,35,0,0,35,100.0
421130,2017,28,0,0,28,100.0
421130,2018,22,0,0,22,100.0
421130,2019,31,1,0,32,100.0
421130,2020,30,0,0,30,100.0
421140,2012,0,1,0,1,100.0
421140,2013,1,0,0,1,100.0
421140,2014,1,0,0,1,100.0
421140,2015,1,0,0,1,100.0
421140,2017,1,0,0,1,100.0
421140,2018,2,0,0,2,100.0
421140,2019,2,0,0,2,100.0
421140,2020,1,0,0,1,100.0
421145,2012,1,0,0,1,100.0
421145,2013,1,0,0,1,100.0
421145,2015,1,0,0,1,100.0
421145,2016,3,0,0,3,100.0
421145,2018,1,0,0,1,100.0
421145,2019,1,0,0,1,100.0
421145,2020,2,0,0,2,100.0
421150,2012,5,0,0,5,100.0
421150,2013,2,0,0,2,100.0
421150,2014,3,0,0,3,100.0
421150,2015,3,0,0,3,100.0
421150,2016,2,0,0,2,100.0
421150,2017,1,0,0,1,100.0
421150,2019,5,0,0,5,100.0
421150,2020,2,0,0,2,100.0
421160,2012,3,0,0,3,100.0
421160,2013,3,0,1,4,75.0
421160,2014,0,0,1,1,0.0
421160,2015,2,0,0,2,100.0
421160,2016,2,0,0,2,100.0
421160,2017,3,0,0,3,100.0
421160,2018,3,0,0,3,100.0
421160,2019,2,0,0,2,100.0
421160,2020,4,0,0,4,100.0
421165,2015,1,0,0,1,100.0
421165,2016,2,0,0,2,100.0
421165,2018,1,0,0,1,100.0
421170,2012,6,0,0,6,100.0
421170,2013,4,0,0,4,100.0
421170,2014,9,0,1,10,90.0
421170,2015,7,0,0,7,100.0
421170,2016,9,0,0,9,100.0
421170,2017,5,0,0,5,100.0
421170,2018,7,0,0,7,100.0
421170,2019,8,0,0,8,100.0
421170,2020,4,0,0,4,100.0
421175,2012,5,0,3,8,62.5
421175,2013,12,0,0,12,100.0
421175,2014,5,0,0,5,100.0
421175,2015,6,0,0,6,100.0
421175,2016,4,0,0,4,100.0
421175,2017,8,0,0,8,100.0
421175,2018,9,0,0,9,100.0
421175,2019,8,0,0,8,100.0
421175,2020,10,0,0,10,100.0
421180,2012,3,0,0,3,100.0
421180,2014,1,1,2,4,50.0
421180,2015,0,0,2,2,0.0
421180,2017,2,0,0,2,100.0
421180,2018,4,0,0,4,100.0
421180,2019,1,0,1,2,50.0
421180,2020,1,0,0,1,100.0
421185,2013,1,0,0,1,100.0
421185,2016,2,0,0,2,100.0
421185,2018,1,0,0,1,100.0
421187,2014,1,0,0,1,100.0
421187,2015,2,0,0,2,100.0
421187,2016,1,0,0,1,100.0
421187,2018,2,0,0,2,100.0
421187,2019,1,0,0,1,100.0
421189,2012,1,0,0,1,100.0
421189,2015,1,0,0,1,100.0
421189,2016,1,0,0,1,100.0
421189,2018,2,0,0,2,100.0
421189,2019,1,0,0,1,100.0
421189,2020,2,0,0,2,100.0
421190,2012,56,0,3,59,94.91525423728814
421190,2013,49,0,0,49,100.0
421190,2014,54,0,0,54,100.0
421190,2015,44,0,0,44,100.0
421190,2016,56,0,0,56,100.0
421190,2017,69,0,0,69,100.0
421190,2018,46,0,0,46,100.0
421190,2019,50,0,0,50,100.0
421190,2020,55,0,0,55,100.0
421200,2012,0,1,1,2,50.0
421200,2013,2,0,0,2,100.0
421200,2014,4,0,0,4,100.0
421200,2015,4,0,0,4,100.0
421200,2016,2,0,0,2,100.0
421200,2017,4,0,0,4,100.0
421200,2018,3,0,0,3,100.0
421200,2019,2,0,0,2,100.0
421200,2020,2,0,0,2,100.0
421205,2014,1,0,0,1,100.0
421205,2017,3,0,0,3,100.0
421205,2020,1,0,0,1,100.0
421210,2012,3,2,1,6,83.33333333333334
421210,2013,3,0,0,3,100.0
421210,2014,5,0,0,5,100.0
421210,2015,6,0,0,6,100.0
421210,2016,5,0,0,5,100.0
421210,2017,4,0,0,4,100.0
421210,2018,5,0,0,5,100.0
421210,2019,7,1,0,8,100.0
421210,2020,3,0,0,3,100.0
421220,2012,0,2,4,6,33.33333333333333
421220,2013,2,0,4,6,33.33333333333333
421220,2014,7,0,0,7,100.0
421220,2015,7,0,1,8,87.5
421220,2016,4,0,2,6,66.66666666666666
421220,2017,1,1,1,3,66.66666666666666
421220,2018,7,0,0,7,100.0
421220,2019,2,0,0,2,100.0
421220,2020,8,0,0,8,100.0
421223,2015,2,0,0,2,100.0
421223,2016,1,0,0,1,100.0
421223,2019,1,0,0,1,100.0
421223,2020,2,0,0,2,100.0
421225,2012,3,0,0,3,100.0
421225,2013,0,0,1,1,0.0
421225,2014,3,0,0,3,100.0
421225,2015,6,0,0,6,100.0
421225,2016,3,0,0,3,100.0
421225,2017,2,0,0,2,100.0
421225,2019,1,0,0,1,100.0
421225,2020,4,0,0,4,100.0
421227,2013,0,1,0,1,100.0
421227,2014,0,0,2,2,0.0
421227,2015,1,0,1,2,50.0
421227,2016,1,0,0,1,100.0
421227,2017,2,0,0,2,100.0
421227,2018,2,1,0,3,100.0
421227,2019,1,0,0,1,100.0
421227,2020,2,0,0,2,100.0
421230,2013,3,0,0,3,100.0
421230,2015,1,1,0,2,100.0
421230,2016,3,0,0,3,100.0
421230,2017,3,0,0,3,100.0
421230,2018,3,0,0,3,100.0
421230,2019,3,0,0,3,100.0
421240,2012,1,1,0,2,100.0
421240,2014,1,0,0,1,100.0
421240,2015,1,0,0,1,100.0
421240,2017,1,0,0,1,100.0
421240,2018,2,0,0,2,100.0
421240,2019,1,0,0,1,100.0
421240,2020,1,0,0,1,100.0
421250,2012,8,0,1,9,88.88888888888889
421250,2013,8,0,0,8,100.0
421250,2014,6,0,0,6,100.0
421250,2015,7,0,0,7,100.0
421250,2016,13,0,0,13,100.0
421250,2017,12,0,0,12,100.0
421250,2018,8,0,0,8,100.0
421250,2019,9,0,0,9,100.0
421250,2020,15,0,0,15,100.0
421260,2012,0,1,1,2,50.0
421260,2017,3,0,0,3,100.0
421260,2018,0,1,0,1,100.0
421265,2014,1,0,0,1,100.0
421265,2015,1,0,0,1,100.0
421265,2016,2,0,0,2,100.0
421265,2017,3,0,0,3,100.0
421265,2018,2,0,0,2,100.0
421265,2019,1,0,0,1,100.0
421265,2020,3,0,0,3,100.0
421270,2012,1,0,0,1,100.0
421270,2013,1,0,0,1,100.0
421270,2014,3,0,0,3,100.0
421270,2017,2,0,0,2,100.0
421270,2019,2,0,0,2,100.0
421270,2020,4,0,0,4,100.0
421280,2012,4,1,3,8,62.5
421280,2013,4,1,0,5,100.0
421280,2014,5,0,0,5,100.0
421280,2015,5,0,0,5,100.0
421280,2016,8,0,0,8,100.0
421280,2017,11,0,0,11,100.0
421280,2018,6,0,0,6,100.0
421280,2019,9,0,0,9,100.0
421280,2020,9,0,0,9,100.0
421290,2012,1,0,0,1,100.0
421290,2013,3,0,0,3,100.0
421290,2014,4,0,0,4,100.0
421290,2015,5,0,0,5,100.0
421290,2016,5,0,0,5,100.0
421290,2017,6,0,0,6,100.0
421290,2018,6,0,0,6,100.0
421290,2019,5,0,0,5,100.0
421290,2020,5,0,0,5,100.0
421300,2013,2,0,0,2,100.0
421300,2015,1,0,0,1,100.0
421300,2017,2,0,0,2,100.0
421300,2018,1,0,0,1,100.0
421300,2019,0,1,1,2,50.0
421300,2020,1,1,0,2,100.0
421310,2012,0,0,1,1,0.0
421310,2013,0,0,1,1,0.0
421310,2014,2,0,0,2,100.0
421310,2016,1,0,0,1,100.0
421310,2017,0,1,0,1,100.0
421310,2018,1,0,0,1,100.0
421310,2019,2,1,0,3,100.0
421310,2020,0,0,1,1,0.0
421315,2013,2,0,0,2,100.0
421315,2014,3,0,0,3,100.0
421315,2015,2,0,0,2,100.0
421315,2017,2,0,0,2,100.0
421315,2018,2,0,0,2,100.0
421320,2012,12,0,0,12,100.0
421320,2013,6,0,0,6,100.0
421320,2014,8,0,0,8,100.0
421320,2015,10,0,0,10,100.0
421320,2016,6,0,0,6,100.0
421320,2017,4,0,0,4,100.0
421320,2018,11,0,0,11,100.0
421320,2019,5,0,0,5,100.0
421320,2020,13,0,0,13,100.0
421330,2012,2,0,1,3,66.66666666666666
421330,2013,1,0,0,1,100.0
421330,2014,2,0,0,2,100.0
421330,2015,4,0,0,4,100.0
421330,2016,1,0,0,1,100.0
421330,2017,2,0,0,2,100.0
421330,2018,3,0,0,3,100.0
421330,2019,2,0,0,2,100.0
421330,2020,2,0,0,2,100.0
421335,2012,4,0,0,4,100.0
421335,2013,1,0,0,1,100.0
421335,2014,1,0,0,1,100.0
421335,2015,1,0,0,1,100.0
421335,2016,1,0,0,1,100.0
421335,2017,2,1,0,3,100.0
421335,2018,0,2,0,2,100.0
421335,2019,0,0,3,3,0.0
421335,2020,2,0,0,2,100.0
421340,2012,8,0,0,8,100.0
421340,2013,3,0,0,3,100.0
421340,2014,6,0,0,6,100.0
421340,2015,3,0,0,3,100.0
421340,2016,5,0,0,5,100.0
421340,2017,5,0,0,5,100.0
421340,2018,5,0,0,5,100.0
421340,2019,5,0,0,5,100.0
421340,2020,3,0,0,3,100.0
421350,2012,0,0,5,5,0.0
421350,2013,2,1,3,6,50.0
421350,2014,10,0,0,10,100.0
421350,2015,3,0,0,3,100.0
421350,2016,11,0,0,11,100.0
421350,2017,2,4,3,9,66.66666666666666
421350,2018,3,1,0,4,100.0
421350,2019,6,0,1,7,85.71428571428571
421350,2020,10,1,0,11,100.0
421360,2012,7,0,0,7,100.0
421360,2013,8,0,0,8,100.0
421360,2014,15,0,0,15,100.0
421360,2015,22,0,0,22,100.0
421360,2016,6,0,0,6,100.0
421360,2017,5,0,0,5,100.0
421360,2018,10,0,0,10,100.0
421360,2019,8,0,0,8,100.0
421360,2020,10,0,0,10,100.0
421370,2012,7,0,0,7,100.0
421370,2013,8,0,0,8,100.0
421370,2014,12,0,0,12,100.0
421370,2015,4,0,0,4,100.0
421370,2016,4,0,0,4,100.0
421370,2017,1,0,0,1,100.0
421370,2018,5,0,0,5,100.0
421370,2019,3,0,0,3,100.0
421370,2020,2,0,0,2,100.0
421380,2012,1,0,1,2,50.0
421380,2013,0,0,2,2,0.0
421380,2014,3,0,0,3,100.0
421380,2016,3,0,0,3,100.0
421380,2017,3,0,0,3,100.0
421380,2018,4,0,0,4,100.0
421380,2019,1,2,1,4,75.0
421380,2020,2,0,0,2,100.0
421390,2012,0,0,1,1,0.0
421390,2015,1,0,0,1,100.0
421400,2012,9,0,0,9,100.0
421400,2013,6,0,0,6,100.0
421400,2014,4,0,0,4,100.0
421400,2015,3,0,0,3,100.0
421400,2016,4,0,0,4,100.0
421400,2017,4,0,0,4,100.0
421400,2018,5,0,0,5,100.0
421400,2019,4,0,0,4,100.0
421400,2020,13,0,0,13,100.0
421410,2013,2,0,0,2,100.0
421410,2014,1,0,0,1,100.0
421410,2015,1,0,0,1,100.0
421410,2017,1,0,0,1,100.0
421410,2020,1,0,0,1,100.0
421415,2012,1,0,0,1,100.0
421415,2013,1,0,0,1,100.0
421415,2014,2,0,0,2,100.0
421415,2017,1,0,0,1,100.0
421420,2012,2,0,0,2,100.0
421420,2013,4,0,0,4,100.0
421420,2014,3,0,0,3,100.0
421420,2016,1,0,0,1,100.0
421420,2017,2,0,0,2,100.0
421420,2019,2,0,0,2,100.0
421420,2020,0,0,3,3,0.0
421430,2012,1,0,0,1,100.0
421430,2013,1,0,0,1,100.0
421430,2014,1,0,0,1,100.0
421430,2015,1,0,0,1,100.0
421430,2016,2,0,0,2,100.0
421430,2020,0,1,0,1,100.0
421440,2012,0,0,1,1,0.0
421440,2014,1,0,0,1,100.0
421440,2015,2,0,0,2,100.0
421440,2016,3,0,0,3,100.0
421440,2018,0,0,2,2,0.0
421440,2019,0,2,1,3,66.66666666666666
421450,2012,2,0,1,3,66.66666666666666
421450,2013,2,0,0,2,100.0
421450,2014,3,0,0,3,100.0
421450,2015,5,0,0,5,100.0
421450,2016,5,0,0,5,100.0
421450,2017,2,0,1,3,66.66666666666666
421450,2018,1,0,0,1,100.0
421450,2019,1,0,0,1,100.0
421450,2020,1,0,0,1,100.0
421460,2013,2,0,0,2,100.0
421460,2014,4,0,0,4,100.0
421460,2015,5,0,0,5,100.0
421460,2016,3,0,0,3,100.0
421460,2017,2,0,0,2,100.0
421460,2018,2,0,0,2,100.0
421460,2019,1,0,0,1,100.0
421460,2020,3,0,0,3,100.0
421470,2012,1,0,2,3,33.33333333333333
421470,2013,0,3,0,3,100.0
421470,2014,1,1,3,5,40.0
421470,2015,1,0,1,2,50.0
421470,2017,1,2,1,4,75.0
421470,2018,6,1,0,7,100.0
421470,2020,2,0,0,2,100.0
421480,2012,14,0,0,14,100.0
421480,2013,16,0,0,16,100.0
421480,2014,20,0,0,20,100.0
421480,2015,24,0,0,24,100.0
421480,2016,28,0,0,28,100.0
421480,2017,19,0,0,19,100.0
421480,2018,16,0,0,16,100.0
421480,2019,15,0,0,15,100.0
421480,2020,15,0,0,15,100.0
421490,2015,2,0,0,2,100.0
421490,2016,2,0,0,2,100.0
421490,2017,1,0,0,1,100.0
421490,2018,1,0,0,1,100.0
421490,2019,1,0,0,1,100.0
421500,2012,0,5,3,8,62.5
421500,2013,15,0,0,15,100.0
421500,2014,16,0,0,16,100.0
421500,2015,11,0,0,11,100.0
421500,2016,13,0,0,13,100.0
421500,2017,9,0,0,9,100.0
421500,2018,10,0,1,11,90.9090909090909
421500,2019,9,0,0,9,100.0
421500,2020,15,0,0,15,100.0
421505,2013,1,0,0,1,100.0
421505,2018,1,0,0,1,100.0
421505,2019,1,0,0,1,100.0
421507,2014,2,0,0,2,100.0
421507,2015,1,0,0,1,100.0
421507,2017,1,0,0,1,100.0
421507,2018,1,0,0,1,100.0
421507,2019,3,0,0,3,100.0
421510,2012,1,1,1,3,66.66666666666666
421510,2013,1,1,1,3,66.66666666666666
421510,2014,2,4,0,6,100.0
421510,2015,2,0,0,2,100.0
421510,2016,3,0,0,3,100.0
421510,2017,1,0,0,1,100.0
421510,2018,3,0,0,3,100.0
421510,2019,1,0,0,1,100.0
421510,2020,6,0,0,6,100.0
421520,2012,1,0,0,1,100.0
421520,2014,1,0,0,1,100.0
421520,2017,1,0,0,1,100.0
421520,2018,0,0,1,1,0.0
421520,2019,2,0,1,3,66.66666666666666
421520,2020,0,0,1,1,0.0
421530,2012,3,0,0,3,100.0
421530,2013,2,0,0,2,100.0
421530,2015,4,0,0,4,100.0
421530,2016,1,0,0,1,100.0
421530,2018,2,0,0,2,100.0
421530,2020,2,0,0,2,100.0
421535,2013,1,0,0,1,100.0
421535,2014,3,0,0,3,100.0
421535,2016,1,0,0,1,100.0
421535,2017,2,0,0,2,100.0
421535,2018,1,0,0,1,100.0
421535,2020,3,0,0,3,100.0
421540,2012,1,0,0,1,100.0
421540,2013,4,0,0,4,100.0
421540,2014,2,0,0,2,100.0
421540,2015,2,0,0,2,100.0
421540,2016,2,0,0,2,100.0
421540,2017,4,0,0,4,100.0
421540,2018,1,0,0,1,100.0
421540,2020,2,0,0,2,100.0
421545,2012,3,0,0,3,100.0
421545,2013,2,0,1,3,66.66666666666666
421545,2014,5,0,0,5,100.0
421545,2015,3,0,0,3,100.0
421545,2016,4,0,0,4,100.0
421545,2017,3,0,0,3,100.0
421545,2018,2,0,0,2,100.0
421545,2019,1,0,1,2,50.0
421545,2020,1,0,0,1,100.0
421550,2012,0,1,4,5,20.0
421550,2013,5,0,0,5,100.0
421550,2014,7,0,0,7,100.0
421550,2015,14,0,0,14,100.0
421550,2016,11,0,0,11,100.0
421550,2017,5,0,0,5,100.0
421550,2018,6,0,0,6,100.0
421550,2019,8,0,0,8,100.0
421550,2020,6,0,0,6,100.0
421555,2012,1,0,0,1,100.0
421555,2014,1,0,0,1,100.0
421560,2013,1,0,0,1,100.0
421560,2015,2,0,0,2,100.0
421560,2017,1,0,0,1,100.0
421565,2012,2,1,0,3,100.0
421565,2013,0,0,1,1,0.0
421565,2014,1,0,0,1,100.0
421565,2015,2,0,0,2,100.0
421565,2016,1,0,0,1,100.0
421565,2017,2,0,0,2,100.0
421565,2018,2,0,0,2,100.0
421565,2019,2,0,0,2,100.0
421565,2020,5,0,0,5,100.0
421567,2012,2,0,0,2,100.0
421567,2013,1,0,0,1,100.0
421567,2014,2,0,0,2,100.0
421567,2015,1,0,0,1,100.0
421567,2016,1,0,0,1,100.0
421567,2017,7,0,0,7,100.0
421567,2018,1,0,0,1,100.0
421567,2019,3,0,0,3,100.0
421567,2020,1,0,0,1,100.0
421568,2012,0,1,1,2,50.0
421568,2016,1,0,0,1,100.0
421568,2018,1,0,0,1,100.0
421569,2012,0,0,1,1,0.0
421569,2014,1,0,0,1,100.0
421569,2018,1,0,0,1,100.0
421569,2019,0,0,1,1,0.0
421570,2012,4,0,0,4,100.0
421570,2013,5,0,2,7,71.42857142857143
421570,2014,1,0,0,1,100.0
421570,2015,3,0,0,3,100.0
421570,2016,7,0,0,7,100.0
421570,2017,7,0,0,7,100.0
421570,2018,5,0,0,5,100.0
421570,2019,2,0,0,2,100.0
421570,2020,8,0,0,8,100.0
421575,2013,1,0,0,1,100.0
421575,2015,1,0,0,1,100.0
421575,2017,1,0,0,1,100.0
421575,2019,2,0,0,2,100.0
421575,2020,3,0,0,3,100.0
421580,2012,17,0,0,17,100.0
421580,2013,30,0,0,30,100.0
421580,2014,32,0,0,32,100.0
421580,2015,17,0,0,17,100.0
421580,2016,25,0,0,25,100.0
421580,2017,24,0,0,24,100.0
421580,2018,23,0,0,23,100.0
421580,2019,23,0,0,23,100.0
421580,2020,22,0,0,22,100.0
421590,2013,2,0,0,2,100.0
421590,2016,1,0,0,1,100.0
421590,2019,2,0,0,2,100.0
421600,2012,2,1,1,4,75.0
421600,2013,2,0,0,2,100.0
421600,2014,2,0,0,2,100.0
421600,2015,1,0,0,1,100.0
421600,2016,1,0,0,1,100.0
421600,2017,3,0,0,3,100.0
421600,2018,2,0,0,2,100.0
421600,2019,3,0,0,3,100.0
421600,2020,4,0,0,4,100.0
421605,2013,1,0,0,1,100.0
421605,2014,1,1,0,2,100.0
421605,2015,1,0,0,1,100.0
421605,2016,1,0,0,1,100.0
421605,2017,1,0,0,1,100.0
421605,2018,2,0,0,2,100.0
421605,2020,2,0,0,2,100.0
421610,2012,4,0,0,4,100.0
421610,2013,2,0,0,2,100.0
421610,2014,2,0,0,2,100.0
421610,2015,3,0,0,3,100.0
421610,2016,3,0,0,3,100.0
421610,2017,6,0,0,6,100.0
421610,2018,5,0,0,5,100.0
421610,2019,2,0,0,2,100.0
421610,2020,1,0,0,1,100.0
421620,2012,14,0,0,14,100.0
421620,2013,16,0,0,16,100.0
421620,2014,16,0,0,16,100.0
421620,2015,14,0,1,15,93.33333333333333
421620,2016,12,0,0,12,100.0
421620,2017,14,0,0,14,100.0
421620,2018,11,0,0,11,100.0
421620,2019,10,0,1,11,90.9090909090909
421620,2020,14,0,0,14,100.0
421625,2012,1,0,0,1,100.0
421625,2013,0,0,1,1,0.0
421625,2014,1,0,0,1,100.0
421625,2017,2,0,0,2,100.0
421625,2019,2,0,0,2,100.0
421625,2020,1,0,0,1,100.0
421630,2012,7,0,1,8,87.5
421630,2013,7,0,0,7,100.0
421630,2014,9,0,0,9,100.0
421630,2015,3,5,0,8,100.0
421630,2016,8,0,0,8,100.0
421630,2017,5,0,0,5,100.0
421630,2018,4,0,0,4,100.0
421630,2019,8,0,0,8,100.0
421630,2020,8,0,0,8,100.0
421635,2014,3,0,0,3,100.0
421635,2015,2,0,0,2,100.0
421635,2016,1,0,0,1,100.0
421635,2017,1,0,0,1,100.0
421635,2018,2,0,0,2,100.0
421635,2020,0,0,1,1,0.0
421640,2013,1,1,0,2,100.0
421640,2014,1,0,0,1,100.0
421640,2015,1,0,0,1,100.0
421640,2016,1,0,0,1,100.0
421640,2017,2,0,0,2,100.0
421640,2018,1,0,0,1,100.0
421640,2019,2,0,0,2,100.0
421640,2020,1,0,0,1,100.0
421650,2012,1,0,11,12,8.333333333333332
421650,2013,7,0,0,7,100.0
421650,2014,7,0,0,7,100.0
421650,2015,9,0,1,10,90.0
421650,2016,11,0,0,11,100.0
421650,2017,9,0,0,9,100.0
421650,2018,8,0,0,8,100.0
421650,2019,11,0,0,11,100.0
421650,2020,11,1,0,12,100.0
421660,2012,62,0,3,65,95.38461538461539
421660,2013,70,2,1,73,98.63013698630137
421660,2014,60,0,0,60,100.0
421660,2015,75,0,0,75,100.0
421660,2016,74,0,0,74,100.0
421660,2017,71,0,0,71,100.0
421660,2018,62,0,0,62,100.0
421660,2019,64,0,0,64,100.0
421660,2020,78,0,0,78,100.0
421670,2012,3,0,0,3,100.0
421670,2013,2,0,0,2,100.0
421670,2014,4,0,0,4,100.0
421670,2015,4,0,0,4,100.0
421670,2016,1,0,0,1,100.0
421670,2017,5,0,0,5,100.0
421670,2018,5,0,0,5,100.0
421670,2019,3,0,0,3,100.0
421670,2020,1,0,0,1,100.0
421680,2012,2,1,3,6,50.0
421680,2013,1,0,0,1,100.0
421680,2014,6,0,0,6,100.0
421680,2015,3,0,0,3,100.0
421680,2016,4,0,0,4,100.0
421680,2017,1,0,0,1,100.0
421680,2018,2,0,0,2,100.0
421680,2019,1,0,0,1,100.0
421680,2020,1,0,0,1,100.0
421690,2012,2,1,4,7,42.857142857142854
421690,2013,5,0,0,5,100.0
421690,2014,3,0,0,3,100.0
421690,2015,6,0,0,6,100.0
421690,2016,7,0,0,7,100.0
421690,2017,5,2,0,7,100.0
421690,2018,3,3,0,6,100.0
421690,2020,3,0,1,4,75.0
421700,2012,2,0,1,3,66.66666666666666
421700,2013,4,0,0,4,100.0
421700,2014,7,0,0,7,100.0
421700,2015,4,0,0,4,100.0
421700,2017,2,0,0,2,100.0
421700,2018,3,0,0,3,100.0
421700,2019,1,0,0,1,100.0
421700,2020,4,0,0,4,100.0
421710,2013,2,0,0,2,100.0
421710,2016,1,0,0,1,100.0
421710,2020,2,0,0,2,100.0
421715,2018,0,1,0,1,100.0
421720,2012,11,0,0,11,100.0
421720,2013,10,0,0,10,100.0
421720,2014,11,0,0,11,100.0
421720,2015,10,0,0,10,100.0
421720,2016,12,0,0,12,100.0
421720,2017,10,0,0,10,100.0
421720,2018,3,0,0,3,100.0
421720,2019,7,0,0,7,100.0
421720,2020,10,0,0,10,100.0
421725,2013,2,0,0,2,100.0
421725,2014,2,0,0,2,100.0
421725,2015,1,0,0,1,100.0
421725,2016,3,0,0,3,100.0
421725,2017,1,0,0,1,100.0
421725,2018,1,0,0,1,100.0
421725,2020,0,0,1,1,0.0
421730,2012,1,0,1,2,50.0
421730,2013,2,0,0,2,100.0
421730,2014,1,0,0,1,100.0
421730,2015,1,0,0,1,100.0
421730,2016,2,0,0,2,100.0
421730,2017,2,0,0,2,100.0
421730,2018,2,0,0,2,100.0
421730,2019,2,1,0,3,100.0
421730,2020,1,0,0,1,100.0
421740,2012,11,0,0,11,100.0
421740,2013,1,0,0,1,100.0
421740,2014,1,0,0,1,100.0
421740,2015,3,0,0,3,100.0
421740,2016,11,0,0,11,100.0
421740,2017,5,0,0,5,100.0
421740,2018,6,0,0,6,100.0
421740,2019,5,0,0,5,100.0
421740,2020,8,0,0,8,100.0
421750,2012,1,3,4,8,50.0
421750,2013,2,1,0,3,100.0
421750,2014,4,0,0,4,100.0
421750,2015,4,0,0,4,100.0
421750,2016,5,0,0,5,100.0
421750,2017,5,0,0,5,100.0
421750,2018,7,0,0,7,100.0
421750,2019,2,0,0,2,100.0
421750,2020,4,0,0,4,100.0
421755,2017,0,1,0,1,100.0
421755,2020,0,0,1,1,0.0
421760,2012,2,0,0,2,100.0
421760,2013,5,0,0,5,100.0
421760,2014,2,0,2,4,50.0
421760,2015,5,0,0,5,100.0
421760,2016,3,0,0,3,100.0
421760,2017,8,0,0,8,100.0
421760,2018,1,0,0,1,100.0
421760,2019,3,0,0,3,100.0
421760,2020,4,0,0,4,100.0
421770,2012,5,0,0,5,100.0
421770,2013,1,2,6,9,33.33333333333333
421770,2014,3,0,0,3,100.0
421770,2015,7,0,0,7,100.0
421770,2016,12,0,0,12,100.0
421770,2017,7,0,0,7,100.0
421770,2018,10,0,0,10,100.0
421770,2019,8,0,0,8,100.0
421770,2020,10,0,0,10,100.0
421775,2012,0,1,0,1,100.0
421775,2018,1,0,0,1,100.0
421775,2019,1,0,0,1,100.0
421780,2012,4,0,0,4,100.0
421780,2013,6,0,0,6,100.0
421780,2014,3,0,0,3,100.0
421780,2015,6,0,0,6,100.0
421780,2016,3,0,0,3,100.0
421780,2017,2,0,0,2,100.0
421780,2018,6,0,0,6,100.0
421780,2019,7,0,0,7,100.0
421780,2020,9,0,0,9,100.0
421790,2012,4,0,2,6,66.66666666666666
421790,2013,1,0,0,1,100.0
421790,2014,1,0,1,2,50.0
421790,2015,2,0,0,2,100.0
421790,2016,0,0,1,1,0.0
421790,2017,3,0,0,3,100.0
421790,2018,0,1,0,1,100.0
421790,2019,1,0,0,1,100.0
421790,2020,2,0,0,2,100.0
421795,2012,1,0,0,1,100.0
421795,2013,1,0,0,1,100.0
421795,2014,1,0,0,1,100.0
421795,2015,1,0,0,1,100.0
421800,2012,15,0,5,20,75.0
421800,2013,10,0,0,10,100.0
421800,2014,8,0,0,8,100.0
421800,2015,16,0,0,16,100.0
421800,2016,9,0,0,9,100.0
421800,2017,9,0,0,9,100.0
421800,2018,10,0,0,10,100.0
421800,2019,14,0,0,14,100.0
421800,2020,20,1,0,21,100.0
421810,2012,1,1,0,2,100.0
421810,2013,1,0,0,1,100.0
421810,2014,1,0,0,1,100.0
421810,2015,1,0,0,1,100.0
421810,2016,2,0,0,2,100.0
421810,2017,2,0,0,2,100.0
421810,2018,1,0,0,1,100.0
421810,2020,1,0,0,1,100.0
421820,2012,3,8,4,15,73.33333333333333
421820,2013,2,6,3,11,72.72727272727273
421820,2014,3,1,3,7,57.14285714285714
421820,2015,11,0,0,11,100.0
421820,2016,8,0,0,8,100.0
421820,2017,7,1,0,8,100.0
421820,2018,10,0,0,10,100.0
421820,2019,4,2,0,6,100.0
421820,2020,0,8,3,11,72.72727272727273
421825,2012,2,1,1,4,75.0
421825,2013,5,0,0,5,100.0
421825,2014,0,1,0,1,100.0
421825,2015,2,1,0,3,100.0
421825,2016,1,0,0,1,100.0
421825,2017,2,0,0,2,100.0
421825,2018,5,0,0,5,100.0
421825,2019,2,0,0,2,100.0
421825,2020,6,0,0,6,100.0
421830,2012,2,1,4,7,42.857142857142854
421830,2013,3,1,3,7,57.14285714285714
421830,2014,9,0,0,9,100.0
421830,2015,1,0,0,1,100.0
421830,2016,6,0,0,6,100.0
421830,2017,5,0,0,5,100.0
421830,2018,10,0,0,10,100.0
421830,2019,6,0,0,6,100.0
421830,2020,5,0,0,5,100.0
421835,2012,1,0,0,1,100.0
421835,2013,1,0,0,1,100.0
421835,2014,1,0,0,1,100.0
421835,2015,2,0,0,2,100.0
421835,2016,1,0,0,1,100.0
421835,2018,1,0,0,1,100.0
421840,2012,0,1,1,2,50.0
421840,2013,1,0,0,1,100.0
421840,2015,3,0,1,4,75.0
421840,2016,2,0,0,2,100.0
421840,2017,1,0,1,2,50.0
421840,2018,2,0,0,2,100.0
421840,2019,1,1,0,2,100.0
421840,2020,1,0,0,1,100.0
421850,2012,0,0,2,2,0.0
421850,2013,0,1,3,4,25.0
421850,2014,1,0,1,2,50.0
421850,2015,0,0,2,2,0.0
421850,2016,2,0,0,2,100.0
421850,2017,3,0,0,3,100.0
421850,2019,2,0,1,3,66.66666666666666
421850,2020,3,0,0,3,100.0
421860,2013,5,0,0,5,100.0
421860,2014,2,0,0,2,100.0
421860,2015,2,0,0,2,100.0
421860,2016,1,0,0,1,100.0
421860,2018,2,0,0,2,100.0
421860,2019,1,0,0,1,100.0
421860,2020,2,0,0,2,100.0
421870,2012,34,0,0,34,100.0
421870,2013,31,0,0,31,100.0
421870,2014,20,0,0,20,100.0
421870,2015,21,0,0,21,100.0
421870,2016,29,0,0,29,100.0
421870,2017,20,0,0,20,100.0
421870,2018,20,0,0,20,100.0
421870,2019,24,0,0,24,100.0
421870,2020,35,0,0,35,100.0
421875,2012,1,0,0,1,100.0
421875,2015,3,0,0,3,100.0
421875,2016,1,0,0,1,100.0
421875,2017,1,0,0,1,100.0
421875,2020,2,0,0,2,100.0
421880,2012,4,0,0,4,100.0
421880,2014,4,0,0,4,100.0
421880,2015,8,0,0,8,100.0
421880,2016,6,0,0,6,100.0
421880,2018,4,0,0,4,100.0
421880,2019,4,0,0,4,100.0
421880,2020,6,0,0,6,100.0
421885,2013,2,0,0,2,100.0
421885,2015,2,0,0,2,100.0
421885,2017,1,0,0,1,100.0
421890,2012,0,0,4,4,0.0
421890,2013,0,0,8,8,0.0
421890,2014,6,0,0,6,100.0
421890,2015,6,0,0,6,100.0
421890,2016,5,0,0,5,100.0
421890,2017,5,0,0,5,100.0
421890,2018,3,0,0,3,100.0
421890,2019,4,0,0,4,100.0
421890,2020,4,0,0,4,100.0
421895,2012,1,0,0,1,100.0
421895,2014,4,0,0,4,100.0
421895,2016,1,0,0,1,100.0
421895,2019,1,0,0,1,100.0
421895,2020,1,0,0,1,100.0
421900,2012,7,0,0,7,100.0
421900,2013,2,0,4,6,33.33333333333333
421900,2014,2,0,1,3,66.66666666666666
421900,2015,8,0,0,8,100.0
421900,2016,5,0,0,5,100.0
421900,2017,2,0,0,2,100.0
421900,2018,2,0,0,2,100.0
421900,2019,10,0,0,10,100.0
421900,2020,10,0,0,10,100.0
421910,2012,1,1,0,2,100.0
421910,2013,1,0,0,1,100.0
421910,2015,1,0,0,1,100.0
421910,2016,1,0,0,1,100.0
421910,2017,1,0,0,1,100.0
421910,2018,1,0,0,1,100.0
421910,2019,1,0,0,1,100.0
421915,2012,2,0,0,2,100.0
421915,2013,1,0,0,1,100.0
421915,2014,1,0,0,1,100.0
421915,2016,3,0,0,3,100.0
421915,2018,1,0,0,1,100.0
421917,2012,5,0,0,5,100.0
421917,2013,2,0,0,2,100.0
421917,2014,1,0,0,1,100.0
421917,2015,4,0,0,4,100.0
421917,2017,2,0,1,3,66.66666666666666
421917,2018,1,0,0,1,100.0
421917,2020,4,0,0,4,100.0
421920,2012,3,0,0,3,100.0
421920,2014,6,0,0,6,100.0
421920,2015,4,0,0,4,100.0
421920,2016,2,0,0,2,100.0
421920,2017,2,0,0,2,100.0
421920,2018,1,0,0,1,100.0
421920,2020,3,0,0,3,100.0
421930,2012,22,0,0,22,100.0
421930,2013,21,0,0,21,100.0
421930,2014,14,0,0,14,100.0
421930,2015,17,0,0,17,100.0
421930,2016,13,0,0,13,100.0
421930,2017,13,0,0,13,100.0
421930,2018,13,0,0,13,100.0
421930,2019,13,1,0,14,100.0
421930,2020,17,0,0,17,100.0
421935,2012,1,0,0,1,100.0
421935,2014,3,0,0,3,100.0
421935,2015,2,0,0,2,100.0
421935,2016,2,0,0,2,100.0
421935,2019,1,0,0,1,100.0
421940,2013,1,0,0,1,100.0
421940,2016,1,0,0,1,100.0
421940,2017,1,0,0,1,100.0
421940,2020,1,0,0,1,100.0
421950,2012,7,2,3,12,75.0
421950,2013,13,2,7,22,68.18181818181817
421950,2014,3,2,1,6,83.33333333333334
421950,2015,9,0,0,9,100.0
421950,2016,14,0,0,14,100.0
421950,2017,9,0,0,9,100.0
421950,2018,15,0,0,15,100.0
421950,2019,16,0,0,16,100.0
421950,2020,22,0,0,22,100.0
421960,2012,1,1,0,2,100.0
421960,2015,1,0,1,2,50.0
421970,2012,4,1,1,6,83.33333333333334
421970,2013,5,1,0,6,100.0
421970,2014,11,0,2,13,84.61538461538461
421970,2015,4,0,0,4,100.0
421970,2016,12,0,0,12,100.0
421970,2017,6,0,0,6,100.0
421970,2018,7,0,0,7,100.0
421970,2019,10,0,0,10,100.0
421970,2020,9,0,0,9,100.0
421985,2015,2,0,0,2,100.0
421985,2016,0,0,1,1,0.0
421985,2019,1,0,1,2,50.0
422000,2013,0,0,3,3,0.0
422000,2014,5,1,1,7,85.71428571428571
422000,2015,1,0,3,4,25.0
422000,2016,0,0,3,3,0.0
422000,2017,0,0,3,3,0.0
422000,2018,0,0,6,6,0.0
422000,2019,0,0,5,5,0.0
422000,2020,4,0,1,5,80.0
430000,2016,0,0,1,1,0.0
430003,2013,1,0,0,1,100.0
430003,2016,2,0,0,2,100.0
430003,2019,2,0,0,2,100.0
430005,2014,1,0,0,1,100.0
430005,2017,2,0,0,2,100.0
430005,2018,1,0,0,1,100.0
430005,2020,1,0,0,1,100.0
430010,2012,4,0,0,4,100.0
430010,2013,4,0,0,4,100.0
430010,2014,5,0,0,5,100.0
430010,2015,7,0,0,7,100.0
430010,2016,3,0,0,3,100.0
430010,2017,3,0,0,3,100.0
430010,2018,5,0,0,5,100.0
430010,2019,4,0,0,4,100.0
430010,2020,4,0,0,4,100.0
430020,2012,1,0,0,1,100.0
430020,2013,1,0,0,1,100.0
430020,2014,1,0,0,1,100.0
430020,2015,3,0,0,3,100.0
430020,2016,2,0,0,2,100.0
430020,2017,1,0,0,1,100.0
430020,2018,1,0,0,1,100.0
430020,2020,2,0,0,2,100.0
430030,2012,1,0,0,1,100.0
430030,2014,1,0,0,1,100.0
430030,2015,3,0,0,3,100.0
430030,2016,2,0,0,2,100.0
430030,2018,1,0,0,1,100.0
430030,2019,1,0,0,1,100.0
430030,2020,2,0,0,2,100.0
430040,2012,22,0,0,22,100.0
430040,2013,21,0,0,21,100.0
430040,2014,24,0,0,24,100.0
430040,2015,30,0,1,31,96.7741935483871
430040,2016,31,0,0,31,100.0
430040,2017,31,0,0,31,100.0
430040,2018,25,0,1,26,96.15384615384616
430040,2019,25,0,0,25,100.0
430040,2020,15,0,0,15,100.0
430045,2012,1,0,0,1,100.0
430045,2016,1,0,0,1,100.0
430045,2017,1,0,0,1,100.0
430045,2018,2,0,0,2,100.0
430047,2015,2,0,0,2,100.0
430047,2016,1,0,0,1,100.0
430047,2017,1,0,0,1,100.0
430047,2019,0,0,1,1,0.0
430047,2020,1,0,0,1,100.0
430050,2012,3,1,0,4,100.0
430050,2013,3,0,0,3,100.0
430050,2014,3,0,0,3,100.0
430050,2015,1,0,0,1,100.0
430050,2016,4,0,0,4,100.0
430050,2017,2,0,0,2,100.0
430050,2018,3,0,0,3,100.0
430050,2019,3,0,1,4,75.0
430050,2020,1,0,0,1,100.0
430055,2020,0,1,0,1,100.0
430057,2013,3,0,0,3,100.0
430060,2012,82,1,7,90,92.22222222222223
430060,2013,61,0,0,61,100.0
430060,2014,97,0,0,97,100.0
430060,2015,100,0,0,100,100.0
430060,2016,90,0,0,90,100.0
430060,2017,72,0,0,72,100.0
430060,2018,68,0,0,68,100.0
430060,2019,69,0,0,69,100.0
430060,2020,80,0,0,80,100.0
430063,2012,3,2,0,5,100.0
430063,2013,4,0,0,4,100.0
430063,2014,2,0,0,2,100.0
430063,2015,1,0,1,2,50.0
430063,2016,4,0,0,4,100.0
430063,2017,1,0,0,1,100.0
430063,2019,1,0,1,2,50.0
430063,2020,2,0,1,3,66.66666666666666
430064,2012,1,0,0,1,100.0
430064,2013,2,0,0,2,100.0
430064,2014,4,0,2,6,66.66666666666666
430064,2015,1,0,0,1,100.0
430064,2016,1,0,1,2,50.0
430064,2017,6,0,0,6,100.0
430064,2018,2,0,0,2,100.0
430064,2020,1,0,0,1,100.0
430066,2012,1,0,0,1,100.0
430066,2015,1,0,0,1,100.0
430066,2016,1,0,0,1,100.0
430070,2012,2,0,0,2,100.0
430070,2013,1,0,0,1,100.0
430070,2015,1,0,0,1,100.0
430070,2016,1,0,0,1,100.0
430070,2017,2,0,0,2,100.0
430070,2018,1,0,0,1,100.0
430070,2019,1,0,0,1,100.0
430070,2020,2,0,0,2,100.0
430080,2012,4,0,0,4,100.0
430080,2013,6,0,0,6,100.0
430080,2014,2,0,0,2,100.0
430080,2015,5,0,0,5,100.0
430080,2016,1,0,0,1,100.0
430080,2017,1,0,0,1,100.0
430080,2019,4,0,0,4,100.0
430085,2012,0,0,2,2,0.0
430085,2013,0,0,2,2,0.0
430085,2014,0,0,1,1,0.0
430085,2015,0,0,1,1,0.0
430085,2016,0,0,2,2,0.0
430085,2017,0,0,2,2,0.0
430085,2019,0,0,1,1,0.0
430085,2020,0,0,1,1,0.0
430087,2012,1,0,1,2,50.0
430087,2013,1,0,0,1,100.0
430087,2014,3,0,0,3,100.0
430087,2015,2,0,0,2,100.0
430087,2016,1,0,0,1,100.0
430087,2017,3,1,0,4,100.0
430087,2018,0,0,2,2,0.0
430087,2019,0,0,2,2,0.0
430087,2020,0,0,3,3,0.0
430090,2012,1,0,0,1,100.0
430090,2013,1,0,0,1,100.0
430090,2014,1,0,0,1,100.0
430090,2016,2,0,0,2,100.0
430090,2017,1,0,0,1,100.0
430090,2018,1,0,0,1,100.0
430090,2019,2,0,0,2,100.0
430090,2020,1,0,0,1,100.0
430100,2012,0,0,3,3,0.0
430100,2013,1,0,4,5,20.0
430100,2014,2,0,4,6,33.33333333333333
430100,2015,0,2,7,9,22.22222222222222
430100,2016,4,0,0,4,100.0
430100,2017,1,1,1,3,66.66666666666666
430100,2018,0,0,5,5,0.0
430100,2019,0,1,4,5,20.0
430100,2020,5,0,0,5,100.0
430105,2012,1,0,0,1,100.0
430105,2013,2,1,1,4,75.0
430105,2014,3,0,0,3,100.0
430105,2015,2,0,0,2,100.0
430105,2016,2,0,0,2,100.0
430105,2018,1,0,0,1,100.0
430105,2019,2,0,1,3,66.66666666666666
430105,2020,3,0,0,3,100.0
430107,2012,1,0,0,1,100.0
430107,2014,2,0,0,2,100.0
430107,2015,1,0,0,1,100.0
430107,2016,2,0,0,2,100.0
430107,2017,1,0,0,1,100.0
430107,2018,0,0,1,1,0.0
430107,2019,0,0,1,1,0.0
430110,2012,2,0,3,5,40.0
430110,2013,0,0,5,5,0.0
430110,2014,0,0,8,8,0.0
430110,2015,4,0,0,4,100.0
430110,2016,3,1,4,8,50.0
430110,2017,0,1,4,5,20.0
430110,2019,0,0,4,4,0.0
430110,2020,0,0,2,2,0.0
430120,2012,4,0,0,4,100.0
430120,2013,2,0,0,2,100.0
430120,2014,4,0,1,5,80.0
430120,2015,4,0,2,6,66.66666666666666
430120,2016,5,0,0,5,100.0
430120,2017,4,0,0,4,100.0
430120,2018,5,0,0,5,100.0
430120,2019,2,0,0,2,100.0
430120,2020,6,0,0,6,100.0
430130,2012,5,2,0,7,100.0
430130,2013,3,0,1,4,75.0
430130,2014,2,0,2,4,50.0
430130,2015,2,0,0,2,100.0
430130,2016,7,0,0,7,100.0
430130,2017,7,0,0,7,100.0
430130,2018,7,0,0,7,100.0
430130,2019,1,0,4,5,20.0
430130,2020,4,0,1,5,80.0
430140,2012,3,0,0,3,100.0
430140,2013,5,0,0,5,100.0
430140,2014,5,0,0,5,100.0
430140,2015,2,0,0,2,100.0
430140,2017,2,0,0,2,100.0
430140,2018,3,0,0,3,100.0
430140,2019,5,0,0,5,100.0
430140,2020,1,0,0,1,100.0
430150,2013,1,0,0,1,100.0
430150,2014,1,0,0,1,100.0
430150,2015,2,0,0,2,100.0
430150,2016,1,0,0,1,100.0
430150,2017,4,0,0,4,100.0
430150,2020,1,0,0,1,100.0
430155,2012,1,0,0,1,100.0
430155,2013,2,0,0,2,100.0
430155,2017,1,0,0,1,100.0
430155,2019,1,0,0,1,100.0
430160,2012,39,0,0,39,100.0
430160,2013,38,0,0,38,100.0
430160,2014,30,0,0,30,100.0
430160,2015,40,0,0,40,100.0
430160,2016,44,0,0,44,100.0
430160,2017,34,0,0,34,100.0
430160,2018,48,0,0,48,100.0
430160,2019,46,0,0,46,100.0
430160,2020,35,0,0,35,100.0
430163,2012,3,0,0,3,100.0
430163,2013,3,1,0,4,100.0
430163,2014,5,0,0,5,100.0
430163,2015,4,0,1,5,80.0
430163,2016,1,0,1,2,50.0
430163,2017,5,0,0,5,100.0
430163,2018,8,0,0,8,100.0
430163,2019,3,0,0,3,100.0
430163,2020,5,0,1,6,83.33333333333334
430165,2012,1,0,0,1,100.0
430165,2013,1,0,0,1,100.0
430165,2014,1,0,0,1,100.0
430165,2016,1,0,0,1,100.0
430165,2017,2,0,0,2,100.0
430165,2018,1,0,0,1,100.0
430165,2019,3,0,0,3,100.0
430170,2012,3,0,0,3,100.0
430170,2014,2,0,0,2,100.0
430170,2015,2,0,0,2,100.0
430170,2016,1,0,0,1,100.0
430170,2017,4,0,0,4,100.0
430170,2018,4,0,0,4,100.0
430170,2019,2,0,0,2,100.0
430170,2020,1,0,0,1,100.0
430175,2012,0,0,3,3,0.0
430175,2013,3,0,0,3,100.0
430175,2014,3,0,0,3,100.0
430175,2015,3,0,0,3,100.0
430175,2016,3,0,0,3,100.0
430175,2017,3,0,0,3,100.0
430175,2018,2,0,0,2,100.0
430175,2019,0,0,2,2,0.0
430180,2012,2,0,0,2,100.0
430180,2013,3,0,0,3,100.0
430180,2016,1,0,0,1,100.0
430180,2017,2,0,0,2,100.0
430180,2018,1,0,0,1,100.0
430180,2019,0,0,1,1,0.0
430180,2020,1,0,0,1,100.0
430185,2012,0,1,1,2,50.0
430185,2013,1,0,0,1,100.0
430185,2014,1,0,2,3,33.33333333333333
430185,2015,1,0,1,2,50.0
430185,2016,2,0,0,2,100.0
430185,2017,1,0,0,1,100.0
430185,2018,1,0,0,1,100.0
430185,2019,1,0,0,1,100.0
430185,2020,1,0,0,1,100.0
430187,2012,0,1,0,1,100.0
430187,2013,0,1,0,1,100.0
430187,2015,0,2,1,3,66.66666666666666
430187,2016,0,1,1,2,50.0
430187,2017,0,0,1,1,0.0
430187,2018,0,0,1,1,0.0
430187,2019,1,1,0,2,100.0
430187,2020,0,0,2,2,0.0
430190,2012,4,0,0,4,100.0
430190,2013,1,0,0,1,100.0
430190,2014,2,0,1,3,66.66666666666666
430190,2015,0,0,3,3,0.0
430190,2016,0,0,1,1,0.0
430190,2017,0,1,3,4,25.0
430190,2018,0,0,3,3,0.0
430190,2019,0,0,1,1,0.0
430190,2020,0,0,5,5,0.0
430192,2012,0,0,2,2,0.0
430192,2019,1,0,0,1,100.0
430195,2015,1,0,0,1,100.0
430195,2016,1,1,0,2,100.0
430195,2018,1,0,0,1,100.0
430200,2012,0,0,6,6,0.0
430200,2013,6,0,0,6,100.0
430200,2014,1,0,0,1,100.0
430200,2015,2,0,0,2,100.0
430200,2016,3,0,0,3,100.0
430200,2017,2,0,2,4,50.0
430200,2018,2,0,0,2,100.0
430200,2019,3,0,0,3,100.0
430200,2020,4,0,0,4,100.0
430205,2014,1,0,0,1,100.0
430205,2017,2,0,0,2,100.0
430205,2018,1,0,0,1,100.0
430205,2019,1,0,0,1,100.0
430210,2012,30,0,0,30,100.0
430210,2013,24,0,0,24,100.0
430210,2014,26,0,0,26,100.0
430210,2015,29,0,0,29,100.0
430210,2016,24,0,0,24,100.0
430210,2017,32,0,0,32,100.0
430210,2018,23,0,0,23,100.0
430210,2019,37,0,0,37,100.0
430210,2020,22,0,1,23,95.65217391304348
430215,2013,1,0,0,1,100.0
430215,2014,1,0,0,1,100.0
430215,2015,1,0,0,1,100.0
430215,2016,0,0,1,1,0.0
430215,2017,1,0,0,1,100.0
430215,2018,3,0,0,3,100.0
430215,2019,1,0,0,1,100.0
430220,2014,2,0,0,2,100.0
430220,2016,2,0,0,2,100.0
430220,2017,2,0,0,2,100.0
430220,2020,1,0,0,1,100.0
430222,2012,2,0,0,2,100.0
430222,2018,1,0,0,1,100.0
430222,2019,1,0,0,1,100.0
430223,2012,1,0,0,1,100.0
430223,2013,1,0,0,1,100.0
430223,2016,2,0,0,2,100.0
430223,2017,1,0,0,1,100.0
430223,2018,0,0,1,1,0.0
430223,2019,2,0,0,2,100.0
430223,2020,1,0,0,1,100.0
430225,2012,1,0,1,2,50.0
430225,2014,0,0,2,2,0.0
430225,2018,1,0,0,1,100.0
430230,2012,6,0,0,6,100.0
430230,2013,5,0,3,8,62.5
430230,2014,3,0,0,3,100.0
430230,2015,4,0,1,5,80.0
430230,2016,3,0,0,3,100.0
430230,2017,1,0,4,5,20.0
430230,2018,3,0,2,5,60.0
430230,2019,6,0,0,6,100.0
430230,2020,2,0,3,5,40.0
430235,2012,5,0,0,5,100.0
430235,2013,5,0,1,6,83.33333333333334
430235,2014,6,0,0,6,100.0
430235,2015,4,0,0,4,100.0
430235,2016,5,0,0,5,100.0
430235,2017,2,0,0,2,100.0
430235,2018,3,0,0,3,100.0
430235,2019,5,0,0,5,100.0
430235,2020,3,0,0,3,100.0
430237,2012,2,0,0,2,100.0
430237,2014,2,0,0,2,100.0
430237,2015,0,0,2,2,0.0
430237,2016,1,0,0,1,100.0
430237,2018,1,0,0,1,100.0
430237,2020,1,0,0,1,100.0
430240,2012,0,0,1,1,0.0
430240,2013,1,0,1,2,50.0
430240,2014,1,0,3,4,25.0
430240,2015,3,0,0,3,100.0
430240,2016,4,0,1,5,80.0
430240,2017,3,0,0,3,100.0
430240,2018,3,0,0,3,100.0
430240,2019,2,0,0,2,100.0
430240,2020,2,0,0,2,100.0
430245,2012,2,0,0,2,100.0
430245,2013,1,0,0,1,100.0
430245,2014,2,0,0,2,100.0
430245,2015,2,0,0,2,100.0
430245,2016,1,0,0,1,100.0
430245,2017,4,0,0,4,100.0
430245,2018,4,0,0,4,100.0
430245,2019,0,0,2,2,0.0
430250,2012,2,0,1,3,66.66666666666666
430250,2013,1,0,0,1,100.0
430250,2014,1,0,0,1,100.0
430250,2015,1,0,0,1,100.0
430250,2016,2,0,0,2,100.0
430250,2017,2,0,0,2,100.0
430250,2018,4,0,0,4,100.0
430250,2019,3,0,0,3,100.0
430250,2020,3,0,0,3,100.0
430258,2016,1,0,0,1,100.0
430258,2019,1,0,0,1,100.0
430258,2020,1,0,0,1,100.0
430260,2012,2,0,0,2,100.0
430260,2013,1,0,0,1,100.0
430260,2014,2,0,0,2,100.0
430260,2015,1,0,0,1,100.0
430260,2018,1,0,0,1,100.0
430260,2020,1,0,0,1,100.0
430265,2012,1,0,2,3,33.33333333333333
430265,2013,0,0,1,1,0.0
430265,2015,0,0,2,2,0.0
430265,2018,0,0,1,1,0.0
430270,2012,0,0,4,4,0.0
430270,2013,0,0,9,9,0.0
430270,2014,0,0,7,7,0.0
430270,2015,0,0,6,6,0.0
430270,2016,0,0,6,6,0.0
430270,2017,0,0,8,8,0.0
430270,2018,0,0,6,6,0.0
430270,2019,0,0,6,6,0.0
430270,2020,0,0,6,6,0.0
430280,2012,16,0,0,16,100.0
430280,2013,12,0,0,12,100.0
430280,2014,13,0,0,13,100.0
430280,2015,11,0,0,11,100.0
430280,2016,12,0,0,12,100.0
430280,2017,11,0,0,11,100.0
430280,2018,12,0,0,12,100.0
430280,2019,15,0,0,15,100.0
430280,2020,11,0,0,11,100.0
430290,2012,2,0,0,2,100.0
430290,2013,5,0,0,5,100.0
430290,2014,4,0,0,4,100.0
430290,2015,4,0,0,4,100.0
430290,2016,8,1,2,11,81.81818181818183
430290,2017,2,0,0,2,100.0
430290,2018,0,0,5,5,0.0
430290,2019,2,0,0,2,100.0
430290,2020,6,0,0,6,100.0
430300,2012,39,0,0,39,100.0
430300,2013,27,0,0,27,100.0
430300,2014,37,0,0,37,100.0
430300,2015,34,0,0,34,100.0
430300,2016,31,0,0,31,100.0
430300,2017,42,0,0,42,100.0
430300,2018,27,0,0,27,100.0
430300,2019,30,0,1,31,96.7741935483871
430300,2020,15,0,0,15,100.0
430310,2012,47,0,0,47,100.0
430310,2013,31,0,0,31,100.0
430310,2014,41,0,0,41,100.0
430310,2015,37,0,0,37,100.0
430310,2016,40,0,0,40,100.0
430310,2017,45,0,0,45,100.0
430310,2018,29,0,0,29,100.0
430310,2019,36,0,0,36,100.0
430310,2020,33,0,0,33,100.0
430320,2012,1,0,0,1,100.0
430320,2014,1,0,0,1,100.0
430320,2015,1,0,0,1,100.0
430320,2016,2,0,0,2,100.0
430320,2017,2,0,0,2,100.0
430320,2019,1,0,0,1,100.0
430320,2020,1,1,2,4,50.0
430330,2013,3,0,0,3,100.0
430330,2015,2,0,0,2,100.0
430330,2019,1,0,0,1,100.0
430340,2012,0,0,1,1,0.0
430340,2013,2,0,0,2,100.0
430340,2015,0,0,1,1,0.0
430340,2018,1,0,0,1,100.0
430340,2019,1,0,0,1,100.0
430340,2020,1,0,0,1,100.0
430350,2012,16,0,1,17,94.11764705882352
430350,2013,31,1,0,32,100.0
430350,2014,16,0,0,16,100.0
430350,2015,19,0,0,19,100.0
430350,2016,16,0,0,16,100.0
430350,2017,23,0,0,23,100.0
430350,2018,21,0,0,21,100.0
430350,2019,16,0,0,16,100.0
430350,2020,23,0,2,25,92.0
430355,2012,1,0,0,1,100.0
430355,2014,1,0,1,2,50.0
430355,2017,1,0,0,1,100.0
430355,2019,1,0,0,1,100.0
430355,2020,1,0,0,1,100.0
430360,2012,0,1,1,2,50.0
430360,2013,3,0,0,3,100.0
430360,2014,3,0,0,3,100.0
430360,2015,2,0,0,2,100.0
430360,2016,4,0,0,4,100.0
430360,2018,2,0,0,2,100.0
430360,2019,1,0,1,2,50.0
430360,2020,1,0,1,2,50.0
430367,2012,2,0,1,3,66.66666666666666
430367,2013,0,1,1,2,50.0
430367,2015,0,0,1,1,0.0
430367,2016,0,0,1,1,0.0
430370,2016,5,0,0,5,100.0
430370,2017,2,0,0,2,100.0
430370,2018,1,0,0,1,100.0
430370,2020,1,0,0,1,100.0
430380,2012,2,0,0,2,100.0
430380,2014,2,0,0,2,100.0
430380,2015,1,0,0,1,100.0
430380,2016,0,0,1,1,0.0
430380,2018,1,0,0,1,100.0
430380,2019,1,0,0,1,100.0
430390,2012,20,0,3,23,86.95652173913044
430390,2013,24,0,0,24,100.0
430390,2014,15,0,0,15,100.0
430390,2015,12,0,0,12,100.0
430390,2016,15,0,0,15,100.0
430390,2017,11,0,0,11,100.0
430390,2018,14,0,0,14,100.0
430390,2019,20,0,0,20,100.0
430390,2020,27,0,0,27,100.0
430400,2013,1,0,0,1,100.0
430400,2014,3,0,0,3,100.0
430400,2015,1,0,0,1,100.0
430400,2016,1,0,0,1,100.0
430400,2017,1,0,0,1,100.0
430400,2018,1,0,0,1,100.0
430400,2019,3,0,1,4,75.0
430400,2020,1,0,0,1,100.0
430410,2012,1,0,0,1,100.0
430410,2013,1,0,0,1,100.0
430410,2014,2,0,0,2,100.0
430410,2016,2,0,0,2,100.0
430410,2017,2,0,0,2,100.0
430420,2012,8,2,3,13,76.92307692307693
430420,2013,11,2,6,19,68.42105263157895
430420,2014,9,0,1,10,90.0
430420,2015,15,0,0,15,100.0
430420,2016,10,0,0,10,100.0
430420,2017,13,0,0,13,100.0
430420,2018,10,0,0,10,100.0
430420,2019,11,0,0,11,100.0
430420,2020,6,0,0,6,100.0
430430,2012,2,0,0,2,100.0
430430,2013,3,0,0,3,100.0
430430,2014,3,0,0,3,100.0
430430,2015,2,0,0,2,100.0
430430,2016,1,0,0,1,100.0
430430,2017,1,0,0,1,100.0
430430,2020,1,0,0,1,100.0
430435,2012,6,0,0,6,100.0
430435,2013,2,0,0,2,100.0
430435,2014,1,0,0,1,100.0
430435,2015,6,0,0,6,100.0
430435,2016,5,0,0,5,100.0
430435,2017,3,0,0,3,100.0
430435,2018,6,0,1,7,85.71428571428571
430435,2019,2,0,1,3,66.66666666666666
430435,2020,3,0,0,3,100.0
430440,2012,12,0,0,12,100.0
430440,2013,19,0,0,19,100.0
430440,2014,20,0,0,20,100.0
430440,2015,16,0,0,16,100.0
430440,2016,16,0,0,16,100.0
430440,2017,12,0,0,12,100.0
430440,2018,12,0,0,12,100.0
430440,2019,18,0,0,18,100.0
430440,2020,21,0,0,21,100.0
430450,2012,21,0,1,22,95.45454545454545
430450,2013,16,0,0,16,100.0
430450,2014,19,0,0,19,100.0
430450,2015,19,0,0,19,100.0
430450,2016,12,0,3,15,80.0
430450,2017,16,0,0,16,100.0
430450,2018,15,0,0,15,100.0
430450,2019,12,0,6,18,66.66666666666666
430450,2020,7,0,10,17,41.17647058823529
430460,2012,122,9,12,143,91.6083916083916
430460,2013,137,0,0,137,100.0
430460,2014,86,3,5,94,94.68085106382979
430460,2015,136,0,0,136,100.0
430460,2016,115,0,0,115,100.0
430460,2017,110,0,1,111,99.09909909909909
430460,2018,124,0,0,124,100.0
430460,2019,114,0,0,114,100.0
430460,2020,127,0,0,127,100.0
430461,2012,0,0,1,1,0.0
430461,2014,1,0,0,1,100.0
430461,2015,1,0,0,1,100.0
430461,2017,0,1,0,1,100.0
430462,2012,1,0,0,1,100.0
430462,2013,0,0,1,1,0.0
430462,2015,1,0,0,1,100.0
430462,2020,2,0,0,2,100.0
430463,2012,16,0,0,16,100.0
430463,2013,18,0,0,18,100.0
430463,2014,17,0,0,17,100.0
430463,2015,16,0,0,16,100.0
430463,2016,21,0,0,21,100.0
430463,2017,13,0,2,15,86.66666666666667
430463,2018,13,0,0,13,100.0
430463,2019,1,0,17,18,5.555555555555555
430463,2020,14,0,11,25,56.00000000000001
430465,2013,1,0,0,1,100.0
430465,2015,1,0,0,1,100.0
430465,2016,2,0,0,2,100.0
430465,2018,2,0,0,2,100.0
430465,2020,1,0,0,1,100.0
430466,2012,6,0,1,7,85.71428571428571
430466,2013,16,0,0,16,100.0
430466,2014,6,0,0,6,100.0
430466,2015,6,0,0,6,100.0
430466,2016,13,0,0,13,100.0
430466,2017,13,0,0,13,100.0
430466,2018,8,0,0,8,100.0
430466,2019,5,1,4,10,60.0
430466,2020,8,0,8,16,50.0
430467,2012,2,0,0,2,100.0
430467,2013,3,0,0,3,100.0
430467,2014,1,0,0,1,100.0
430467,2015,0,0,2,2,0.0
430467,2017,3,0,0,3,100.0
430467,2018,2,0,0,2,100.0
430468,2012,0,0,3,3,0.0
430468,2013,0,0,3,3,0.0
430468,2014,0,0,4,4,0.0
430468,2015,0,0,5,5,0.0
430468,2016,0,1,2,3,33.33333333333333
430468,2017,0,2,3,5,40.0
430468,2018,0,0,2,2,0.0
430468,2019,0,0,4,4,0.0
430468,2020,0,0,4,4,0.0
430469,2012,1,0,0,1,100.0
430469,2014,1,0,0,1,100.0
430469,2018,0,1,0,1,100.0
430470,2012,24,0,0,24,100.0
430470,2013,17,0,1,18,94.44444444444444
430470,2014,23,0,0,23,100.0
430470,2015,25,0,0,25,100.0
430470,2016,24,0,0,24,100.0
430470,2017,16,0,0,16,100.0
430470,2018,20,0,0,20,100.0
430470,2019,34,0,0,34,100.0
430470,2020,22,1,5,28,82.14285714285714
430471,2012,0,0,2,2,0.0
430471,2014,0,0,1,1,0.0
430471,2015,1,0,0,1,100.0
430471,2016,0,0,1,1,0.0
430471,2017,1,0,0,1,100.0
430471,2019,1,0,0,1,100.0
430480,2012,1,0,0,1,100.0
430480,2013,3,0,0,3,100.0
430480,2014,5,0,0,5,100.0
430480,2015,1,0,0,1,100.0
430480,2016,7,0,0,7,100.0
430480,2017,5,0,0,5,100.0
430480,2018,2,0,0,2,100.0
430480,2019,10,0,0,10,100.0
430480,2020,2,0,0,2,100.0
430485,2012,3,0,0,3,100.0
430485,2013,1,0,0,1,100.0
430485,2014,1,0,0,1,100.0
430485,2017,1,0,0,1,100.0
430485,2019,1,0,0,1,100.0
430490,2012,2,0,1,3,66.66666666666666
430490,2013,1,0,0,1,100.0
430490,2014,3,0,0,3,100.0
430490,2015,1,0,0,1,100.0
430490,2016,4,0,0,4,100.0
430490,2017,1,0,0,1,100.0
430490,2018,4,0,0,4,100.0
430490,2019,1,0,0,1,100.0
430490,2020,2,0,0,2,100.0
430495,2012,1,0,0,1,100.0
430495,2014,1,0,0,1,100.0
430495,2015,1,0,0,1,100.0
430495,2016,1,0,0,1,100.0
430495,2017,3,0,0,3,100.0
430500,2012,2,0,0,2,100.0
430500,2013,2,0,0,2,100.0
430500,2014,5,0,0,5,100.0
430500,2015,5,0,0,5,100.0
430500,2016,2,0,0,2,100.0
430500,2017,4,0,0,4,100.0
430500,2018,2,0,0,2,100.0
430500,2019,3,0,0,3,100.0
430500,2020,6,0,0,6,100.0
430510,2012,127,0,0,127,100.0
430510,2013,130,4,0,134,100.0
430510,2014,116,0,0,116,100.0
430510,2015,113,0,0,113,100.0
430510,2016,121,0,0,121,100.0
430510,2017,134,0,0,134,100.0
430510,2018,119,0,0,119,100.0
430510,2019,129,0,0,129,100.0
430510,2020,127,0,3,130,97.6923076923077
430511,2013,2,0,0,2,100.0
430511,2016,1,0,0,1,100.0
430512,2012,0,1,1,2,50.0
430512,2013,1,0,1,2,50.0
430512,2014,0,0,1,1,0.0
430512,2016,0,0,1,1,0.0
430512,2017,0,0,4,4,0.0
430512,2018,1,0,0,1,100.0
430512,2019,0,0,2,2,0.0
430512,2020,0,0,2,2,0.0
430513,2013,1,0,0,1,100.0
430513,2015,2,0,0,2,100.0
430513,2016,1,0,0,1,100.0
430513,2017,1,0,0,1,100.0
430513,2019,2,0,0,2,100.0
430513,2020,2,0,0,2,100.0
430515,2012,2,0,0,2,100.0
430515,2013,1,0,0,1,100.0
430515,2014,1,0,0,1,100.0
430515,2015,1,0,0,1,100.0
430515,2017,1,0,0,1,100.0
430515,2019,0,0,1,1,0.0
430517,2012,0,0,1,1,0.0
430517,2013,0,0,1,1,0.0
430517,2014,0,0,2,2,0.0
430517,2015,0,0,5,5,0.0
430517,2016,0,0,1,1,0.0
430517,2017,0,0,2,2,0.0
430517,2018,0,0,4,4,0.0
430517,2019,0,0,4,4,0.0
430520,2012,3,0,0,3,100.0
430520,2013,2,0,0,2,100.0
430520,2014,4,0,0,4,100.0
430520,2015,2,0,0,2,100.0
430520,2016,7,0,0,7,100.0
430520,2017,6,0,0,6,100.0
430520,2018,4,0,0,4,100.0
430520,2019,1,0,0,1,100.0
430520,2020,10,0,0,10,100.0
430530,2012,7,0,0,7,100.0
430530,2013,3,0,0,3,100.0
430530,2014,2,0,0,2,100.0
430530,2015,1,0,0,1,100.0
430530,2016,2,1,0,3,100.0
430530,2017,1,0,0,1,100.0
430530,2018,3,0,0,3,100.0
430530,2019,2,0,0,2,100.0
430530,2020,1,0,0,1,100.0
430535,2012,9,0,0,9,100.0
430535,2013,17,0,0,17,100.0
430535,2014,5,0,0,5,100.0
430535,2015,6,0,0,6,100.0
430535,2016,7,0,0,7,100.0
430535,2017,9,0,0,9,100.0
430535,2018,13,0,0,13,100.0
430535,2019,6,0,0,6,100.0
430535,2020,8,0,0,8,100.0
430537,2012,5,0,0,5,100.0
430537,2013,3,0,0,3,100.0
430537,2014,2,0,0,2,100.0
430537,2015,1,0,0,1,100.0
430537,2017,2,0,0,2,100.0
430537,2018,2,0,0,2,100.0
430537,2019,1,0,1,2,50.0
430537,2020,4,1,1,6,83.33333333333334
430540,2012,2,0,0,2,100.0
430540,2013,1,0,0,1,100.0
430540,2014,2,0,0,2,100.0
430540,2015,2,0,0,2,100.0
430540,2019,1,0,1,2,50.0
430540,2020,1,0,0,1,100.0
430543,2012,3,0,0,3,100.0
430543,2014,2,0,0,2,100.0
430543,2015,1,0,0,1,100.0
430543,2017,1,0,0,1,100.0
430544,2012,0,0,2,2,0.0
430544,2013,0,0,3,3,0.0
430544,2015,0,0,2,2,0.0
430544,2019,0,0,1,1,0.0
430544,2020,0,0,1,1,0.0
430545,2012,2,0,4,6,33.33333333333333
430545,2013,0,0,7,7,0.0
430545,2014,2,1,2,5,60.0
430545,2015,5,0,0,5,100.0
430545,2016,5,0,2,7,71.42857142857143
430545,2017,9,0,0,9,100.0
430545,2018,3,0,0,3,100.0
430545,2019,0,0,5,5,0.0
430545,2020,1,0,7,8,12.5
430550,2014,1,0,0,1,100.0
430550,2016,3,0,0,3,100.0
430550,2017,1,0,0,1,100.0
430550,2018,2,0,0,2,100.0
430550,2020,1,0,0,1,100.0
430558,2015,3,0,0,3,100.0
430558,2016,0,0,1,1,0.0
430558,2018,2,0,0,2,100.0
430560,2015,1,0,0,1,100.0
430560,2017,1,0,0,1,100.0
430560,2019,2,0,0,2,100.0
430570,2015,1,0,0,1,100.0
430570,2017,3,0,0,3,100.0
430570,2018,2,0,0,2,100.0
430570,2019,2,0,0,2,100.0
430570,2020,2,0,0,2,100.0
430580,2012,2,0,0,2,100.0
430580,2013,2,0,0,2,100.0
430580,2014,6,0,0,6,100.0
430580,2015,8,0,0,8,100.0
430580,2016,2,0,0,2,100.0
430580,2017,6,0,0,6,100.0
430580,2018,5,0,0,5,100.0
430580,2019,3,0,0,3,100.0
430580,2020,5,0,0,5,100.0
430583,2014,4,0,0,4,100.0
430583,2015,1,0,0,1,100.0
430583,2016,0,0,1,1,0.0
430585,2013,1,0,0,1,100.0
430585,2014,1,0,1,2,50.0
430585,2015,1,0,0,1,100.0
430585,2016,1,0,0,1,100.0
430585,2020,0,0,1,1,0.0
430587,2015,1,0,0,1,100.0
430587,2017,2,0,0,2,100.0
430587,2019,2,0,0,2,100.0
430590,2012,6,0,0,6,100.0
430590,2013,3,0,0,3,100.0
430590,2014,2,0,0,2,100.0
430590,2015,2,0,0,2,100.0
430590,2016,5,0,0,5,100.0
430590,2017,1,0,1,2,50.0
430590,2018,1,0,0,1,100.0
430590,2019,2,0,0,2,100.0
430590,2020,2,0,0,2,100.0
430593,2013,0,1,1,2,50.0
430593,2019,0,0,1,1,0.0
430595,2012,1,0,0,1,100.0
430595,2014,1,0,0,1,100.0
430595,2016,2,0,0,2,100.0
430595,2019,2,0,0,2,100.0
430597,2012,3,0,0,3,100.0
430597,2013,4,0,0,4,100.0
430597,2017,1,0,0,1,100.0
430597,2019,1,0,0,1,100.0
430597,2020,1,0,0,1,100.0
430600,2012,4,0,0,4,100.0
430600,2013,6,0,0,6,100.0
430600,2015,2,0,0,2,100.0
430600,2016,1,0,0,1,100.0
430600,2017,4,0,0,4,100.0
430600,2018,1,0,0,1,100.0
430600,2019,1,0,0,1,100.0
430600,2020,3,0,0,3,100.0
430605,2012,3,0,0,3,100.0
430605,2013,1,0,0,1,100.0
430605,2014,1,0,0,1,100.0
430605,2015,7,0,0,7,100.0
430605,2016,3,0,0,3,100.0
430605,2017,2,0,0,2,100.0
430605,2018,0,1,1,2,50.0
430605,2019,0,0,1,1,0.0
430605,2020,2,0,0,2,100.0
430607,2014,2,0,0,2,100.0
430607,2015,0,0,1,1,0.0
430610,2012,34,0,2,36,94.44444444444444
430610,2013,41,0,0,41,100.0
430610,2014,31,0,0,31,100.0
430610,2015,25,0,0,25,100.0
430610,2016,28,0,0,28,100.0
430610,2017,28,0,0,28,100.0
430610,2018,21,0,0,21,100.0
430610,2019,28,0,0,28,100.0
430610,2020,20,0,0,20,100.0
430613,2014,1,0,0,1,100.0
430613,2016,2,0,0,2,100.0
430613,2018,1,0,0,1,100.0
430620,2012,1,0,1,2,50.0
430620,2013,1,0,1,2,50.0
430620,2014,3,0,1,4,75.0
430620,2015,1,0,0,1,100.0
430620,2016,6,0,0,6,100.0
430620,2017,2,0,0,2,100.0
430620,2018,2,1,1,4,75.0
430620,2019,0,0,2,2,0.0
430620,2020,6,0,0,6,100.0
430630,2012,2,0,0,2,100.0
430630,2013,0,0,1,1,0.0
430630,2015,5,0,0,5,100.0
430630,2016,1,0,0,1,100.0
430630,2017,0,1,0,1,100.0
430630,2020,4,0,0,4,100.0
430632,2012,1,0,1,2,50.0
430632,2013,2,0,0,2,100.0
430632,2014,0,0,1,1,0.0
430632,2015,1,0,0,1,100.0
430632,2017,0,0,1,1,0.0
430632,2018,1,0,0,1,100.0
430632,2020,3,0,0,3,100.0
430635,2014,2,0,0,2,100.0
430635,2015,1,0,0,1,100.0
430635,2016,1,0,0,1,100.0
430635,2018,1,0,0,1,100.0
430637,2012,1,0,0,1,100.0
430637,2013,1,0,0,1,100.0
430637,2014,2,0,0,2,100.0
430637,2016,3,0,0,3,100.0
430637,2017,3,0,0,3,100.0
430637,2020,1,0,0,1,100.0
430640,2012,5,0,1,6,83.33333333333334
430640,2013,8,0,0,8,100.0
430640,2014,5,0,0,5,100.0
430640,2015,7,0,0,7,100.0
430640,2016,5,0,0,5,100.0
430640,2017,10,0,0,10,100.0
430640,2018,7,0,0,7,100.0
430640,2019,3,1,0,4,100.0
430640,2020,10,0,0,10,100.0
430642,2016,2,0,0,2,100.0
430642,2017,1,0,0,1,100.0
430642,2018,1,0,0,1,100.0
430642,2019,1,0,0,1,100.0
430645,2017,0,1,2,3,33.33333333333333
430645,2018,1,0,0,1,100.0
430645,2019,1,0,0,1,100.0
430645,2020,1,0,0,1,100.0
430650,2012,1,0,2,3,33.33333333333333
430650,2013,0,0,2,2,0.0
430650,2014,0,0,4,4,0.0
430650,2015,0,2,5,7,28.57142857142857
430650,2016,1,0,5,6,16.666666666666664
430650,2017,0,0,2,2,0.0
430650,2018,2,0,0,2,100.0
430650,2019,7,0,0,7,100.0
430650,2020,4,0,0,4,100.0
430655,2012,1,0,0,1,100.0
430655,2014,1,0,0,1,100.0
430655,2015,1,0,0,1,100.0
430655,2017,1,0,0,1,100.0
430655,2018,1,0,0,1,100.0
430660,2012,13,0,0,13,100.0
430660,2013,13,0,0,13,100.0
430660,2014,8,0,0,8,100.0
430660,2015,16,0,0,16,100.0
430660,2016,15,0,0,15,100.0
430660,2017,17,0,0,17,100.0
430660,2018,8,0,0,8,100.0
430660,2019,5,0,1,6,83.33333333333334
430660,2020,15,0,0,15,100.0
430670,2012,1,0,0,1,100.0
430670,2013,2,0,0,2,100.0
430670,2014,3,0,0,3,100.0
430670,2015,3,0,0,3,100.0
430670,2017,2,0,0,2,100.0
430670,2018,1,0,0,1,100.0
430670,2019,1,0,1,2,50.0
430670,2020,1,0,0,1,100.0
430673,2012,1,0,0,1,100.0
430673,2013,2,0,0,2,100.0
430673,2015,2,0,0,2,100.0
430673,2017,4,0,0,4,100.0
430673,2018,1,0,0,1,100.0
430673,2019,2,0,0,2,100.0
430673,2020,1,0,0,1,100.0
430675,2013,1,0,0,1,100.0
430675,2014,1,0,0,1,100.0
430675,2019,2,0,0,2,100.0
430676,2012,0,0,11,11,0.0
430676,2013,0,2,10,12,16.666666666666664
430676,2014,10,0,0,10,100.0
430676,2015,11,0,0,11,100.0
430676,2016,10,0,0,10,100.0
430676,2017,19,0,0,19,100.0
430676,2018,15,0,0,15,100.0
430676,2019,13,0,1,14,92.85714285714286
430676,2020,16,0,0,16,100.0
430680,2012,5,0,3,8,62.5
430680,2013,0,0,7,7,0.0
430680,2014,1,0,9,10,10.0
430680,2015,4,0,0,4,100.0
430680,2016,0,1,4,5,20.0
430680,2017,2,1,1,4,75.0
430680,2018,5,0,0,5,100.0
430680,2019,4,0,0,4,100.0
430680,2020,8,0,0,8,100.0
430690,2012,11,0,1,12,91.66666666666666
430690,2013,17,0,0,17,100.0
430690,2014,4,0,0,4,100.0
430690,2015,7,0,0,7,100.0
430690,2016,9,0,0,9,100.0
430690,2017,9,0,0,9,100.0
430690,2018,9,0,0,9,100.0
430690,2019,12,0,0,12,100.0
430690,2020,5,0,0,5,100.0
430692,2012,1,0,0,1,100.0
430692,2013,2,0,0,2,100.0
430692,2019,1,0,0,1,100.0
430692,2020,1,0,0,1,100.0
430693,2012,3,0,0,3,100.0
430693,2013,4,0,0,4,100.0
430693,2014,3,0,0,3,100.0
430693,2015,3,0,0,3,100.0
430693,2016,2,0,0,2,100.0
430693,2017,2,0,0,2,100.0
430693,2018,4,0,0,4,100.0
430693,2020,6,0,0,6,100.0
430695,2013,1,0,0,1,100.0
430695,2014,1,0,0,1,100.0
430695,2016,2,0,0,2,100.0
430695,2017,1,0,0,1,100.0
430695,2019,1,0,0,1,100.0
430695,2020,1,0,0,1,100.0
430697,2012,2,1,0,3,100.0
430697,2014,2,0,0,2,100.0
430697,2015,1,0,0,1,100.0
430697,2016,2,0,0,2,100.0
430697,2020,1,0,0,1,100.0
430700,2012,20,1,4,25,84.0
430700,2013,30,0,1,31,96.7741935483871
430700,2014,37,0,0,37,100.0
430700,2015,23,0,0,23,100.0
430700,2016,32,0,0,32,100.0
430700,2017,29,0,0,29,100.0
430700,2018,32,0,0,32,100.0
430700,2019,23,0,0,23,100.0
430700,2020,24,0,0,24,100.0
430705,2013,1,0,0,1,100.0
430705,2014,1,0,0,1,100.0
430705,2016,1,0,0,1,100.0
430705,2017,1,0,0,1,100.0
430705,2018,4,0,0,4,100.0
430705,2020,3,0,0,3,100.0
430710,2012,1,1,0,2,100.0
430710,2013,2,0,0,2,100.0
430710,2015,0,0,2,2,0.0
430710,2016,4,0,0,4,100.0
430710,2017,2,0,0,2,100.0
430710,2018,2,0,0,2,100.0
430710,2019,3,0,1,4,75.0
430710,2020,0,0,4,4,0.0
430720,2013,3,0,0,3,100.0
430720,2014,2,0,0,2,100.0
430720,2015,2,0,0,2,100.0
430720,2016,3,0,0,3,100.0
430720,2017,2,0,0,2,100.0
430720,2019,1,0,0,1,100.0
430720,2020,2,0,0,2,100.0
430730,2012,3,0,2,5,60.0
430730,2013,2,0,0,2,100.0
430730,2014,1,0,0,1,100.0
430730,2015,1,2,0,3,100.0
430730,2016,1,0,0,1,100.0
430730,2017,2,1,0,3,100.0
430730,2018,1,0,0,1,100.0
430730,2020,1,0,0,1,100.0
430740,2013,0,1,1,2,50.0
430740,2014,2,0,0,2,100.0
430740,2015,0,0,1,1,0.0
430740,2017,0,0,1,1,0.0
430740,2019,0,0,2,2,0.0
430740,2020,0,0,1,1,0.0
430745,2013,1,0,0,1,100.0
430745,2014,1,0,0,1,100.0
430745,2015,1,0,0,1,100.0
430745,2017,1,0,0,1,100.0
430745,2020,2,0,0,2,100.0
430750,2012,4,0,0,4,100.0
430750,2013,2,0,0,2,100.0
430750,2014,5,0,0,5,100.0
430750,2015,6,0,0,6,100.0
430750,2016,5,0,0,5,100.0
430750,2017,6,1,0,7,100.0
430750,2018,4,0,0,4,100.0
430750,2019,4,1,0,5,100.0
430750,2020,5,0,0,5,100.0
430755,2012,4,0,0,4,100.0
430755,2014,1,0,0,1,100.0
430755,2015,1,0,0,1,100.0
430755,2016,3,0,0,3,100.0
430755,2017,1,0,0,1,100.0
430755,2018,5,0,0,5,100.0
430755,2020,1,0,0,1,100.0
430760,2012,12,0,0,12,100.0
430760,2013,14,1,0,15,100.0
430760,2014,10,0,0,10,100.0
430760,2015,11,0,0,11,100.0
430760,2016,18,0,0,18,100.0
430760,2017,14,0,0,14,100.0
430760,2018,15,0,0,15,100.0
430760,2019,12,0,0,12,100.0
430760,2020,15,0,0,15,100.0
430770,2012,26,0,2,28,92.85714285714286
430770,2013,36,0,6,42,85.71428571428571
430770,2014,30,0,0,30,100.0
430770,2015,17,0,1,18,94.44444444444444
430770,2016,34,0,2,36,94.44444444444444
430770,2017,26,0,0,26,100.0
430770,2018,22,0,0,22,100.0
430770,2019,16,0,1,17,94.11764705882352
430770,2020,33,0,0,33,100.0
430780,2012,13,0,1,14,92.85714285714286
430780,2013,5,0,0,5,100.0
430780,2014,6,0,0,6,100.0
430780,2015,11,0,0,11,100.0
430780,2016,9,0,0,9,100.0
430780,2017,10,0,0,10,100.0
430780,2018,7,0,0,7,100.0
430780,2019,7,0,0,7,100.0
430780,2020,9,0,0,9,100.0
430781,2013,1,0,0,1,100.0
430781,2017,1,0,0,1,100.0
430781,2018,3,0,0,3,100.0
430781,2019,2,0,0,2,100.0
430783,2012,1,0,0,1,100.0
430783,2013,1,0,0,1,100.0
430783,2014,1,0,0,1,100.0
430783,2015,2,0,0,2,100.0
430783,2017,1,0,0,1,100.0
430783,2018,1,0,0,1,100.0
430786,2012,2,0,0,2,100.0
430786,2015,1,0,0,1,100.0
430790,2012,23,0,0,23,100.0
430790,2013,17,0,0,17,100.0
430790,2014,15,0,0,15,100.0
430790,2015,19,0,0,19,100.0
430790,2016,25,0,0,25,100.0
430790,2017,16,0,0,16,100.0
430790,2018,18,0,0,18,100.0
430790,2019,15,0,0,15,100.0
430790,2020,22,0,0,22,100.0
430800,2012,1,0,0,1,100.0
430800,2013,2,0,0,2,100.0
430800,2014,1,0,1,2,50.0
430800,2015,3,0,0,3,100.0
430800,2016,3,1,1,5,80.0
430800,2017,0,0,1,1,0.0
430800,2018,3,0,0,3,100.0
430800,2019,1,0,1,2,50.0
430800,2020,2,0,0,2,100.0
430805,2013,1,0,0,1,100.0
430805,2014,1,0,0,1,100.0
430805,2015,1,0,0,1,100.0
430805,2016,3,0,0,3,100.0
430805,2018,1,0,0,1,100.0
430807,2013,1,0,0,1,100.0
430807,2014,1,0,0,1,100.0
430807,2015,2,0,0,2,100.0
430807,2016,1,0,1,2,50.0
430810,2012,5,0,0,5,100.0
430810,2013,2,0,0,2,100.0
430810,2014,5,0,0,5,100.0
430810,2015,1,0,0,1,100.0
430810,2016,2,0,0,2,100.0
430810,2017,5,0,0,5,100.0
430810,2018,5,0,0,5,100.0
430810,2019,4,0,0,4,100.0
430810,2020,2,0,0,2,100.0
430820,2012,5,0,0,5,100.0
430820,2013,11,0,0,11,100.0
430820,2014,4,0,0,4,100.0
430820,2015,3,0,0,3,100.0
430820,2016,8,0,0,8,100.0
430820,2017,7,0,0,7,100.0
430820,2018,6,0,0,6,100.0
430820,2019,6,0,0,6,100.0
430820,2020,9,0,0,9,100.0
430825,2012,1,0,0,1,100.0
430825,2014,1,0,0,1,100.0
430825,2017,2,0,0,2,100.0
430825,2019,2,0,0,2,100.0
430825,2020,1,0,0,1,100.0
430830,2012,0,0,3,3,0.0
430830,2013,3,0,0,3,100.0
430830,2014,1,0,0,1,100.0
430830,2015,3,0,0,3,100.0
430830,2016,2,0,2,4,50.0
430830,2017,1,0,1,2,50.0
430830,2018,2,0,1,3,66.66666666666666
430830,2019,2,0,1,3,66.66666666666666
430830,2020,1,0,0,1,100.0
430840,2012,2,0,0,2,100.0
430840,2013,5,0,0,5,100.0
430840,2014,2,0,0,2,100.0
430840,2016,4,0,0,4,100.0
430840,2017,3,0,0,3,100.0
430840,2018,2,0,0,2,100.0
430840,2019,1,0,0,1,100.0
430840,2020,3,0,1,4,75.0
430843,2012,1,0,0,1,100.0
430843,2014,1,0,0,1,100.0
430843,2015,1,0,0,1,100.0
430843,2016,1,0,0,1,100.0
430843,2018,1,0,0,1,100.0
430843,2019,0,1,0,1,100.0
430843,2020,1,0,0,1,100.0
430845,2012,2,0,0,2,100.0
430845,2015,1,0,0,1,100.0
430845,2017,3,0,0,3,100.0
430845,2018,1,0,0,1,100.0
430845,2019,1,0,0,1,100.0
430845,2020,1,0,0,1,100.0
430850,2012,2,0,1,3,66.66666666666666
430850,2013,6,0,1,7,85.71428571428571
430850,2014,6,0,1,7,85.71428571428571
430850,2015,1,0,6,7,14.285714285714285
430850,2016,2,0,4,6,33.33333333333333
430850,2017,8,0,3,11,72.72727272727273
430850,2018,6,1,0,7,100.0
430850,2019,5,0,3,8,62.5
430850,2020,5,1,2,8,75.0
430860,2012,6,0,0,6,100.0
430860,2013,6,0,2,8,75.0
430860,2014,5,0,0,5,100.0
430860,2015,5,1,0,6,100.0
430860,2016,6,0,2,8,75.0
430860,2017,3,2,3,8,62.5
430860,2018,4,0,0,4,100.0
430860,2019,3,0,0,3,100.0
430860,2020,8,0,1,9,88.88888888888889
430865,2014,1,0,0,1,100.0
430865,2015,1,0,0,1,100.0
430865,2016,1,0,0,1,100.0
430865,2019,1,0,0,1,100.0
430865,2020,2,0,0,2,100.0
430870,2012,4,0,0,4,100.0
430870,2013,3,0,0,3,100.0
430870,2014,1,0,0,1,100.0
430870,2015,2,0,0,2,100.0
430870,2016,3,0,0,3,100.0
430870,2017,1,0,0,1,100.0
430870,2018,1,0,0,1,100.0
430870,2020,1,0,0,1,100.0
430880,2012,2,0,1,3,66.66666666666666
430880,2013,0,0,2,2,0.0
430880,2014,0,0,1,1,0.0
430880,2015,0,0,1,1,0.0
430880,2016,0,0,1,1,0.0
430880,2017,0,0,3,3,0.0
430880,2018,1,0,5,6,16.666666666666664
430880,2019,0,0,2,2,0.0
430880,2020,0,0,2,2,0.0
430885,2015,2,0,0,2,100.0
430885,2016,1,0,0,1,100.0
430885,2019,1,0,0,1,100.0
430885,2020,1,0,0,1,100.0
430890,2012,3,0,0,3,100.0
430890,2013,1,0,1,2,50.0
430890,2014,2,0,0,2,100.0
430890,2015,2,0,0,2,100.0
430890,2016,2,0,0,2,100.0
430890,2017,6,0,0,6,100.0
430890,2018,2,0,0,2,100.0
430890,2019,5,0,0,5,100.0
430890,2020,2,0,0,2,100.0
430900,2012,10,0,0,10,100.0
430900,2013,9,0,0,9,100.0
430900,2014,7,0,0,7,100.0
430900,2015,6,0,0,6,100.0
430900,2016,8,0,0,8,100.0
430900,2017,3,0,0,3,100.0
430900,2018,6,0,0,6,100.0
430900,2019,6,0,0,6,100.0
430900,2020,5,0,0,5,100.0
430905,2013,1,0,0,1,100.0
430905,2014,2,0,0,2,100.0
430905,2015,1,0,0,1,100.0
430905,2016,3,0,0,3,100.0
430905,2017,2,0,0,2,100.0
430905,2018,2,0,0,2,100.0
430905,2019,1,0,0,1,100.0
430905,2020,2,0,0,2,100.0
430910,2012,7,0,0,7,100.0
430910,2013,6,0,0,6,100.0
430910,2014,12,0,2,14,85.71428571428571
430910,2015,5,0,0,5,100.0
430910,2016,10,0,0,10,100.0
430910,2017,14,0,0,14,100.0
430910,2018,8,0,0,8,100.0
430910,2019,7,0,0,7,100.0
430910,2020,16,0,0,16,100.0
430912,2012,1,0,0,1,100.0
430912,2013,1,0,0,1,100.0
430912,2014,1,0,0,1,100.0
430912,2015,3,0,0,3,100.0
430912,2017,0,1,0,1,100.0
430912,2019,2,0,0,2,100.0
430912,2020,2,0,0,2,100.0
430915,2012,0,0,2,2,0.0
430915,2013,0,1,2,3,33.33333333333333
430915,2014,4,0,0,4,100.0
430915,2016,1,0,0,1,100.0
430915,2017,1,0,0,1,100.0
430915,2018,3,0,0,3,100.0
430915,2019,1,0,0,1,100.0
430920,2012,87,1,0,88,100.0
430920,2013,84,0,0,84,100.0
430920,2014,86,0,0,86,100.0
430920,2015,94,0,0,94,100.0
430920,2016,71,1,13,85,84.70588235294117
430920,2017,87,0,0,87,100.0
430920,2018,96,0,2,98,97.95918367346938
430920,2019,90,0,2,92,97.82608695652173
430920,2020,101,0,0,101,100.0
430930,2012,37,0,0,37,100.0
430930,2013,43,0,0,43,100.0
430930,2014,36,0,0,36,100.0
430930,2015,38,0,0,38,100.0
430930,2016,31,0,0,31,100.0
430930,2017,36,0,0,36,100.0
430930,2018,33,0,0,33,100.0
430930,2019,33,0,0,33,100.0
430930,2020,34,0,0,34,100.0
430940,2012,6,0,0,6,100.0
430940,2013,8,0,0,8,100.0
430940,2014,5,0,2,7,71.42857142857143
430940,2015,7,0,0,7,100.0
430940,2016,2,1,2,5,60.0
430940,2017,6,0,0,6,100.0
430940,2018,9,0,0,9,100.0
430940,2019,7,0,0,7,100.0
430940,2020,10,0,0,10,100.0
430950,2012,1,0,0,1,100.0
430950,2013,1,0,0,1,100.0
430950,2014,6,0,0,6,100.0
430950,2015,2,0,0,2,100.0
430950,2016,3,0,0,3,100.0
430950,2017,1,0,0,1,100.0
430950,2018,2,0,0,2,100.0
430950,2019,1,0,0,1,100.0
430950,2020,1,0,0,1,100.0
430955,2013,0,0,1,1,0.0
430955,2015,1,0,1,2,50.0
430955,2017,0,0,2,2,0.0
430955,2019,0,0,2,2,0.0
430957,2012,0,0,2,2,0.0
430957,2013,0,0,1,1,0.0
430957,2014,1,0,0,1,100.0
430957,2017,2,0,0,2,100.0
430960,2012,8,0,0,8,100.0
430960,2013,6,0,0,6,100.0
430960,2014,3,0,0,3,100.0
430960,2015,8,0,1,9,88.88888888888889
430960,2016,5,0,0,5,100.0
430960,2017,4,0,0,4,100.0
430960,2018,4,0,0,4,100.0
430960,2019,9,0,0,9,100.0
430960,2020,5,0,0,5,100.0
430965,2012,2,0,0,2,100.0
430965,2013,2,0,0,2,100.0
430965,2014,1,0,0,1,100.0
430965,2015,2,0,0,2,100.0
430965,2016,1,0,0,1,100.0
430965,2020,6,0,0,6,100.0
430970,2012,6,0,0,6,100.0
430970,2013,1,0,0,1,100.0
430970,2014,1,0,0,1,100.0
430970,2016,2,0,0,2,100.0
430970,2017,1,0,0,1,100.0
430970,2018,2,0,0,2,100.0
430970,2019,0,0,1,1,0.0
430975,2013,4,0,0,4,100.0
430975,2014,1,0,0,1,100.0
430975,2015,2,0,0,2,100.0
430975,2016,1,0,0,1,100.0
430980,2015,1,0,0,1,100.0
430980,2017,1,0,0,1,100.0
430980,2018,1,0,0,1,100.0
430990,2012,2,0,0,2,100.0
430990,2013,3,0,0,3,100.0
430990,2014,1,0,0,1,100.0
430990,2015,3,0,0,3,100.0
430990,2016,1,0,0,1,100.0
430990,2017,3,0,0,3,100.0
430990,2018,2,0,1,3,66.66666666666666
430990,2020,1,0,0,1,100.0
430995,2012,1,0,2,3,33.33333333333333
430995,2013,0,0,1,1,0.0
430995,2016,0,0,3,3,0.0
430995,2020,0,1,0,1,100.0
431000,2012,3,1,0,4,100.0
431000,2013,6,0,0,6,100.0
431000,2014,10,0,0,10,100.0
431000,2015,4,0,0,4,100.0
431000,2016,3,0,0,3,100.0
431000,2017,4,0,0,4,100.0
431000,2018,6,0,0,6,100.0
431000,2019,6,0,0,6,100.0
431000,2020,4,0,0,4,100.0
431010,2012,8,0,0,8,100.0
431010,2013,14,0,0,14,100.0
431010,2014,9,0,0,9,100.0
431010,2015,6,0,0,6,100.0
431010,2016,18,0,0,18,100.0
431010,2017,10,0,0,10,100.0
431010,2018,8,0,0,8,100.0
431010,2019,9,0,0,9,100.0
431010,2020,6,0,3,9,66.66666666666666
431020,2012,19,0,0,19,100.0
431020,2013,19,0,0,19,100.0
431020,2014,25,0,0,25,100.0
431020,2015,21,0,0,21,100.0
431020,2016,20,0,0,20,100.0
431020,2017,24,0,0,24,100.0
431020,2018,20,0,0,20,100.0
431020,2019,26,0,0,26,100.0
431020,2020,31,0,0,31,100.0
431030,2012,0,0,1,1,0.0
431030,2013,1,0,0,1,100.0
431030,2015,1,0,0,1,100.0
431030,2016,2,0,0,2,100.0
431030,2017,1,1,0,2,100.0
431030,2018,1,0,0,1,100.0
431030,2019,2,0,0,2,100.0
431033,2012,10,1,0,11,100.0
431033,2013,5,2,0,7,100.0
431033,2014,5,0,0,5,100.0
431033,2015,4,0,0,4,100.0
431033,2016,9,1,1,11,90.9090909090909
431033,2017,7,0,0,7,100.0
431033,2018,7,0,0,7,100.0
431033,2019,2,0,9,11,18.181818181818183
431033,2020,8,0,0,8,100.0
431036,2012,2,0,0,2,100.0
431036,2013,0,0,1,1,0.0
431036,2015,1,0,0,1,100.0
431036,2017,1,0,1,2,50.0
431036,2020,2,0,0,2,100.0
431040,2012,2,0,0,2,100.0
431040,2013,2,0,0,2,100.0
431040,2014,4,0,0,4,100.0
431040,2015,1,0,0,1,100.0
431040,2016,2,0,0,2,100.0
431040,2017,2,0,0,2,100.0
431040,2018,1,0,0,1,100.0
431040,2019,1,0,0,1,100.0
431041,2012,1,0,0,1,100.0
431041,2014,1,0,0,1,100.0
431041,2017,1,0,0,1,100.0
431043,2012,2,0,0,2,100.0
431043,2013,1,1,1,3,66.66666666666666
431043,2014,0,1,1,2,50.0
431043,2016,3,0,0,3,100.0
431043,2017,1,0,0,1,100.0
431043,2018,3,0,0,3,100.0
431043,2019,1,0,0,1,100.0
431043,2020,2,0,0,2,100.0
431046,2012,1,0,1,2,50.0
431046,2013,1,0,0,1,100.0
431046,2015,1,0,0,1,100.0
431046,2017,0,0,1,1,0.0
431046,2019,0,0,1,1,0.0
431050,2012,2,0,3,5,40.0
431050,2013,1,1,0,2,100.0
431050,2015,1,0,3,4,25.0
431050,2016,2,0,0,2,100.0
431050,2017,2,0,1,3,66.66666666666666
431050,2018,5,0,0,5,100.0
431050,2019,4,0,0,4,100.0
431050,2020,2,0,0,2,100.0
431053,2012,4,0,0,4,100.0
431053,2013,3,0,0,3,100.0
431053,2017,1,0,0,1,100.0
431053,2018,1,0,0,1,100.0
431053,2019,2,0,0,2,100.0
431055,2012,1,0,0,1,100.0
431055,2013,1,0,0,1,100.0
431055,2017,2,0,0,2,100.0
431055,2018,0,0,1,1,0.0
431055,2019,2,0,0,2,100.0
431057,2012,1,0,0,1,100.0
431057,2017,1,0,0,1,100.0
431057,2019,1,0,1,2,50.0
431060,2012,17,0,0,17,100.0
431060,2013,8,0,0,8,100.0
431060,2014,13,0,0,13,100.0
431060,2015,13,0,0,13,100.0
431060,2016,19,0,0,19,100.0
431060,2017,14,0,0,14,100.0
431060,2018,11,0,1,12,91.66666666666666
431060,2019,9,0,0,9,100.0
431060,2020,11,0,0,11,100.0
431065,2013,0,0,1,1,0.0
431065,2015,1,0,0,1,100.0
431065,2016,1,0,0,1,100.0
431065,2017,1,0,0,1,100.0
431065,2018,1,0,0,1,100.0
431065,2019,0,0,1,1,0.0
431065,2020,3,0,2,5,60.0
431070,2015,1,0,0,1,100.0
431070,2017,1,0,0,1,100.0
431070,2019,2,0,0,2,100.0
431075,2013,1,0,0,1,100.0
431080,2012,3,0,2,5,60.0
431080,2013,4,1,0,5,100.0
431080,2014,1,0,0,1,100.0
431080,2015,5,0,0,5,100.0
431080,2016,5,0,0,5,100.0
431080,2017,4,0,0,4,100.0
431080,2018,3,0,0,3,100.0
431080,2019,3,0,0,3,100.0
431080,2020,2,0,1,3,66.66666666666666
431085,2012,2,0,0,2,100.0
431085,2014,6,0,0,6,100.0
431085,2016,1,0,0,1,100.0
431085,2017,3,0,0,3,100.0
431085,2018,1,0,0,1,100.0
431085,2019,4,0,1,5,80.0
431085,2020,2,0,0,2,100.0
431087,2015,1,0,0,1,100.0
431087,2017,1,0,0,1,100.0
431087,2019,1,0,0,1,100.0
431087,2020,2,0,0,2,100.0
431090,2012,2,0,0,2,100.0
431090,2016,3,0,0,3,100.0
431090,2019,3,0,0,3,100.0
431090,2020,2,0,0,2,100.0
431100,2012,10,0,0,10,100.0
431100,2013,9,1,0,10,100.0
431100,2014,16,0,0,16,100.0
431100,2015,10,0,1,11,90.9090909090909
431100,2016,15,0,0,15,100.0
431100,2017,7,0,0,7,100.0
431100,2018,14,0,0,14,100.0
431100,2019,9,0,0,9,100.0
431100,2020,9,0,1,10,90.0
431110,2012,1,0,0,1,100.0
431110,2013,2,0,0,2,100.0
431110,2015,0,1,2,3,33.33333333333333
431110,2016,2,0,1,3,66.66666666666666
431110,2017,1,0,0,1,100.0
431110,2018,4,0,0,4,100.0
431110,2019,1,0,0,1,100.0
431110,2020,2,0,0,2,100.0
431112,2012,2,0,0,2,100.0
431112,2013,1,0,0,1,100.0
431112,2014,3,0,0,3,100.0
431112,2015,3,0,0,3,100.0
431112,2016,2,0,0,2,100.0
431112,2017,2,0,0,2,100.0
431112,2018,3,0,0,3,100.0
431112,2019,2,0,0,2,100.0
431112,2020,2,0,0,2,100.0
431113,2012,2,0,0,2,100.0
431113,2013,0,0,1,1,0.0
431113,2014,2,0,0,2,100.0
431113,2016,0,0,2,2,0.0
431115,2012,2,0,0,2,100.0
431115,2013,5,0,0,5,100.0
431115,2014,3,0,0,3,100.0
431115,2015,2,0,0,2,100.0
431115,2016,1,0,0,1,100.0
431115,2019,1,0,0,1,100.0
431115,2020,2,0,0,2,100.0
431120,2012,5,0,0,5,100.0
431120,2013,7,0,0,7,100.0
431120,2014,6,0,0,6,100.0
431120,2015,7,0,0,7,100.0
431120,2016,5,0,0,5,100.0
431120,2017,6,0,0,6,100.0
431120,2018,5,0,0,5,100.0
431120,2019,7,0,0,7,100.0
431120,2020,7,0,1,8,87.5
431123,2012,3,0,0,3,100.0
431123,2014,2,0,0,2,100.0
431123,2015,1,0,0,1,100.0
431123,2017,1,0,0,1,100.0
431123,2018,1,0,0,1,100.0
431123,2020,1,0,0,1,100.0
431125,2012,3,0,0,3,100.0
431125,2013,1,0,1,2,50.0
431125,2014,1,0,0,1,100.0
431125,2015,1,0,0,1,100.0
431125,2016,2,0,0,2,100.0
431125,2017,3,0,0,3,100.0
431125,2018,2,0,0,2,100.0
431125,2019,2,0,1,3,66.66666666666666
431125,2020,0,0,1,1,0.0
431127,2014,0,0,1,1,0.0
431127,2015,1,0,0,1,100.0
431127,2016,1,0,0,1,100.0
431127,2020,1,0,0,1,100.0
431130,2012,6,0,5,11,54.54545454545454
431130,2013,6,0,2,8,75.0
431130,2014,6,3,7,16,56.25
431130,2015,10,0,0,10,100.0
431130,2016,7,0,0,7,100.0
431130,2017,7,0,0,7,100.0
431130,2018,4,0,0,4,100.0
431130,2019,6,0,0,6,100.0
431130,2020,13,0,0,13,100.0
431140,2012,22,0,0,22,100.0
431140,2013,23,0,0,23,100.0
431140,2014,25,0,0,25,100.0
431140,2015,16,0,0,16,100.0
431140,2016,23,0,0,23,100.0
431140,2017,23,0,0,23,100.0
431140,2018,16,0,0,16,100.0
431140,2019,19,0,0,19,100.0
431140,2020,25,0,0,25,100.0
431142,2012,1,0,0,1,100.0
431142,2014,2,0,0,2,100.0
431142,2015,3,0,0,3,100.0
431142,2016,2,0,0,2,100.0
431142,2018,1,0,0,1,100.0
431150,2012,2,0,0,2,100.0
431150,2013,2,0,0,2,100.0
431150,2014,3,0,0,3,100.0
431150,2015,3,0,0,3,100.0
431150,2016,6,0,0,6,100.0
431150,2018,2,0,0,2,100.0
431150,2019,2,0,0,2,100.0
431150,2020,5,0,0,5,100.0
431160,2012,1,0,0,1,100.0
431160,2013,1,0,0,1,100.0
431160,2014,1,0,0,1,100.0
431160,2015,1,0,0,1,100.0
431160,2018,2,0,0,2,100.0
431160,2019,1,0,1,2,50.0
431160,2020,1,0,0,1,100.0
431162,2013,1,0,0,1,100.0
431162,2014,4,0,0,4,100.0
431162,2015,1,0,0,1,100.0
431162,2016,1,0,0,1,100.0
431162,2017,2,0,0,2,100.0
431162,2018,2,0,0,2,100.0
431162,2019,2,0,0,2,100.0
431162,2020,1,0,0,1,100.0
431164,2017,0,0,1,1,0.0
431170,2012,1,0,0,1,100.0
431170,2013,0,0,1,1,0.0
431170,2016,1,0,0,1,100.0
431170,2017,2,0,0,2,100.0
431170,2018,1,0,0,1,100.0
431170,2019,1,0,0,1,100.0
431171,2014,0,0,1,1,0.0
431171,2019,4,0,0,4,100.0
431171,2020,1,0,0,1,100.0
431173,2013,1,0,1,2,50.0
431173,2015,1,0,0,1,100.0
431173,2016,1,0,1,2,50.0
431173,2020,1,0,0,1,100.0
431175,2012,1,0,0,1,100.0
431175,2013,3,0,0,3,100.0
431175,2014,3,0,0,3,100.0
431175,2015,1,0,0,1,100.0
431175,2017,2,0,0,2,100.0
431175,2018,2,0,1,3,66.66666666666666
431175,2019,2,0,0,2,100.0
431175,2020,1,0,0,1,100.0
431177,2012,4,0,0,4,100.0
431177,2013,1,0,0,1,100.0
431177,2014,2,0,0,2,100.0
431177,2015,3,0,0,3,100.0
431177,2016,0,0,1,1,0.0
431177,2017,2,0,1,3,66.66666666666666
431177,2018,3,0,0,3,100.0
431177,2020,1,0,0,1,100.0
431179,2012,1,0,0,1,100.0
431179,2014,0,0,1,1,0.0
431180,2012,12,0,0,12,100.0
431180,2013,15,0,0,15,100.0
431180,2014,14,0,0,14,100.0
431180,2015,9,0,0,9,100.0
431180,2016,6,0,0,6,100.0
431180,2017,10,0,1,11,90.9090909090909
431180,2018,8,0,0,8,100.0
431180,2019,13,0,1,14,92.85714285714286
431180,2020,8,0,0,8,100.0
431190,2012,3,0,0,3,100.0
431190,2013,2,0,0,2,100.0
431190,2015,2,0,0,2,100.0
431190,2017,2,0,0,2,100.0
431190,2018,1,0,0,1,100.0
431190,2020,0,0,2,2,0.0
431198,2013,0,0,2,2,0.0
431198,2014,0,0,1,1,0.0
431198,2015,0,1,1,2,50.0
431198,2017,0,0,1,1,0.0
431198,2018,0,0,1,1,0.0
431198,2019,0,0,1,1,0.0
431198,2020,0,0,1,1,0.0
431200,2012,1,0,0,1,100.0
431200,2015,0,0,1,1,0.0
431200,2020,0,0,1,1,0.0
431205,2012,1,0,0,1,100.0
431205,2014,1,0,1,2,50.0
431205,2016,3,0,0,3,100.0
431205,2017,1,0,0,1,100.0
431205,2018,1,0,1,2,50.0
431205,2019,2,0,1,3,66.66666666666666
431205,2020,1,0,0,1,100.0
431210,2012,2,0,0,2,100.0
431210,2013,1,0,0,1,100.0
431210,2015,1,0,0,1,100.0
431210,2016,1,0,1,2,50.0
431210,2018,2,0,0,2,100.0
431210,2019,1,0,0,1,100.0
431213,2012,2,0,0,2,100.0
431213,2016,1,0,0,1,100.0
431213,2018,1,0,0,1,100.0
431215,2015,3,0,0,3,100.0
431215,2017,1,0,0,1,100.0
431217,2012,1,0,0,1,100.0
431217,2014,1,0,0,1,100.0
431217,2015,1,0,0,1,100.0
431220,2012,1,0,0,1,100.0
431220,2015,1,0,0,1,100.0
431220,2018,1,0,0,1,100.0
431220,2020,2,0,0,2,100.0
431225,2012,0,1,1,2,50.0
431225,2013,0,1,2,3,33.33333333333333
431225,2014,0,0,3,3,0.0
431225,2015,0,1,1,2,50.0
431225,2016,0,0,4,4,0.0
431225,2017,0,0,2,2,0.0
431225,2018,0,0,4,4,0.0
431225,2019,0,0,1,1,0.0
431225,2020,0,0,2,2,0.0
431230,2012,1,0,0,1,100.0
431230,2013,2,0,0,2,100.0
431230,2014,1,0,0,1,100.0
431230,2016,0,0,1,1,0.0
431230,2020,1,0,0,1,100.0
431235,2014,1,0,0,1,100.0
431235,2015,1,0,0,1,100.0
431235,2017,1,0,0,1,100.0
431237,2013,0,1,0,1,100.0
431237,2014,1,0,1,2,50.0
431237,2015,0,0,1,1,0.0
431237,2016,1,1,2,4,50.0
431237,2017,2,0,0,2,100.0
431237,2018,1,0,0,1,100.0
431237,2019,1,0,1,2,50.0
431237,2020,0,0,1,1,0.0
431238,2012,1,0,0,1,100.0
431238,2014,0,0,1,1,0.0
431240,2012,24,0,0,24,100.0
431240,2013,22,1,0,23,100.0
431240,2014,24,0,0,24,100.0
431240,2015,29,0,0,29,100.0
431240,2016,20,0,0,20,100.0
431240,2017,26,0,0,26,100.0
431240,2018,17,0,0,17,100.0
431240,2019,12,1,0,13,100.0
431240,2020,24,0,0,24,100.0
431242,2013,1,0,0,1,100.0
431242,2017,1,0,0,1,100.0
431242,2020,0,0,1,1,0.0
431244,2013,1,0,0,1,100.0
431244,2015,0,0,1,1,0.0
431244,2020,1,0,0,1,100.0
431245,2012,2,0,0,2,100.0
431245,2013,1,0,0,1,100.0
431245,2014,2,0,0,2,100.0
431245,2015,2,0,0,2,100.0
431245,2016,2,0,0,2,100.0
431245,2017,3,0,0,3,100.0
431245,2018,1,0,0,1,100.0
431245,2019,1,0,0,1,100.0
431245,2020,1,0,1,2,50.0
431247,2012,1,0,0,1,100.0
431247,2013,0,0,2,2,0.0
431247,2015,0,0,2,2,0.0
431247,2016,0,0,1,1,0.0
431247,2017,0,0,1,1,0.0
431247,2018,0,0,1,1,0.0
431247,2019,0,1,0,1,100.0
431247,2020,0,0,2,2,0.0
431250,2012,3,0,0,3,100.0
431250,2013,5,0,0,5,100.0
431250,2014,4,0,0,4,100.0
431250,2015,3,1,2,6,66.66666666666666
431250,2016,1,0,0,1,100.0
431250,2017,4,0,0,4,100.0
431250,2018,1,0,0,1,100.0
431250,2019,0,0,3,3,0.0
431250,2020,2,0,0,2,100.0
431260,2014,3,0,1,4,75.0
431260,2016,0,0,1,1,0.0
431260,2017,2,0,0,2,100.0
431260,2018,2,0,0,2,100.0
431260,2019,1,0,0,1,100.0
431260,2020,2,0,0,2,100.0
431261,2013,0,1,1,2,50.0
431261,2014,1,0,0,1,100.0
431261,2015,1,1,0,2,100.0
431261,2016,0,0,1,1,0.0
431261,2017,0,0,1,1,0.0
431261,2018,0,1,0,1,100.0
431261,2019,3,0,0,3,100.0
431261,2020,2,0,0,2,100.0
431262,2013,1,0,0,1,100.0
431262,2017,1,0,0,1,100.0
431262,2020,0,1,0,1,100.0
431265,2012,4,0,0,4,100.0
431265,2013,2,0,0,2,100.0
431265,2014,1,0,0,1,100.0
431265,2015,3,0,0,3,100.0
431265,2016,10,0,0,10,100.0
431265,2017,5,0,0,5,100.0
431265,2018,3,0,0,3,100.0
431265,2019,1,0,1,2,50.0
431265,2020,4,1,0,5,100.0
431267,2013,1,0,0,1,100.0
431267,2016,1,0,0,1,100.0
431267,2020,0,0,1,1,0.0
431270,2012,1,0,0,1,100.0
431270,2013,2,0,0,2,100.0
431270,2014,1,0,0,1,100.0
431270,2015,6,0,0,6,100.0
431270,2016,4,0,0,4,100.0
431270,2017,3,0,0,3,100.0
431270,2018,7,0,0,7,100.0
431270,2019,3,0,0,3,100.0
431270,2020,8,0,0,8,100.0
431275,2012,2,0,0,2,100.0
431275,2013,3,0,0,3,100.0
431275,2016,1,0,0,1,100.0
431275,2017,1,0,0,1,100.0
431275,2019,0,0,1,1,0.0
431275,2020,1,1,0,2,100.0
431280,2013,0,1,1,2,50.0
431280,2014,0,1,0,1,100.0
431280,2016,1,0,0,1,100.0
431280,2017,1,0,0,1,100.0
431280,2018,1,0,0,1,100.0
431280,2019,0,1,0,1,100.0
431280,2020,0,0,1,1,0.0
431290,2012,1,0,0,1,100.0
431290,2013,1,0,0,1,100.0
431290,2014,2,0,0,2,100.0
431290,2015,2,0,0,2,100.0
431290,2016,2,0,0,2,100.0
431290,2017,3,0,0,3,100.0
431290,2018,3,0,0,3,100.0
431290,2019,1,0,0,1,100.0
431295,2013,1,0,0,1,100.0
431295,2014,1,0,0,1,100.0
431300,2012,2,0,0,2,100.0
431300,2014,2,0,0,2,100.0
431300,2020,2,0,0,2,100.0
431301,2012,1,0,0,1,100.0
431301,2013,3,0,0,3,100.0
431301,2019,2,0,0,2,100.0
431303,2013,2,0,0,2,100.0
431303,2014,3,0,1,4,75.0
431303,2015,0,0,1,1,0.0
431303,2016,2,0,0,2,100.0
431303,2017,1,0,1,2,50.0
431303,2018,1,0,0,1,100.0
431303,2019,1,0,0,1,100.0
431303,2020,1,0,0,1,100.0
431306,2012,6,0,0,6,100.0
431306,2013,8,0,0,8,100.0
431306,2014,4,0,3,7,57.14285714285714
431306,2015,9,0,0,9,100.0
431306,2016,2,0,0,2,100.0
431306,2017,9,1,0,10,100.0
431306,2018,7,0,0,7,100.0
431306,2019,0,0,1,1,0.0
431306,2020,0,0,3,3,0.0
431308,2018,1,0,0,1,100.0
431310,2012,2,0,0,2,100.0
431310,2014,5,0,0,5,100.0
431310,2016,0,0,1,1,0.0
431310,2018,1,0,0,1,100.0
431310,2019,2,0,0,2,100.0
431310,2020,1,0,0,1,100.0
431320,2012,4,0,1,5,80.0
431320,2013,0,2,1,3,66.66666666666666
431320,2014,3,0,0,3,100.0
431320,2015,5,0,0,5,100.0
431320,2016,8,0,0,8,100.0
431320,2017,4,0,0,4,100.0
431320,2018,8,0,0,8,100.0
431320,2019,4,0,0,4,100.0
431320,2020,7,0,0,7,100.0
431330,2012,7,0,0,7,100.0
431330,2013,7,0,0,7,100.0
431330,2014,3,0,0,3,100.0
431330,2015,13,0,0,13,100.0
431330,2016,14,0,0,14,100.0
431330,2017,5,0,0,5,100.0
431330,2018,1,0,0,1,100.0
431330,2019,5,0,0,5,100.0
431330,2020,5,0,0,5,100.0
431333,2012,1,0,0,1,100.0
431333,2014,2,0,0,2,100.0
431333,2018,1,0,0,1,100.0
431333,2020,1,0,0,1,100.0
431335,2017,0,0,1,1,0.0
431335,2019,0,0,1,1,0.0
431335,2020,0,0,1,1,0.0
431337,2012,12,0,0,12,100.0
431337,2013,3,1,0,4,100.0
431337,2014,4,0,1,5,80.0
431337,2015,13,0,0,13,100.0
431337,2016,6,0,0,6,100.0
431337,2017,8,0,0,8,100.0
431337,2018,8,0,0,8,100.0
431337,2019,9,0,0,9,100.0
431337,2020,14,0,0,14,100.0
431339,2012,1,0,0,1,100.0
431339,2013,1,0,0,1,100.0
431339,2015,2,0,0,2,100.0
431339,2017,1,0,0,1,100.0
431339,2018,2,0,0,2,100.0
431339,2020,1,0,0,1,100.0
431340,2012,79,0,0,79,100.0
431340,2013,102,0,0,102,100.0
431340,2014,78,0,0,78,100.0
431340,2015,85,0,0,85,100.0
431340,2016,88,0,1,89,98.87640449438202
431340,2017,101,0,0,101,100.0
431340,2018,90,0,0,90,100.0
431340,2019,89,0,0,89,100.0
431340,2020,76,0,0,76,100.0
431342,2012,1,0,0,1,100.0
431342,2016,3,0,0,3,100.0
431342,2017,1,0,0,1,100.0
431344,2012,1,0,0,1,100.0
431344,2014,0,0,1,1,0.0
431344,2015,1,0,0,1,100.0
431344,2020,1,0,0,1,100.0
431346,2012,1,0,0,1,100.0
431346,2018,1,0,0,1,100.0
431346,2019,2,0,0,2,100.0
431346,2020,1,0,0,1,100.0
431349,2013,1,0,0,1,100.0
431349,2014,1,0,0,1,100.0
431349,2015,2,0,0,2,100.0
431349,2017,1,0,0,1,100.0
431349,2018,1,0,0,1,100.0
431350,2012,16,0,0,16,100.0
431350,2013,16,0,0,16,100.0
431350,2014,12,1,0,13,100.0
431350,2015,12,0,0,12,100.0
431350,2016,18,0,0,18,100.0
431350,2017,15,0,0,15,100.0
431350,2018,7,0,0,7,100.0
431350,2019,16,0,0,16,100.0
431350,2020,22,0,0,22,100.0
431360,2016,1,0,0,1,100.0
431360,2017,2,0,0,2,100.0
431360,2018,1,0,0,1,100.0
431360,2019,1,0,0,1,100.0
431360,2020,1,0,0,1,100.0
431365,2012,3,0,0,3,100.0
431365,2013,3,2,1,6,83.33333333333334
431365,2014,4,0,0,4,100.0
431365,2015,2,0,0,2,100.0
431365,2016,1,0,1,2,50.0
431365,2017,2,0,0,2,100.0
431365,2018,10,0,0,10,100.0
431365,2019,2,0,3,5,40.0
431365,2020,7,0,0,7,100.0
431370,2012,13,0,0,13,100.0
431370,2013,13,1,0,14,100.0
431370,2014,7,0,0,7,100.0
431370,2015,9,0,1,10,90.0
431370,2016,11,0,0,11,100.0
431370,2017,4,0,1,5,80.0
431370,2018,17,0,1,18,94.44444444444444
431370,2019,15,0,0,15,100.0
431370,2020,16,0,0,16,100.0
431380,2012,0,0,2,2,0.0
431380,2013,2,0,1,3,66.66666666666666
431380,2014,1,0,0,1,100.0
431380,2015,2,0,0,2,100.0
431380,2016,2,0,1,3,66.66666666666666
431380,2017,2,1,0,3,100.0
431380,2018,1,0,0,1,100.0
431380,2020,1,0,0,1,100.0
431390,2012,8,0,0,8,100.0
431390,2013,12,0,0,12,100.0
431390,2014,8,0,0,8,100.0
431390,2015,8,0,0,8,100.0
431390,2016,14,0,0,14,100.0
431390,2017,16,0,0,16,100.0
431390,2018,14,0,0,14,100.0
431390,2019,3,0,5,8,37.5
431390,2020,10,0,0,10,100.0
431395,2012,1,0,5,6,16.666666666666664
431395,2013,1,0,2,3,33.33333333333333
431395,2014,4,0,1,5,80.0
431395,2015,10,0,0,10,100.0
431395,2016,1,0,0,1,100.0
431395,2017,3,0,0,3,100.0
431395,2018,2,0,0,2,100.0
431395,2019,3,0,0,3,100.0
431395,2020,1,0,0,1,100.0
431400,2012,0,0,1,1,0.0
431400,2013,2,0,0,2,100.0
431400,2014,2,0,0,2,100.0
431400,2015,1,0,0,1,100.0
431400,2016,1,0,1,2,50.0
431400,2017,1,0,0,1,100.0
431400,2019,4,0,0,4,100.0
431400,2020,2,0,0,2,100.0
431402,2012,1,0,0,1,100.0
431402,2013,2,0,0,2,100.0
431402,2014,1,0,0,1,100.0
431402,2015,4,0,0,4,100.0
431402,2016,3,0,0,3,100.0
431402,2018,2,0,2,4,50.0
431402,2019,1,0,0,1,100.0
431403,2013,2,0,0,2,100.0
431403,2015,1,0,1,2,50.0
431403,2016,1,0,0,1,100.0
431403,2017,1,0,0,1,100.0
431403,2018,1,0,0,1,100.0
431403,2019,1,0,0,1,100.0
431403,2020,1,0,0,1,100.0
431405,2012,17,0,0,17,100.0
431405,2013,24,0,0,24,100.0
431405,2014,29,0,0,29,100.0
431405,2015,15,0,8,23,65.21739130434783
431405,2016,16,0,1,17,94.11764705882352
431405,2017,21,0,1,22,95.45454545454545
431405,2018,17,0,1,18,94.44444444444444
431405,2019,17,0,0,17,100.0
431405,2020,27,0,0,27,100.0
431406,2012,2,0,0,2,100.0
431406,2014,1,0,0,1,100.0
431406,2016,1,0,0,1,100.0
431406,2017,1,0,0,1,100.0
431406,2018,3,0,0,3,100.0
431406,2019,1,0,0,1,100.0
431407,2012,1,0,3,4,25.0
431407,2014,5,0,0,5,100.0
431407,2015,0,0,3,3,0.0
431407,2016,0,0,4,4,0.0
431407,2017,1,0,0,1,100.0
431407,2018,3,0,0,3,100.0
431407,2019,2,0,0,2,100.0
431407,2020,1,0,0,1,100.0
431410,2012,80,0,0,80,100.0
431410,2013,60,0,0,60,100.0
431410,2014,49,0,0,49,100.0
431410,2015,69,0,0,69,100.0
431410,2016,65,0,0,65,100.0
431410,2017,50,0,0,50,100.0
431410,2018,58,0,0,58,100.0
431410,2019,59,0,0,59,100.0
431410,2020,64,0,0,64,100.0
431413,2012,1,0,0,1,100.0
431413,2013,2,0,0,2,100.0
431413,2017,4,0,0,4,100.0
431413,2018,1,0,0,1,100.0
431413,2019,1,0,0,1,100.0
431415,2012,0,0,1,1,0.0
431415,2013,1,0,1,2,50.0
431415,2014,5,0,0,5,100.0
431415,2015,1,0,0,1,100.0
431415,2019,0,0,2,2,0.0
431415,2020,1,0,0,1,100.0
431417,2012,2,0,0,2,100.0
431417,2013,1,0,0,1,100.0
431417,2014,1,0,0,1,100.0
431417,2016,3,0,0,3,100.0
431417,2018,0,1,0,1,100.0
431417,2020,1,0,0,1,100.0
431420,2012,0,1,5,6,16.666666666666664
431420,2013,4,0,2,6,66.66666666666666
431420,2015,1,0,1,2,50.0
431420,2016,3,0,1,4,75.0
431420,2017,2,0,0,2,100.0
431420,2018,1,0,0,1,100.0
431420,2019,1,0,1,2,50.0
431420,2020,1,0,1,2,50.0
431430,2012,1,0,0,1,100.0
431430,2013,0,0,1,1,0.0
431430,2015,1,0,0,1,100.0
431430,2016,1,0,0,1,100.0
431430,2017,2,0,0,2,100.0
431430,2018,2,0,0,2,100.0
431430,2020,2,0,0,2,100.0
431440,2012,128,2,2,132,98.48484848484848
431440,2013,125,0,16,141,88.65248226950354
431440,2014,89,4,37,130,71.53846153846153
431440,2015,125,0,0,125,100.0
431440,2016,134,0,0,134,100.0
431440,2017,126,0,0,126,100.0
431440,2018,118,0,0,118,100.0
431440,2019,102,0,1,103,99.02912621359224
431440,2020,127,0,4,131,96.94656488549617
431442,2012,1,0,0,1,100.0
431442,2013,1,0,0,1,100.0
431442,2014,2,0,0,2,100.0
431442,2016,2,0,0,2,100.0
431442,2017,5,0,1,6,83.33333333333334
431442,2018,2,0,0,2,100.0
431442,2019,2,0,0,2,100.0
431442,2020,1,0,0,1,100.0
431445,2012,1,0,0,1,100.0
431445,2013,1,0,1,2,50.0
431445,2016,1,0,0,1,100.0
431445,2017,1,0,0,1,100.0
431445,2018,1,0,0,1,100.0
431445,2019,1,0,0,1,100.0
431446,2014,0,0,1,1,0.0
431446,2015,0,1,0,1,100.0
431446,2016,1,0,0,1,100.0
431446,2019,1,0,0,1,100.0
431447,2013,1,0,0,1,100.0
431447,2014,2,0,0,2,100.0
431447,2016,2,0,0,2,100.0
431447,2017,1,0,0,1,100.0
431449,2014,1,0,0,1,100.0
431449,2016,2,0,0,2,100.0
431449,2018,2,0,0,2,100.0
431449,2019,3,0,0,3,100.0
431450,2012,3,0,0,3,100.0
431450,2013,8,0,0,8,100.0
431450,2014,10,0,1,11,90.9090909090909
431450,2015,1,0,2,3,33.33333333333333
431450,2016,6,0,0,6,100.0
431450,2017,8,0,0,8,100.0
431450,2018,2,0,1,3,66.66666666666666
431450,2019,0,0,6,6,0.0
431450,2020,3,0,1,4,75.0
431454,2014,1,0,0,1,100.0
431455,2013,2,0,0,2,100.0
431455,2016,1,0,0,1,100.0
431455,2017,1,0,0,1,100.0
431455,2018,1,0,0,1,100.0
431455,2020,2,0,0,2,100.0
431460,2012,6,0,0,6,100.0
431460,2013,6,0,0,6,100.0
431460,2014,10,0,0,10,100.0
431460,2015,2,0,2,4,50.0
431460,2016,6,0,1,7,85.71428571428571
431460,2017,5,0,0,5,100.0
431460,2018,6,0,2,8,75.0
431460,2019,2,0,1,3,66.66666666666666
431460,2020,4,1,3,8,62.5
431470,2012,2,0,1,3,66.66666666666666
431470,2013,5,0,0,5,100.0
431470,2015,2,0,0,2,100.0
431470,2016,2,0,0,2,100.0
431470,2017,5,0,1,6,83.33333333333334
431470,2018,5,0,0,5,100.0
431470,2019,2,0,0,2,100.0
431470,2020,3,0,0,3,100.0
431475,2015,1,0,0,1,100.0
431475,2016,1,0,0,1,100.0
431475,2017,0,0,1,1,0.0
431475,2020,1,0,0,1,100.0
431477,2014,1,0,0,1,100.0
431477,2015,1,0,0,1,100.0
431477,2017,0,0,1,1,0.0
431477,2020,0,1,0,1,100.0
431478,2017,1,0,0,1,100.0
431480,2012,9,0,1,10,90.0
431480,2013,9,0,0,9,100.0
431480,2014,18,0,1,19,94.73684210526315
431480,2015,21,0,0,21,100.0
431480,2016,7,0,0,7,100.0
431480,2017,9,0,0,9,100.0
431480,2018,9,0,0,9,100.0
431480,2019,7,1,2,10,80.0
431480,2020,2,0,8,10,20.0
431490,2012,527,0,0,527,100.0
431490,2013,443,20,23,486,95.26748971193416
431490,2014,442,8,13,463,97.19222462203024
431490,2015,465,0,0,465,100.0
431490,2016,455,5,20,480,95.83333333333334
431490,2017,494,2,15,511,97.06457925636008
431490,2018,447,4,6,457,98.6870897155361
431490,2019,395,28,11,434,97.46543778801843
431490,2020,443,6,17,466,96.35193133047211
431500,2012,3,0,0,3,100.0
431500,2013,1,0,0,1,100.0
431500,2014,2,0,0,2,100.0
431500,2015,1,0,0,1,100.0
431500,2017,2,0,0,2,100.0
431500,2019,1,0,0,1,100.0
431500,2020,2,0,0,2,100.0
431505,2012,1,0,0,1,100.0
431505,2014,1,0,0,1,100.0
431505,2019,1,0,0,1,100.0
431505,2020,2,0,0,2,100.0
431507,2013,1,0,0,1,100.0
431507,2017,1,0,0,1,100.0
431507,2020,2,0,0,2,100.0
431510,2012,1,0,0,1,100.0
431510,2013,1,0,0,1,100.0
431510,2014,10,0,0,10,100.0
431510,2015,5,0,0,5,100.0
431510,2016,5,0,0,5,100.0
431510,2017,5,0,0,5,100.0
431510,2018,2,0,0,2,100.0
431510,2019,2,0,0,2,100.0
431510,2020,4,0,0,4,100.0
431513,2013,1,0,0,1,100.0
431513,2015,1,0,0,1,100.0
431513,2016,0,0,1,1,0.0
431513,2018,2,0,0,2,100.0
431514,2013,1,0,0,1,100.0
431514,2016,1,0,0,1,100.0
431514,2017,1,0,0,1,100.0
431514,2018,1,0,0,1,100.0
431514,2019,2,0,0,2,100.0
431515,2013,0,0,1,1,0.0
431515,2014,1,0,1,2,50.0
431515,2015,4,0,0,4,100.0
431515,2016,1,0,1,2,50.0
431515,2017,3,0,0,3,100.0
431515,2018,3,0,0,3,100.0
431515,2019,2,0,0,2,100.0
431515,2020,2,0,0,2,100.0
431517,2012,1,0,0,1,100.0
431517,2013,0,0,1,1,0.0
431517,2016,0,0,1,1,0.0
431517,2017,0,0,1,1,0.0
431517,2019,0,0,1,1,0.0
431517,2020,0,0,1,1,0.0
431520,2016,0,0,1,1,0.0
431520,2017,0,0,2,2,0.0
431520,2018,0,0,1,1,0.0
431520,2019,0,0,2,2,0.0
431530,2012,4,1,1,6,83.33333333333334
431530,2013,2,0,2,4,50.0
431530,2014,8,1,0,9,100.0
431530,2015,9,0,2,11,81.81818181818183
431530,2016,0,2,4,6,33.33333333333333
431530,2017,3,5,0,8,100.0
431530,2018,5,0,1,6,83.33333333333334
431530,2019,1,0,10,11,9.090909090909092
431530,2020,0,0,8,8,0.0
431531,2012,1,0,0,1,100.0
431531,2015,1,0,0,1,100.0
431531,2017,1,0,0,1,100.0
431531,2020,1,0,0,1,100.0
431532,2014,1,0,0,1,100.0
431532,2016,2,0,0,2,100.0
431532,2018,1,0,0,1,100.0
431532,2020,1,0,0,1,100.0
431535,2013,1,0,0,1,100.0
431535,2014,1,0,0,1,100.0
431535,2015,1,0,0,1,100.0
431535,2017,2,0,0,2,100.0
431535,2018,1,0,0,1,100.0
431540,2012,3,0,0,3,100.0
431540,2013,7,0,0,7,100.0
431540,2014,4,0,0,4,100.0
431540,2015,3,0,0,3,100.0
431540,2016,8,0,0,8,100.0
431540,2017,5,0,1,6,83.33333333333334
431540,2018,5,0,0,5,100.0
431540,2019,2,0,0,2,100.0
431540,2020,2,0,0,2,100.0
431545,2013,1,0,1,2,50.0
431545,2019,0,0,1,1,0.0
431545,2020,1,0,0,1,100.0
431550,2012,8,0,0,8,100.0
431550,2013,7,0,0,7,100.0
431550,2014,1,0,0,1,100.0
431550,2015,2,0,0,2,100.0
431550,2016,3,0,0,3,100.0
431550,2017,2,0,0,2,100.0
431550,2018,9,0,0,9,100.0
431550,2019,4,0,1,5,80.0
431550,2020,4,0,0,4,100.0
431555,2013,2,0,0,2,100.0
431555,2016,0,0,1,1,0.0
431555,2017,1,0,0,1,100.0
431555,2020,2,0,0,2,100.0
431560,2012,72,0,11,83,86.74698795180723
431560,2013,69,0,21,90,76.66666666666667
431560,2014,81,0,0,81,100.0
431560,2015,74,1,0,75,100.0
431560,2016,92,0,0,92,100.0
431560,2017,63,0,0,63,100.0
431560,2018,79,0,0,79,100.0
431560,2019,71,0,0,71,100.0
431560,2020,49,1,20,70,71.42857142857143
431570,2012,0,1,6,7,14.285714285714285
431570,2013,3,1,11,15,26.666666666666668
431570,2014,12,0,0,12,100.0
431570,2015,13,0,0,13,100.0
431570,2016,12,0,2,14,85.71428571428571
431570,2017,9,0,0,9,100.0
431570,2018,12,0,1,13,92.3076923076923
431570,2019,15,0,0,15,100.0
431570,2020,10,0,0,10,100.0
431575,2012,0,0,4,4,0.0
431575,2013,2,0,0,2,100.0
431575,2014,0,0,1,1,0.0
431575,2016,0,0,1,1,0.0
431575,2017,1,0,0,1,100.0
431575,2018,1,0,0,1,100.0
431575,2019,1,0,0,1,100.0
431575,2020,0,0,1,1,0.0
431580,2012,2,0,0,2,100.0
431580,2013,1,0,4,5,20.0
431580,2014,1,0,0,1,100.0
431580,2015,3,0,0,3,100.0
431580,2016,3,0,0,3,100.0
431580,2017,2,0,0,2,100.0
431580,2018,1,0,0,1,100.0
431580,2019,4,0,0,4,100.0
431580,2020,4,0,0,4,100.0
431590,2012,2,0,0,2,100.0
431590,2013,1,0,0,1,100.0
431590,2014,1,0,0,1,100.0
431590,2015,2,0,0,2,100.0
431590,2016,1,0,0,1,100.0
431590,2018,3,0,0,3,100.0
431590,2019,2,0,0,2,100.0
431590,2020,3,0,0,3,100.0
431595,2013,1,0,0,1,100.0
431595,2014,1,0,0,1,100.0
431595,2015,1,0,0,1,100.0
431595,2018,1,0,0,1,100.0
431595,2020,2,0,0,2,100.0
431600,2012,2,0,0,2,100.0
431600,2013,11,0,0,11,100.0
431600,2014,5,0,0,5,100.0
431600,2015,7,0,0,7,100.0
431600,2016,7,0,0,7,100.0
431600,2017,6,0,0,6,100.0
431600,2018,10,0,0,10,100.0
431600,2019,5,0,0,5,100.0
431600,2020,12,0,0,12,100.0
431610,2012,1,0,0,1,100.0
431610,2013,5,0,0,5,100.0
431610,2014,3,0,0,3,100.0
431610,2015,3,0,0,3,100.0
431610,2016,1,0,0,1,100.0
431610,2017,2,0,0,2,100.0
431610,2018,3,0,0,3,100.0
431610,2019,5,0,0,5,100.0
431610,2020,1,0,0,1,100.0
431620,2014,1,0,0,1,100.0
431620,2015,1,0,0,1,100.0
431620,2016,2,0,0,2,100.0
431620,2017,1,0,0,1,100.0
431620,2019,3,0,0,3,100.0
431630,2012,2,0,0,2,100.0
431630,2014,5,0,0,5,100.0
431630,2015,1,0,0,1,100.0
431630,2016,3,0,0,3,100.0
431630,2017,1,0,0,1,100.0
431630,2018,4,0,0,4,100.0
431630,2019,1,0,0,1,100.0
431630,2020,4,0,0,4,100.0
431640,2012,14,0,0,14,100.0
431640,2013,15,0,0,15,100.0
431640,2014,7,0,0,7,100.0
431640,2015,10,0,0,10,100.0
431640,2016,22,0,0,22,100.0
431640,2017,12,0,0,12,100.0
431640,2018,13,0,0,13,100.0
431640,2019,15,0,0,15,100.0
431640,2020,13,0,0,13,100.0
431642,2012,1,0,0,1,100.0
431642,2015,1,0,0,1,100.0
431642,2017,3,0,0,3,100.0
431642,2018,1,0,0,1,100.0
431642,2020,2,0,0,2,100.0
431643,2012,1,0,0,1,100.0
431643,2013,1,0,0,1,100.0
431643,2018,1,0,0,1,100.0
431643,2019,1,0,0,1,100.0
431643,2020,1,0,0,1,100.0
431645,2012,6,0,0,6,100.0
431645,2013,6,0,0,6,100.0
431645,2014,2,0,0,2,100.0
431645,2015,5,0,0,5,100.0
431645,2016,5,0,0,5,100.0
431645,2017,6,0,0,6,100.0
431645,2018,3,0,0,3,100.0
431645,2019,4,0,0,4,100.0
431645,2020,4,0,0,4,100.0
431647,2012,2,0,0,2,100.0
431647,2013,2,0,0,2,100.0
431647,2016,1,0,0,1,100.0
431647,2017,2,0,0,2,100.0
431647,2018,1,0,0,1,100.0
431650,2012,0,0,3,3,0.0
431650,2013,0,0,1,1,0.0
431650,2016,0,1,1,2,50.0
431650,2017,0,0,1,1,0.0
431650,2020,0,0,1,1,0.0
431660,2012,7,0,0,7,100.0
431660,2013,6,0,0,6,100.0
431660,2014,5,0,0,5,100.0
431660,2015,3,0,0,3,100.0
431660,2016,5,0,0,5,100.0
431660,2017,5,0,0,5,100.0
431660,2018,3,0,0,3,100.0
431660,2019,3,0,0,3,100.0
431660,2020,4,0,0,4,100.0
431670,2012,1,0,0,1,100.0
431670,2013,3,0,0,3,100.0
431670,2014,1,0,0,1,100.0
431670,2015,2,0,0,2,100.0
431670,2016,5,0,0,5,100.0
431670,2017,1,0,0,1,100.0
431670,2018,4,0,0,4,100.0
431670,2019,4,0,0,4,100.0
431670,2020,2,0,0,2,100.0
431673,2019,1,0,0,1,100.0
431675,2012,3,0,0,3,100.0
431675,2013,1,0,0,1,100.0
431675,2014,1,0,0,1,100.0
431675,2017,1,0,0,1,100.0
431675,2018,3,0,0,3,100.0
431675,2019,1,0,0,1,100.0
431675,2020,1,0,0,1,100.0
431680,2012,36,0,0,36,100.0
431680,2013,38,0,1,39,97.43589743589743
431680,2014,38,0,0,38,100.0
431680,2015,43,0,0,43,100.0
431680,2016,38,0,0,38,100.0
431680,2017,36,0,0,36,100.0
431680,2018,39,0,0,39,100.0
431680,2019,39,0,1,40,97.5
431680,2020,31,0,0,31,100.0
431690,2012,107,0,0,107,100.0
431690,2013,172,0,0,172,100.0
431690,2014,89,0,0,89,100.0
431690,2015,96,0,1,97,98.96907216494846
431690,2016,79,0,0,79,100.0
431690,2017,95,0,0,95,100.0
431690,2018,91,0,0,91,100.0
431690,2019,85,0,0,85,100.0
431690,2020,89,0,0,89,100.0
431695,2012,2,0,0,2,100.0
431695,2013,1,0,3,4,25.0
431695,2014,0,0,1,1,0.0
431695,2015,0,0,1,1,0.0
431695,2017,3,0,0,3,100.0
431695,2018,2,0,0,2,100.0
431695,2019,1,0,0,1,100.0
431697,2012,0,0,1,1,0.0
431697,2013,0,0,1,1,0.0
431697,2016,1,0,1,2,50.0
431700,2012,4,0,0,4,100.0
431700,2013,3,0,0,3,100.0
431700,2014,1,0,0,1,100.0
431700,2015,0,0,1,1,0.0
431700,2016,4,0,0,4,100.0
431700,2017,4,0,0,4,100.0
431700,2018,3,0,0,3,100.0
431700,2019,1,0,4,5,20.0
431700,2020,2,0,1,3,66.66666666666666
431710,2012,25,0,0,25,100.0
431710,2013,21,0,0,21,100.0
431710,2014,26,0,0,26,100.0
431710,2015,42,0,0,42,100.0
431710,2016,35,0,0,35,100.0
431710,2017,36,0,0,36,100.0
431710,2018,19,0,0,19,100.0
431710,2019,21,0,0,21,100.0
431710,2020,35,0,0,35,100.0
431720,2012,20,0,0,20,100.0
431720,2013,10,1,2,13,84.61538461538461
431720,2014,18,0,0,18,100.0
431720,2015,27,0,0,27,100.0
431720,2016,21,0,0,21,100.0
431720,2017,25,0,0,25,100.0
431720,2018,17,0,0,17,100.0
431720,2019,28,0,0,28,100.0
431720,2020,20,0,0,20,100.0
431725,2014,0,0,1,1,0.0
431730,2012,13,0,0,13,100.0
431730,2013,10,0,0,10,100.0
431730,2014,14,0,0,14,100.0
431730,2015,9,0,0,9,100.0
431730,2016,9,1,0,10,100.0
431730,2017,11,0,1,12,91.66666666666666
431730,2018,12,1,2,15,86.66666666666667
431730,2019,7,1,5,13,61.53846153846154
431730,2020,5,0,1,6,83.33333333333334
431740,2012,11,0,0,11,100.0
431740,2013,13,0,0,13,100.0
431740,2014,15,0,0,15,100.0
431740,2015,8,0,2,10,80.0
431740,2016,14,0,0,14,100.0
431740,2017,20,0,0,20,100.0
431740,2018,11,0,0,11,100.0
431740,2019,9,0,0,9,100.0
431740,2020,11,0,0,11,100.0
431750,2012,29,0,0,29,100.0
431750,2013,37,0,0,37,100.0
431750,2014,28,0,1,29,96.55172413793103
431750,2015,26,0,0,26,100.0
431750,2016,34,0,1,35,97.14285714285714
431750,2017,24,0,0,24,100.0
431750,2018,25,0,0,25,100.0
431750,2019,27,0,0,27,100.0
431750,2020,28,0,1,29,96.55172413793103
431755,2018,1,0,0,1,100.0
431760,2012,14,0,0,14,100.0
431760,2013,12,0,0,12,100.0
431760,2014,18,0,0,18,100.0
431760,2015,12,0,0,12,100.0
431760,2016,10,0,0,10,100.0
431760,2017,9,0,0,9,100.0
431760,2018,5,0,0,5,100.0
431760,2019,2,3,5,10,50.0
431760,2020,13,0,0,13,100.0
431770,2012,2,0,0,2,100.0
431770,2013,4,0,0,4,100.0
431770,2014,5,0,0,5,100.0
431770,2016,5,0,0,5,100.0
431770,2017,2,0,0,2,100.0
431770,2018,5,0,0,5,100.0
431770,2019,5,0,0,5,100.0
431770,2020,7,0,0,7,100.0
431775,2016,4,0,0,4,100.0
431775,2017,1,0,0,1,100.0
431775,2018,1,0,0,1,100.0
431775,2020,0,0,1,1,0.0
431780,2012,3,0,1,4,75.0
431780,2013,4,0,0,4,100.0
431780,2014,6,0,0,6,100.0
431780,2015,4,0,0,4,100.0
431780,2016,4,0,0,4,100.0
431780,2017,1,0,0,1,100.0
431780,2018,5,0,0,5,100.0
431780,2019,3,0,0,3,100.0
431780,2020,4,0,0,4,100.0
431790,2012,4,0,0,4,100.0
431790,2013,1,0,1,2,50.0
431790,2014,1,0,0,1,100.0
431790,2015,3,0,0,3,100.0
431790,2016,4,0,0,4,100.0
431790,2017,1,0,0,1,100.0
431790,2018,1,0,0,1,100.0
431790,2019,5,0,0,5,100.0
431790,2020,3,0,0,3,100.0
431795,2013,1,0,0,1,100.0
431795,2016,2,0,0,2,100.0
431800,2012,18,0,1,19,94.73684210526315
431800,2013,10,0,0,10,100.0
431800,2014,23,0,0,23,100.0
431800,2015,24,0,0,24,100.0
431800,2016,15,0,0,15,100.0
431800,2017,22,0,0,22,100.0
431800,2018,15,0,0,15,100.0
431800,2019,25,0,0,25,100.0
431800,2020,21,0,0,21,100.0
431805,2013,2,0,0,2,100.0
431805,2018,1,0,0,1,100.0
431810,2012,7,0,0,7,100.0
431810,2013,7,0,0,7,100.0
431810,2014,5,0,0,5,100.0
431810,2015,3,0,1,4,75.0
431810,2016,2,0,1,3,66.66666666666666
431810,2017,3,0,1,4,75.0
431810,2018,0,0,3,3,0.0
431810,2019,0,0,2,2,0.0
431810,2020,3,0,0,3,100.0
431820,2012,4,0,4,8,50.0
431820,2013,3,0,0,3,100.0
431820,2014,5,0,0,5,100.0
431820,2015,7,0,0,7,100.0
431820,2016,4,1,0,5,100.0
431820,2017,6,1,0,7,100.0
431820,2018,0,3,8,11,27.27272727272727
431820,2019,0,2,4,6,33.33333333333333
431820,2020,5,0,3,8,62.5
431830,2012,21,0,0,21,100.0
431830,2013,29,0,0,29,100.0
431830,2014,17,0,0,17,100.0
431830,2015,16,0,1,17,94.11764705882352
431830,2016,28,0,1,29,96.55172413793103
431830,2017,19,0,0,19,100.0
431830,2018,14,0,3,17,82.35294117647058
431830,2019,18,0,0,18,100.0
431830,2020,17,0,0,17,100.0
431840,2012,0,1,9,10,10.0
431840,2013,0,0,6,6,0.0
431840,2014,0,0,10,10,0.0
431840,2015,0,0,6,6,0.0
431840,2016,0,0,3,3,0.0
431840,2017,0,0,10,10,0.0
431840,2018,0,0,5,5,0.0
431840,2019,0,0,6,6,0.0
431840,2020,0,0,7,7,0.0
431842,2012,1,0,0,1,100.0
431842,2014,2,0,1,3,66.66666666666666
431842,2015,1,0,0,1,100.0
431842,2016,1,0,0,1,100.0
431842,2018,2,0,0,2,100.0
431843,2014,1,0,0,1,100.0
431843,2016,2,0,0,2,100.0
431843,2017,1,0,0,1,100.0
431843,2018,1,0,0,1,100.0
431843,2019,3,0,0,3,100.0
431843,2020,2,0,0,2,100.0
431844,2015,2,0,0,2,100.0
431844,2016,1,0,0,1,100.0
431844,2020,1,0,0,1,100.0
431845,2013,3,0,0,3,100.0
431845,2014,1,0,0,1,100.0
431845,2017,2,0,0,2,100.0
431845,2018,1,0,0,1,100.0
431845,2019,1,0,0,1,100.0
431846,2012,1,0,0,1,100.0
431846,2014,0,0,1,1,0.0
431846,2016,1,0,0,1,100.0
431846,2018,0,0,1,1,0.0
431846,2019,0,0,2,2,0.0
431846,2020,1,0,0,1,100.0
431848,2012,4,0,0,4,100.0
431848,2013,1,0,0,1,100.0
431848,2015,1,0,0,1,100.0
431848,2016,1,0,0,1,100.0
431848,2019,0,0,3,3,0.0
431848,2020,0,0,1,1,0.0
431849,2013,2,0,0,2,100.0
431849,2014,1,0,0,1,100.0
431849,2018,1,0,0,1,100.0
431849,2019,1,0,0,1,100.0
431849,2020,1,0,0,1,100.0
431850,2012,13,0,0,13,100.0
431850,2013,8,0,2,10,80.0
431850,2014,10,0,0,10,100.0
431850,2015,6,0,3,9,66.66666666666666
431850,2016,6,0,0,6,100.0
431850,2017,10,0,0,10,100.0
431850,2018,15,0,0,15,100.0
431850,2019,10,0,3,13,76.92307692307693
431850,2020,10,0,6,16,62.5
431860,2012,0,0,1,1,0.0
431860,2013,1,0,0,1,100.0
431860,2015,2,0,0,2,100.0
431860,2016,1,0,0,1,100.0
431860,2019,1,0,0,1,100.0
431860,2020,3,0,0,3,100.0
431861,2014,0,0,1,1,0.0
431861,2017,0,0,1,1,0.0
431861,2018,0,0,1,1,0.0
431862,2012,1,0,0,1,100.0
431862,2013,0,0,1,1,0.0
431862,2014,1,0,0,1,100.0
431862,2015,0,0,1,1,0.0
431862,2016,0,0,1,1,0.0
431862,2017,2,0,1,3,66.66666666666666
431862,2018,1,0,0,1,100.0
431870,2012,88,0,0,88,100.0
431870,2013,86,0,2,88,97.72727272727273
431870,2014,79,0,0,79,100.0
431870,2015,81,0,0,81,100.0
431870,2016,93,0,0,93,100.0
431870,2017,78,0,2,80,97.5
431870,2018,63,0,0,63,100.0
431870,2019,77,0,0,77,100.0
431870,2020,75,0,1,76,98.68421052631578
431880,2012,8,0,0,8,100.0
431880,2013,10,0,0,10,100.0
431880,2014,5,0,0,5,100.0
431880,2015,7,0,1,8,87.5
431880,2016,16,0,0,16,100.0
431880,2017,10,0,0,10,100.0
431880,2018,10,0,1,11,90.9090909090909
431880,2019,20,0,0,20,100.0
431880,2020,9,0,0,9,100.0
431890,2012,6,0,0,6,100.0
431890,2013,10,0,0,10,100.0
431890,2014,14,0,1,15,93.33333333333333
431890,2015,5,0,0,5,100.0
431890,2016,9,0,0,9,100.0
431890,2017,11,0,0,11,100.0
431890,2018,11,0,1,12,91.66666666666666
431890,2019,14,0,0,14,100.0
431890,2020,11,0,0,11,100.0
431900,2012,7,0,0,7,100.0
431900,2013,8,0,0,8,100.0
431900,2014,2,0,0,2,100.0
431900,2015,4,0,0,4,100.0
431900,2016,2,0,0,2,100.0
431900,2017,7,0,0,7,100.0
431900,2018,4,0,0,4,100.0
431900,2019,3,0,0,3,100.0
431900,2020,6,0,0,6,100.0
431910,2012,3,0,0,3,100.0
431910,2013,3,1,2,6,66.66666666666666
431910,2015,2,0,0,2,100.0
431910,2016,4,0,0,4,100.0
431910,2017,1,0,0,1,100.0
431910,2020,2,0,0,2,100.0
431912,2015,2,0,0,2,100.0
431912,2016,0,0,1,1,0.0
431912,2018,0,0,1,1,0.0
431915,2012,3,0,0,3,100.0
431915,2013,3,0,0,3,100.0
431915,2014,1,0,0,1,100.0
431915,2015,3,0,0,3,100.0
431915,2016,1,0,0,1,100.0
431915,2017,1,0,0,1,100.0
431915,2018,2,0,0,2,100.0
431915,2019,3,0,0,3,100.0
431915,2020,3,0,0,3,100.0
431920,2012,1,0,0,1,100.0
431920,2013,3,0,0,3,100.0
431920,2014,2,0,0,2,100.0
431920,2015,1,0,0,1,100.0
431920,2016,1,0,0,1,100.0
431920,2017,2,0,0,2,100.0
431920,2018,5,0,0,5,100.0
431920,2019,1,0,0,1,100.0
431930,2012,1,0,0,1,100.0
431930,2013,1,0,0,1,100.0
431930,2015,2,0,0,2,100.0
431930,2016,2,0,0,2,100.0
431930,2017,1,0,0,1,100.0
431930,2018,1,0,0,1,100.0
431930,2020,1,0,0,1,100.0
431935,2017,1,0,0,1,100.0
431935,2018,2,0,0,2,100.0
431936,2013,1,0,0,1,100.0
431936,2015,2,0,0,2,100.0
431936,2016,2,0,0,2,100.0
431936,2018,2,0,0,2,100.0
431936,2019,1,0,0,1,100.0
431937,2012,2,0,0,2,100.0
431937,2014,1,0,0,1,100.0
431937,2016,1,0,0,1,100.0
431940,2012,3,0,0,3,100.0
431940,2013,4,0,0,4,100.0
431940,2014,3,0,0,3,100.0
431940,2015,4,0,0,4,100.0
431940,2016,3,0,0,3,100.0
431940,2017,4,0,0,4,100.0
431940,2018,3,0,0,3,100.0
431940,2019,6,0,0,6,100.0
431940,2020,5,0,1,6,83.33333333333334
431950,2012,0,0,10,10,0.0
431950,2013,0,0,7,7,0.0
431950,2014,0,1,8,9,11.11111111111111
431950,2015,8,1,3,12,75.0
431950,2016,0,0,9,9,0.0
431950,2017,4,0,2,6,66.66666666666666
431950,2018,6,0,0,6,100.0
431950,2019,10,0,0,10,100.0
431950,2020,10,0,0,10,100.0
431960,2012,13,0,0,13,100.0
431960,2013,8,0,0,8,100.0
431960,2014,1,0,1,2,50.0
431960,2015,8,0,0,8,100.0
431960,2016,9,0,1,10,90.0
431960,2017,4,0,0,4,100.0
431960,2018,17,0,1,18,94.44444444444444
431960,2019,5,0,2,7,71.42857142857143
431960,2020,8,0,0,8,100.0
431970,2013,3,0,0,3,100.0
431970,2015,2,0,0,2,100.0
431970,2017,1,0,0,1,100.0
431970,2018,1,0,0,1,100.0
431970,2019,1,0,0,1,100.0
431970,2020,1,0,0,1,100.0
431973,2014,1,0,0,1,100.0
431973,2018,2,0,0,2,100.0
431973,2019,1,0,0,1,100.0
431975,2012,1,0,0,1,100.0
431975,2013,1,0,0,1,100.0
431975,2014,0,0,1,1,0.0
431975,2015,0,0,1,1,0.0
431975,2017,1,0,0,1,100.0
431975,2018,1,0,0,1,100.0
431975,2019,0,0,1,1,0.0
431975,2020,0,1,1,2,50.0
431980,2012,1,0,0,1,100.0
431980,2013,2,0,0,2,100.0
431980,2014,4,0,0,4,100.0
431980,2015,0,0,1,1,0.0
431980,2016,0,0,4,4,0.0
431980,2017,1,0,0,1,100.0
431980,2018,1,0,0,1,100.0
431980,2019,7,0,0,7,100.0
431980,2020,1,0,0,1,100.0
431990,2012,30,0,0,30,100.0
431990,2013,34,0,0,34,100.0
431990,2014,28,0,0,28,100.0
431990,2015,19,0,0,19,100.0
431990,2016,19,0,1,20,95.0
431990,2017,14,0,0,14,100.0
431990,2018,14,0,4,18,77.77777777777779
431990,2019,22,0,2,24,91.66666666666666
431990,2020,22,0,0,22,100.0
432000,2012,61,0,0,61,100.0
432000,2013,40,0,0,40,100.0
432000,2014,36,0,0,36,100.0
432000,2015,38,0,0,38,100.0
432000,2016,45,0,0,45,100.0
432000,2017,59,0,0,59,100.0
432000,2018,27,0,0,27,100.0
432000,2019,42,0,0,42,100.0
432000,2020,40,0,0,40,100.0
432010,2012,8,0,0,8,100.0
432010,2013,12,0,0,12,100.0
432010,2014,6,0,0,6,100.0
432010,2015,6,0,0,6,100.0
432010,2016,4,0,0,4,100.0
432010,2017,3,0,0,3,100.0
432010,2018,7,0,0,7,100.0
432010,2019,10,0,0,10,100.0
432010,2020,5,0,0,5,100.0
432020,2012,3,0,0,3,100.0
432020,2013,2,0,2,4,50.0
432020,2014,2,0,0,2,100.0
432020,2015,2,0,0,2,100.0
432020,2016,2,1,0,3,100.0
432020,2017,3,1,0,4,100.0
432020,2018,3,0,0,3,100.0
432020,2019,2,0,0,2,100.0
432020,2020,5,0,0,5,100.0
432023,2013,1,0,1,2,50.0
432023,2014,1,0,0,1,100.0
432023,2016,1,0,0,1,100.0
432023,2018,1,0,0,1,100.0
432023,2019,1,0,0,1,100.0
432023,2020,1,0,0,1,100.0
432026,2012,1,0,0,1,100.0
432026,2014,1,0,0,1,100.0
432026,2015,4,0,0,4,100.0
432026,2016,2,0,0,2,100.0
432026,2017,1,0,0,1,100.0
432026,2018,2,0,0,2,100.0
432026,2019,3,0,0,3,100.0
432026,2020,2,0,0,2,100.0
432030,2012,2,0,0,2,100.0
432030,2013,2,0,0,2,100.0
432030,2014,1,0,0,1,100.0
432030,2016,1,0,0,1,100.0
432030,2017,3,0,0,3,100.0
432030,2018,2,0,0,2,100.0
432032,2015,1,0,0,1,100.0
432032,2018,1,0,0,1,100.0
432032,2020,1,0,0,1,100.0
432035,2012,0,0,2,2,0.0
432035,2014,0,0,3,3,0.0
432035,2015,0,0,3,3,0.0
432035,2016,0,0,1,1,0.0
432035,2018,0,0,3,3,0.0
432035,2019,0,0,2,2,0.0
432035,2020,0,1,4,5,20.0
432040,2012,6,0,0,6,100.0
432040,2013,2,0,0,2,100.0
432040,2014,3,0,0,3,100.0
432040,2015,4,0,0,4,100.0
432040,2016,8,0,0,8,100.0
432040,2017,3,0,0,3,100.0
432040,2018,5,0,0,5,100.0
432040,2019,8,0,0,8,100.0
432040,2020,3,0,0,3,100.0
432045,2012,3,0,0,3,100.0
432045,2014,1,0,0,1,100.0
432045,2015,1,0,0,1,100.0
432045,2018,1,0,0,1,100.0
432050,2012,3,0,0,3,100.0
432050,2013,1,0,0,1,100.0
432050,2014,2,0,1,3,66.66666666666666
432050,2015,3,0,0,3,100.0
432050,2016,2,0,0,2,100.0
432050,2020,1,1,0,2,100.0
432055,2012,0,0,2,2,0.0
432055,2013,0,0,1,1,0.0
432055,2019,0,0,3,3,0.0
432055,2020,0,0,2,2,0.0
432057,2012,1,0,0,1,100.0
432057,2019,1,0,0,1,100.0
432060,2015,1,0,0,1,100.0
432060,2016,1,0,0,1,100.0
432060,2017,1,0,0,1,100.0
432060,2018,2,0,0,2,100.0
432060,2019,1,0,0,1,100.0
432065,2013,2,0,0,2,100.0
432065,2014,1,0,0,1,100.0
432067,2012,2,1,0,3,100.0
432067,2013,2,0,2,4,50.0
432067,2014,1,0,0,1,100.0
432067,2015,2,0,0,2,100.0
432067,2016,4,0,0,4,100.0
432067,2017,2,0,0,2,100.0
432067,2018,1,0,0,1,100.0
432067,2019,2,0,0,2,100.0
432067,2020,1,0,0,1,100.0
432070,2012,9,0,0,9,100.0
432070,2013,4,0,0,4,100.0
432070,2014,4,0,0,4,100.0
432070,2015,3,0,0,3,100.0
432070,2016,5,0,1,6,83.33333333333334
432070,2017,3,0,0,3,100.0
432070,2018,6,0,0,6,100.0
432070,2019,4,0,0,4,100.0
432070,2020,6,0,0,6,100.0
432080,2012,11,0,0,11,100.0
432080,2013,10,0,0,10,100.0
432080,2014,6,0,1,7,85.71428571428571
432080,2015,9,0,0,9,100.0
432080,2016,11,0,0,11,100.0
432080,2017,13,0,0,13,100.0
432080,2018,10,0,0,10,100.0
432080,2019,12,0,2,14,85.71428571428571
432080,2020,10,0,0,10,100.0
432085,2012,1,0,0,1,100.0
432085,2013,0,0,1,1,0.0
432085,2014,0,0,1,1,0.0
432085,2017,0,0,2,2,0.0
432085,2018,0,1,0,1,100.0
432085,2019,0,0,4,4,0.0
432085,2020,0,0,1,1,0.0
432090,2012,7,0,0,7,100.0
432090,2013,8,0,0,8,100.0
432090,2014,8,0,0,8,100.0
432090,2015,9,0,0,9,100.0
432090,2016,5,0,0,5,100.0
432090,2017,7,0,0,7,100.0
432090,2018,4,0,0,4,100.0
432090,2019,4,0,1,5,80.0
432090,2020,4,0,1,5,80.0
432100,2012,5,0,0,5,100.0
432100,2013,2,0,0,2,100.0
432100,2014,1,0,0,1,100.0
432100,2015,4,0,0,4,100.0
432100,2016,4,0,0,4,100.0
432100,2017,3,0,0,3,100.0
432100,2018,7,0,0,7,100.0
432100,2019,3,0,0,3,100.0
432100,2020,5,0,0,5,100.0
432110,2012,5,0,2,7,71.42857142857143
432110,2013,8,0,0,8,100.0
432110,2014,9,0,0,9,100.0
432110,2015,6,0,0,6,100.0
432110,2016,4,0,0,4,100.0
432110,2017,5,0,0,5,100.0
432110,2018,4,0,0,4,100.0
432110,2019,6,0,0,6,100.0
432110,2020,9,0,0,9,100.0
432120,2012,25,0,0,25,100.0
432120,2013,25,0,0,25,100.0
432120,2014,18,0,2,20,90.0
432120,2015,10,0,8,18,55.55555555555556
432120,2016,12,0,0,12,100.0
432120,2017,16,0,2,18,88.88888888888889
432120,2018,19,0,0,19,100.0
432120,2019,16,0,3,19,84.21052631578947
432120,2020,14,0,3,17,82.35294117647058
432130,2012,7,0,1,8,87.5
432130,2013,4,1,1,6,83.33333333333334
432130,2014,14,0,1,15,93.33333333333333
432130,2015,4,1,2,7,71.42857142857143
432130,2016,13,0,0,13,100.0
432130,2017,8,0,0,8,100.0
432130,2018,8,0,0,8,100.0
432130,2019,12,0,1,13,92.3076923076923
432130,2020,7,0,0,7,100.0
432132,2013,1,0,0,1,100.0
432132,2015,1,0,0,1,100.0
432132,2017,1,0,0,1,100.0
432132,2020,1,0,0,1,100.0
432135,2012,1,0,0,1,100.0
432135,2014,1,0,0,1,100.0
432135,2015,2,0,0,2,100.0
432135,2018,2,0,0,2,100.0
432135,2019,1,0,2,3,33.33333333333333
432135,2020,0,0,1,1,0.0
432140,2012,2,1,0,3,100.0
432140,2013,2,0,0,2,100.0
432140,2014,1,0,0,1,100.0
432140,2015,6,0,0,6,100.0
432140,2016,2,0,0,2,100.0
432140,2017,4,1,0,5,100.0
432140,2018,4,0,0,4,100.0
432140,2019,5,0,0,5,100.0
432140,2020,4,0,0,4,100.0
432143,2012,1,0,0,1,100.0
432143,2013,1,0,0,1,100.0
432143,2014,4,0,0,4,100.0
432143,2015,3,0,0,3,100.0
432143,2016,2,0,1,3,66.66666666666666
432143,2017,4,0,0,4,100.0
432143,2018,4,0,2,6,66.66666666666666
432143,2019,1,0,3,4,25.0
432143,2020,0,0,4,4,0.0
432145,2012,6,0,0,6,100.0
432145,2013,8,0,1,9,88.88888888888889
432145,2014,4,0,1,5,80.0
432145,2015,10,0,0,10,100.0
432145,2016,4,0,0,4,100.0
432145,2017,7,0,0,7,100.0
432145,2018,12,0,0,12,100.0
432145,2019,8,0,0,8,100.0
432145,2020,3,0,0,3,100.0
432146,2012,3,0,0,3,100.0
432146,2014,0,0,1,1,0.0
432146,2016,1,0,0,1,100.0
432147,2012,1,0,0,1,100.0
432147,2013,1,0,1,2,50.0
432147,2014,3,0,0,3,100.0
432147,2015,2,0,0,2,100.0
432147,2016,3,0,0,3,100.0
432147,2017,1,0,0,1,100.0
432147,2020,1,0,0,1,100.0
432149,2013,2,0,0,2,100.0
432149,2015,1,0,0,1,100.0
432149,2016,1,0,0,1,100.0
432149,2020,1,0,0,1,100.0
432150,2012,12,0,0,12,100.0
432150,2013,17,0,0,17,100.0
432150,2014,12,0,0,12,100.0
432150,2015,12,0,0,12,100.0
432150,2016,5,0,0,5,100.0
432150,2017,14,0,0,14,100.0
432150,2018,10,0,0,10,100.0
432150,2019,13,0,0,13,100.0
432150,2020,10,0,0,10,100.0
432160,2012,35,0,3,38,92.10526315789474
432160,2013,13,4,8,25,68.0
432160,2014,16,0,0,16,100.0
432160,2015,19,0,0,19,100.0
432160,2016,21,4,0,25,100.0
432160,2017,24,0,0,24,100.0
432160,2018,17,0,0,17,100.0
432160,2019,5,1,9,15,40.0
432160,2020,28,0,0,28,100.0
432162,2015,0,1,0,1,100.0
432162,2020,0,1,0,1,100.0
432163,2013,1,0,0,1,100.0
432163,2014,2,0,0,2,100.0
432163,2018,1,0,0,1,100.0
432163,2020,1,0,0,1,100.0
432166,2012,1,0,0,1,100.0
432166,2013,2,0,1,3,66.66666666666666
432166,2014,3,0,0,3,100.0
432166,2015,3,0,0,3,100.0
432166,2016,6,0,0,6,100.0
432166,2017,1,0,0,1,100.0
432166,2018,2,0,0,2,100.0
432166,2019,1,0,0,1,100.0
432166,2020,3,0,0,3,100.0
432170,2012,8,0,4,12,66.66666666666666
432170,2013,6,0,0,6,100.0
432170,2014,5,0,0,5,100.0
432170,2015,5,0,0,5,100.0
432170,2016,8,0,0,8,100.0
432170,2017,8,0,0,8,100.0
432170,2018,10,0,0,10,100.0
432170,2019,7,0,0,7,100.0
432170,2020,5,0,6,11,45.45454545454545
432180,2012,11,0,0,11,100.0
432180,2013,6,0,0,6,100.0
432180,2014,5,0,0,5,100.0
432180,2015,13,0,0,13,100.0
432180,2016,3,0,0,3,100.0
432180,2017,10,0,0,10,100.0
432180,2018,7,0,0,7,100.0
432180,2019,4,0,0,4,100.0
432180,2020,5,0,0,5,100.0
432183,2012,1,0,1,2,50.0
432183,2013,1,0,0,1,100.0
432183,2014,1,0,0,1,100.0
432183,2015,0,1,0,1,100.0
432183,2016,0,0,1,1,0.0
432183,2017,1,0,0,1,100.0
432185,2012,2,0,0,2,100.0
432185,2014,1,0,0,1,100.0
432185,2015,2,0,0,2,100.0
432185,2016,1,0,0,1,100.0
432185,2017,1,0,0,1,100.0
432185,2019,2,0,0,2,100.0
432185,2020,1,0,0,1,100.0
432190,2012,8,0,0,8,100.0
432190,2013,5,0,0,5,100.0
432190,2014,5,0,0,5,100.0
432190,2015,3,1,2,6,66.66666666666666
432190,2016,0,1,2,3,33.33333333333333
432190,2017,2,1,4,7,42.857142857142854
432190,2018,9,0,1,10,90.0
432190,2019,7,0,0,7,100.0
432190,2020,6,0,0,6,100.0
432195,2012,3,0,0,3,100.0
432195,2013,1,0,0,1,100.0
432195,2014,1,0,0,1,100.0
432195,2015,1,0,0,1,100.0
432195,2016,2,0,0,2,100.0
432195,2017,1,0,0,1,100.0
432195,2019,3,0,0,3,100.0
432195,2020,2,0,0,2,100.0
432200,2012,6,0,0,6,100.0
432200,2013,12,0,0,12,100.0
432200,2014,5,0,0,5,100.0
432200,2015,9,0,0,9,100.0
432200,2016,8,0,0,8,100.0
432200,2017,4,0,0,4,100.0
432200,2018,6,0,0,6,100.0
432200,2019,11,0,0,11,100.0
432200,2020,12,0,0,12,100.0
432210,2012,2,0,0,2,100.0
432210,2013,6,0,1,7,85.71428571428571
432210,2014,4,0,0,4,100.0
432210,2015,1,0,0,1,100.0
432210,2016,3,0,0,3,100.0
432210,2018,3,0,0,3,100.0
432210,2019,2,0,0,2,100.0
432210,2020,1,0,0,1,100.0
432215,2012,4,0,0,4,100.0
432215,2014,2,0,0,2,100.0
432215,2016,1,0,0,1,100.0
432215,2018,2,0,0,2,100.0
432215,2020,3,0,0,3,100.0
432218,2013,2,0,0,2,100.0
432218,2016,1,0,0,1,100.0
432218,2017,1,0,0,1,100.0
432220,2012,5,0,3,8,62.5
432220,2013,3,0,0,3,100.0
432220,2014,11,0,0,11,100.0
432220,2015,3,0,0,3,100.0
432220,2016,6,0,0,6,100.0
432220,2017,7,0,0,7,100.0
432220,2018,6,0,0,6,100.0
432220,2019,8,0,0,8,100.0
432220,2020,6,0,0,6,100.0
432225,2012,2,0,0,2,100.0
432225,2013,1,0,0,1,100.0
432225,2014,1,0,0,1,100.0
432225,2016,5,0,0,5,100.0
432225,2018,1,0,0,1,100.0
432225,2019,1,0,0,1,100.0
432230,2012,1,0,0,1,100.0
432230,2013,3,0,0,3,100.0
432230,2014,4,0,0,4,100.0
432230,2015,2,0,0,2,100.0
432230,2016,2,0,0,2,100.0
432230,2017,1,0,0,1,100.0
432230,2018,5,0,0,5,100.0
432230,2020,3,0,0,3,100.0
432232,2012,1,0,0,1,100.0
432232,2013,1,0,0,1,100.0
432232,2014,0,0,1,1,0.0
432232,2016,1,0,0,1,100.0
432232,2018,1,0,3,4,25.0
432232,2019,0,0,1,1,0.0
432232,2020,0,0,3,3,0.0
432234,2012,2,0,0,2,100.0
432234,2014,1,0,0,1,100.0
432234,2019,1,0,0,1,100.0
432235,2012,0,0,1,1,0.0
432237,2012,2,0,0,2,100.0
432237,2015,1,0,0,1,100.0
432237,2016,1,0,0,1,100.0
432237,2018,1,0,0,1,100.0
432237,2019,2,0,0,2,100.0
432240,2012,42,0,0,42,100.0
432240,2013,55,0,0,55,100.0
432240,2014,44,1,0,45,100.0
432240,2015,54,0,0,54,100.0
432240,2016,41,0,1,42,97.61904761904762
432240,2017,49,0,0,49,100.0
432240,2018,45,0,1,46,97.82608695652173
432240,2019,45,0,0,45,100.0
432240,2020,45,0,0,45,100.0
432250,2012,28,0,0,28,100.0
432250,2013,28,0,5,33,84.84848484848484
432250,2014,18,2,2,22,90.9090909090909
432250,2015,14,1,7,22,68.18181818181817
432250,2016,26,0,0,26,100.0
432250,2017,26,0,0,26,100.0
432250,2018,24,0,0,24,100.0
432250,2019,11,0,0,11,100.0
432250,2020,17,0,0,17,100.0
432252,2013,0,0,2,2,0.0
432252,2016,1,0,0,1,100.0
432252,2017,1,0,0,1,100.0
432252,2018,1,0,0,1,100.0
432252,2019,2,0,0,2,100.0
432252,2020,4,0,0,4,100.0
432253,2012,1,1,2,4,50.0
432253,2014,2,1,3,6,50.0
432253,2015,3,0,1,4,75.0
432253,2016,3,0,0,3,100.0
432253,2017,2,0,0,2,100.0
432253,2018,3,0,0,3,100.0
432253,2019,2,0,0,2,100.0
432253,2020,2,0,0,2,100.0
432254,2012,0,0,1,1,0.0
432254,2013,0,2,1,3,66.66666666666666
432254,2015,1,0,0,1,100.0
432254,2016,1,0,0,1,100.0
432254,2017,1,0,0,1,100.0
432254,2018,2,0,0,2,100.0
432254,2019,2,0,0,2,100.0
432254,2020,1,0,0,1,100.0
432255,2015,1,0,0,1,100.0
432255,2017,1,0,0,1,100.0
432255,2018,2,0,0,2,100.0
432260,2012,17,0,0,17,100.0
432260,2013,10,0,15,25,40.0
432260,2014,23,0,0,23,100.0
432260,2015,21,0,0,21,100.0
432260,2016,22,0,0,22,100.0
432260,2017,12,0,1,13,92.3076923076923
432260,2018,16,0,0,16,100.0
432260,2019,19,0,0,19,100.0
432260,2020,23,0,0,23,100.0
432270,2012,1,0,1,2,50.0
432270,2013,4,2,4,10,60.0
432270,2014,1,0,0,1,100.0
432270,2015,7,0,0,7,100.0
432270,2016,9,0,1,10,90.0
432270,2017,8,0,0,8,100.0
432270,2018,5,0,1,6,83.33333333333334
432270,2019,8,0,2,10,80.0
432270,2020,8,0,0,8,100.0
432280,2012,5,0,0,5,100.0
432280,2013,14,1,0,15,100.0
432280,2014,8,0,0,8,100.0
432280,2015,10,0,0,10,100.0
432280,2016,5,0,0,5,100.0
432280,2017,9,0,0,9,100.0
432280,2018,1,0,0,1,100.0
432280,2019,6,0,2,8,75.0
432280,2020,2,0,0,2,100.0
432285,2012,2,0,0,2,100.0
432285,2013,1,0,0,1,100.0
432285,2017,1,0,0,1,100.0
432285,2020,1,0,0,1,100.0
432290,2012,1,0,0,1,100.0
432290,2013,1,0,0,1,100.0
432290,2014,0,0,1,1,0.0
432290,2016,2,0,0,2,100.0
432290,2017,1,0,0,1,100.0
432290,2019,1,0,0,1,100.0
432300,2012,90,0,1,91,98.9010989010989
432300,2013,89,0,0,89,100.0
432300,2014,88,0,0,88,100.0
432300,2015,83,0,1,84,98.80952380952381
432300,2016,83,1,19,103,81.55339805825243
432300,2017,48,5,43,96,55.208333333333336
432300,2018,96,0,5,101,95.04950495049505
432300,2019,70,5,14,89,84.26966292134831
432300,2020,41,17,20,78,74.35897435897436
432310,2012,5,0,0,5,100.0
432310,2013,1,0,0,1,100.0
432310,2014,2,0,0,2,100.0
432310,2017,2,0,0,2,100.0
432310,2019,2,0,0,2,100.0
432310,2020,1,0,0,1,100.0
432320,2015,1,0,0,1,100.0
432320,2019,2,0,0,2,100.0
432320,2020,1,0,0,1,100.0
432330,2012,2,0,0,2,100.0
432330,2013,1,0,0,1,100.0
432330,2014,1,0,0,1,100.0
432330,2015,1,0,0,1,100.0
432330,2016,1,0,0,1,100.0
432330,2017,2,0,0,2,100.0
432335,2016,1,0,0,1,100.0
432335,2017,1,0,0,1,100.0
432340,2014,1,0,0,1,100.0
432340,2015,2,0,0,2,100.0
432340,2016,1,0,0,1,100.0
432340,2017,1,0,0,1,100.0
432340,2018,1,0,0,1,100.0
432340,2019,1,0,0,1,100.0
432345,2012,1,0,0,1,100.0
432345,2013,5,0,0,5,100.0
432345,2017,1,0,0,1,100.0
432345,2018,2,0,0,2,100.0
432350,2014,2,0,0,2,100.0
432350,2016,2,0,0,2,100.0
432350,2017,1,0,0,1,100.0
432350,2018,1,0,0,1,100.0
432350,2019,1,0,1,2,50.0
432350,2020,1,0,0,1,100.0
432360,2013,0,0,1,1,0.0
432360,2018,3,0,0,3,100.0
432370,2015,1,0,1,2,50.0
432370,2016,0,1,0,1,100.0
432370,2018,3,0,0,3,100.0
432370,2020,1,0,0,1,100.0
432375,2013,1,0,0,1,100.0
432375,2014,1,0,0,1,100.0
432375,2015,1,0,0,1,100.0
432375,2016,1,0,0,1,100.0
432375,2017,1,0,0,1,100.0
432375,2019,1,0,0,1,100.0
432375,2020,1,0,0,1,100.0
432377,2012,1,0,0,1,100.0
432377,2016,0,0,1,1,0.0
432377,2017,1,0,0,1,100.0
432377,2018,1,0,0,1,100.0
432380,2012,5,0,0,5,100.0
432380,2013,6,0,0,6,100.0
432380,2014,3,0,0,3,100.0
432380,2015,3,0,2,5,60.0
432380,2016,3,0,0,3,100.0
432380,2017,6,0,0,6,100.0
432380,2018,3,0,0,3,100.0
432380,2019,5,0,0,5,100.0
432380,2020,6,0,0,6,100.0
500020,2012,3,0,0,3,100.0
500020,2013,3,0,0,3,100.0
500020,2014,0,0,1,1,0.0
500020,2015,0,2,3,5,40.0
500020,2016,1,1,4,6,33.33333333333333
500020,2017,0,0,6,6,0.0
500020,2018,6,0,0,6,100.0
500020,2019,4,0,0,4,100.0
500020,2020,7,0,0,7,100.0
500025,2012,2,0,0,2,100.0
500025,2015,1,0,0,1,100.0
500025,2016,0,0,1,1,0.0
500025,2018,4,0,0,4,100.0
500025,2019,1,0,0,1,100.0
500025,2020,1,0,0,1,100.0
500060,2012,12,4,1,17,94.11764705882352
500060,2013,18,0,0,18,100.0
500060,2014,25,0,1,26,96.15384615384616
500060,2015,27,1,0,28,100.0
500060,2016,31,0,0,31,100.0
500060,2017,19,0,0,19,100.0
500060,2018,25,0,0,25,100.0
500060,2019,23,0,0,23,100.0
500060,2020,32,0,0,32,100.0
500070,2012,11,1,1,13,92.3076923076923
500070,2013,5,3,0,8,100.0
500070,2014,0,5,3,8,62.5
500070,2015,5,1,2,8,75.0
500070,2016,5,0,0,5,100.0
500070,2017,11,0,0,11,100.0
500070,2018,9,0,0,9,100.0
500070,2019,8,0,1,9,88.88888888888889
500070,2020,16,0,0,16,100.0
500080,2012,3,0,2,5,60.0
500080,2013,0,1,1,2,50.0
500080,2016,0,0,5,5,0.0
500080,2017,1,0,0,1,100.0
500080,2018,0,0,1,1,0.0
500080,2019,0,0,3,3,0.0
500080,2020,2,0,0,2,100.0
500085,2012,1,0,0,1,100.0
500085,2013,7,0,1,8,87.5
500085,2014,7,0,0,7,100.0
500085,2015,4,0,0,4,100.0
500085,2016,4,0,0,4,100.0
500085,2017,2,0,0,2,100.0
500085,2018,2,0,0,2,100.0
500085,2019,3,0,0,3,100.0
500085,2020,3,0,0,3,100.0
500090,2012,4,0,0,4,100.0
500090,2013,7,0,0,7,100.0
500090,2014,7,0,0,7,100.0
500090,2015,3,0,0,3,100.0
500090,2016,8,0,0,8,100.0
500090,2017,5,0,0,5,100.0
500090,2018,2,0,0,2,100.0
500090,2019,3,0,0,3,100.0
500090,2020,7,0,0,7,100.0
500100,2012,6,0,0,6,100.0
500100,2013,12,0,0,12,100.0
500100,2014,5,0,0,5,100.0
500100,2015,13,0,0,13,100.0
500100,2016,7,0,0,7,100.0
500100,2017,3,0,0,3,100.0
500100,2018,13,0,0,13,100.0
500100,2019,13,0,0,13,100.0
500100,2020,9,0,0,9,100.0
500110,2012,20,0,0,20,100.0
500110,2013,16,5,0,21,100.0
500110,2014,18,0,0,18,100.0
500110,2015,17,0,0,17,100.0
500110,2016,17,0,0,17,100.0
500110,2017,20,0,0,20,100.0
500110,2018,16,0,0,16,100.0
500110,2019,28,0,0,28,100.0
500110,2020,16,0,0,16,100.0
500124,2012,6,0,0,6,100.0
500124,2013,3,0,0,3,100.0
500124,2014,4,0,0,4,100.0
500124,2015,1,0,0,1,100.0
500124,2016,2,0,0,2,100.0
500124,2017,4,0,1,5,80.0
500124,2018,5,0,1,6,83.33333333333334
500124,2019,2,0,2,4,50.0
500124,2020,3,0,0,3,100.0
500150,2012,3,0,1,4,75.0
500150,2013,2,0,0,2,100.0
500150,2014,3,0,0,3,100.0
500150,2015,3,0,0,3,100.0
500150,2016,6,0,0,6,100.0
500150,2017,4,0,0,4,100.0
500150,2018,1,0,0,1,100.0
500150,2019,3,0,0,3,100.0
500150,2020,2,0,1,3,66.66666666666666
500190,2012,10,1,0,11,100.0
500190,2013,10,0,0,10,100.0
500190,2014,4,3,0,7,100.0
500190,2015,0,6,0,6,100.0
500190,2016,9,0,0,9,100.0
500190,2017,2,0,1,3,66.66666666666666
500190,2018,10,0,0,10,100.0
500190,2019,15,0,0,15,100.0
500190,2020,7,0,0,7,100.0
500200,2012,2,0,2,4,50.0
500200,2013,7,0,0,7,100.0
500200,2014,4,0,0,4,100.0
500200,2015,4,0,0,4,100.0
500200,2016,6,0,0,6,100.0
500200,2017,1,0,4,5,20.0
500200,2018,0,0,3,3,0.0
500200,2019,0,0,3,3,0.0
500200,2020,0,0,3,3,0.0
500210,2012,14,0,0,14,100.0
500210,2013,9,0,0,9,100.0
500210,2014,10,0,0,10,100.0
500210,2015,7,0,0,7,100.0
500210,2016,9,3,1,13,92.3076923076923
500210,2017,4,0,1,5,80.0
500210,2018,14,0,0,14,100.0
500210,2019,7,0,0,7,100.0
500210,2020,8,0,2,10,80.0
500215,2012,3,0,0,3,100.0
500215,2013,1,0,0,1,100.0
500215,2015,5,0,0,5,100.0
500215,2016,3,0,0,3,100.0
500215,2017,5,0,0,5,100.0
500215,2018,2,0,0,2,100.0
500215,2019,4,0,0,4,100.0
500215,2020,2,0,0,2,100.0
500220,2012,6,0,0,6,100.0
500220,2013,7,0,0,7,100.0
500220,2014,6,0,0,6,100.0
500220,2015,1,0,1,2,50.0
500220,2016,1,0,6,7,14.285714285714285
500220,2017,6,0,0,6,100.0
500220,2018,8,0,0,8,100.0
500220,2019,4,0,0,4,100.0
500220,2020,6,0,2,8,75.0
500230,2012,10,0,0,10,100.0
500230,2013,5,0,0,5,100.0
500230,2014,2,0,0,2,100.0
500230,2015,7,0,0,7,100.0
500230,2016,3,0,0,3,100.0
500230,2017,3,0,0,3,100.0
500230,2018,4,0,0,4,100.0
500230,2019,2,0,0,2,100.0
500230,2020,5,0,0,5,100.0
500240,2012,9,0,1,10,90.0
500240,2013,12,0,1,13,92.3076923076923
500240,2014,7,0,0,7,100.0
500240,2015,8,0,2,10,80.0
500240,2016,3,0,6,9,33.33333333333333
500240,2017,1,0,6,7,14.285714285714285
500240,2018,0,1,6,7,14.285714285714285
500240,2019,1,0,8,9,11.11111111111111
500240,2020,10,0,12,22,45.45454545454545
500260,2012,5,0,0,5,100.0
500260,2013,5,0,0,5,100.0
500260,2014,5,0,0,5,100.0
500260,2015,5,0,0,5,100.0
500260,2016,5,1,0,6,100.0
500260,2017,8,0,0,8,100.0
500260,2018,3,0,0,3,100.0
500260,2019,7,0,0,7,100.0
500260,2020,3,0,0,3,100.0
500270,2012,235,4,30,269,88.84758364312268
500270,2013,263,0,40,303,86.79867986798679
500270,2014,241,5,37,283,86.92579505300353
500270,2015,196,3,49,248,80.24193548387096
500270,2016,256,1,33,290,88.62068965517241
500270,2017,238,0,6,244,97.54098360655738
500270,2018,258,0,8,266,96.99248120300751
500270,2019,259,0,7,266,97.36842105263158
500270,2020,267,2,16,285,94.38596491228071
500280,2012,2,0,0,2,100.0
500280,2013,1,0,0,1,100.0
500280,2014,1,0,0,1,100.0
500280,2015,3,0,0,3,100.0
500280,2016,2,0,0,2,100.0
500280,2017,2,0,1,3,66.66666666666666
500280,2020,1,0,0,1,100.0
500290,2012,9,0,0,9,100.0
500290,2013,7,0,0,7,100.0
500290,2014,6,0,0,6,100.0
500290,2015,8,0,0,8,100.0
500290,2016,11,0,0,11,100.0
500290,2017,8,0,0,8,100.0
500290,2018,7,0,0,7,100.0
500290,2019,7,0,0,7,100.0
500290,2020,16,0,0,16,100.0
500295,2012,4,0,0,4,100.0
500295,2013,3,0,0,3,100.0
500295,2014,6,0,0,6,100.0
500295,2015,10,0,0,10,100.0
500295,2016,9,0,0,9,100.0
500295,2017,1,0,0,1,100.0
500295,2018,2,0,0,2,100.0
500295,2019,12,0,0,12,100.0
500295,2020,8,0,0,8,100.0
500310,2013,2,0,0,2,100.0
500310,2014,1,1,1,3,66.66666666666666
500310,2015,0,0,1,1,0.0
500310,2016,0,1,0,1,100.0
500310,2017,2,0,0,2,100.0
500310,2018,1,0,0,1,100.0
500310,2020,0,0,1,1,0.0
500315,2012,12,0,0,12,100.0
500315,2013,13,0,0,13,100.0
500315,2014,14,0,0,14,100.0
500315,2015,8,0,1,9,88.88888888888889
500315,2016,8,0,1,9,88.88888888888889
500315,2017,8,0,1,9,88.88888888888889
500315,2018,7,0,0,7,100.0
500315,2019,14,0,0,14,100.0
500315,2020,12,0,0,12,100.0
500320,2012,50,0,2,52,96.15384615384616
500320,2013,43,0,1,44,97.72727272727273
500320,2014,41,0,0,41,100.0
500320,2015,30,0,18,48,62.5
500320,2016,37,0,7,44,84.0909090909091
500320,2017,30,0,5,35,85.71428571428571
500320,2018,40,0,1,41,97.5609756097561
500320,2019,43,0,2,45,95.55555555555556
500320,2020,52,0,0,52,100.0
500325,2012,4,0,0,4,100.0
500325,2013,5,0,0,5,100.0
500325,2014,10,0,0,10,100.0
500325,2015,8,0,0,8,100.0
500325,2016,10,0,0,10,100.0
500325,2017,4,0,0,4,100.0
500325,2018,10,0,0,10,100.0
500325,2019,10,0,0,10,100.0
500325,2020,6,0,0,6,100.0
500330,2012,15,0,0,15,100.0
500330,2013,12,0,0,12,100.0
500330,2014,13,0,0,13,100.0
500330,2015,19,0,0,19,100.0
500330,2016,13,0,0,13,100.0
500330,2017,4,0,0,4,100.0
500330,2018,11,0,0,11,100.0
500330,2019,8,0,0,8,100.0
500330,2020,15,0,0,15,100.0
500345,2012,5,0,0,5,100.0
500345,2013,9,0,0,9,100.0
500345,2014,5,0,2,7,71.42857142857143
500345,2015,0,1,3,4,25.0
500345,2016,3,0,0,3,100.0
500345,2017,4,0,0,4,100.0
500345,2018,7,0,0,7,100.0
500345,2020,5,0,0,5,100.0
500348,2012,6,0,0,6,100.0
500348,2013,5,0,0,5,100.0
500348,2014,5,0,0,5,100.0
500348,2015,1,0,2,3,33.33333333333333
500348,2016,0,0,3,3,0.0
500348,2017,2,0,3,5,40.0
500348,2018,2,0,2,4,50.0
500348,2019,2,0,1,3,66.66666666666666
500348,2020,1,0,5,6,16.666666666666664
500350,2013,1,0,0,1,100.0
500350,2014,1,0,0,1,100.0
500350,2015,2,0,0,2,100.0
500350,2016,4,0,0,4,100.0
500350,2017,2,0,1,3,66.66666666666666
500350,2018,3,0,0,3,100.0
500350,2019,4,0,0,4,100.0
500350,2020,2,0,2,4,50.0
500370,2012,70,0,6,76,92.10526315789474
500370,2013,80,0,0,80,100.0
500370,2014,91,0,6,97,93.81443298969072
500370,2015,54,0,16,70,77.14285714285715
500370,2016,83,0,0,83,100.0
500370,2017,76,0,0,76,100.0
500370,2018,78,0,2,80,97.5
500370,2019,68,0,0,68,100.0
500370,2020,93,0,0,93,100.0
500375,2012,7,0,0,7,100.0
500375,2013,6,0,0,6,100.0
500375,2014,6,0,3,9,66.66666666666666
500375,2015,0,0,2,2,0.0
500375,2016,1,0,0,1,100.0
500375,2017,6,0,0,6,100.0
500375,2018,3,0,0,3,100.0
500375,2019,1,0,0,1,100.0
500375,2020,2,0,0,2,100.0
500380,2012,6,0,0,6,100.0
500380,2013,5,0,1,6,83.33333333333334
500380,2014,8,0,0,8,100.0
500380,2015,7,0,0,7,100.0
500380,2016,13,0,0,13,100.0
500380,2017,4,0,1,5,80.0
500380,2018,4,0,0,4,100.0
500380,2019,4,0,1,5,80.0
500380,2020,10,0,0,10,100.0
500390,2013,2,0,0,2,100.0
500390,2015,1,0,0,1,100.0
500390,2016,3,0,0,3,100.0
500390,2018,3,0,0,3,100.0
500390,2019,2,0,0,2,100.0
500390,2020,3,0,0,3,100.0
500400,2012,3,0,0,3,100.0
500400,2013,2,0,1,3,66.66666666666666
500400,2014,1,0,1,2,50.0
500400,2015,1,0,1,2,50.0
500400,2016,0,0,2,2,0.0
500400,2017,1,0,1,2,50.0
500400,2018,2,0,0,2,100.0
500400,2019,1,0,0,1,100.0
500400,2020,4,0,0,4,100.0
500410,2012,4,0,0,4,100.0
500410,2013,7,0,1,8,87.5
500410,2014,4,0,0,4,100.0
500410,2015,2,0,1,3,66.66666666666666
500410,2016,5,0,0,5,100.0
500410,2017,3,0,0,3,100.0
500410,2018,2,0,0,2,100.0
500410,2019,0,0,2,2,0.0
500410,2020,0,0,3,3,0.0
500430,2012,6,0,3,9,66.66666666666666
500430,2013,4,0,0,4,100.0
500430,2014,8,0,0,8,100.0
500430,2015,2,0,0,2,100.0
500430,2016,5,0,1,6,83.33333333333334
500430,2017,4,0,0,4,100.0
500430,2018,5,0,0,5,100.0
500430,2019,4,0,0,4,100.0
500430,2020,5,0,0,5,100.0
500440,2012,2,0,0,2,100.0
500440,2013,1,0,1,2,50.0
500440,2014,1,0,1,2,50.0
500440,2016,2,0,0,2,100.0
500440,2017,2,0,4,6,33.33333333333333
500440,2018,1,0,0,1,100.0
500440,2020,2,0,0,2,100.0
500450,2012,1,0,3,4,25.0
500450,2013,6,0,0,6,100.0
500450,2014,4,0,0,4,100.0
500450,2015,0,1,5,6,16.666666666666664
500450,2016,5,0,2,7,71.42857142857143
500450,2017,9,0,0,9,100.0
500450,2018,10,0,1,11,90.9090909090909
500450,2019,3,0,0,3,100.0
500450,2020,5,0,0,5,100.0
500460,2012,4,0,0,4,100.0
500460,2013,3,0,0,3,100.0
500460,2014,5,0,0,5,100.0
500460,2015,1,0,3,4,25.0
500460,2016,0,3,2,5,60.0
500460,2017,0,0,10,10,0.0
500460,2018,3,0,0,3,100.0
500460,2019,4,0,4,8,50.0
500460,2020,0,1,7,8,12.5
500470,2012,7,0,0,7,100.0
500470,2013,11,0,0,11,100.0
500470,2014,10,0,0,10,100.0
500470,2015,8,0,0,8,100.0
500470,2016,3,0,1,4,75.0
500470,2017,5,0,0,5,100.0
500470,2018,9,0,0,9,100.0
500470,2019,10,0,0,10,100.0
500470,2020,4,0,0,4,100.0
500480,2012,4,0,0,4,100.0
500480,2013,9,0,0,9,100.0
500480,2014,3,0,0,3,100.0
500480,2016,0,0,1,1,0.0
500480,2017,0,0,1,1,0.0
500480,2018,3,0,0,3,100.0
500480,2019,2,0,0,2,100.0
500480,2020,5,0,0,5,100.0
500490,2012,1,0,0,1,100.0
500490,2013,1,0,0,1,100.0
500490,2014,1,0,1,2,50.0
500490,2015,0,0,2,2,0.0
500490,2016,0,0,1,1,0.0
500490,2017,1,0,0,1,100.0
500490,2018,2,0,0,2,100.0
500490,2019,0,0,2,2,0.0
500490,2020,0,0,2,2,0.0
500500,2012,8,0,0,8,100.0
500500,2013,10,0,0,10,100.0
500500,2014,8,0,0,8,100.0
500500,2015,8,0,0,8,100.0
500500,2016,10,0,0,10,100.0
500500,2017,6,0,0,6,100.0
500500,2018,12,0,0,12,100.0
500500,2019,5,0,6,11,45.45454545454545
500500,2020,16,0,0,16,100.0
500510,2012,5,0,0,5,100.0
500510,2016,0,0,4,4,0.0
500510,2017,0,1,0,1,100.0
500510,2018,1,0,0,1,100.0
500510,2019,1,0,0,1,100.0
500515,2012,6,0,0,6,100.0
500515,2013,3,0,0,3,100.0
500515,2014,3,0,0,3,100.0
500515,2015,4,0,0,4,100.0
500515,2016,5,0,0,5,100.0
500515,2017,5,0,0,5,100.0
500515,2018,5,0,0,5,100.0
500515,2019,2,0,0,2,100.0
500515,2020,2,0,0,2,100.0
500520,2012,3,0,0,3,100.0
500520,2013,5,0,0,5,100.0
500520,2014,8,0,0,8,100.0
500520,2015,6,0,0,6,100.0
500520,2016,5,0,1,6,83.33333333333334
500520,2017,5,0,1,6,83.33333333333334
500520,2018,6,0,0,6,100.0
500520,2019,4,0,0,4,100.0
500520,2020,12,0,0,12,100.0
500525,2013,3,0,0,3,100.0
500525,2015,2,0,0,2,100.0
500525,2016,2,0,0,2,100.0
500525,2017,6,0,0,6,100.0
500525,2018,2,0,0,2,100.0
500525,2019,2,0,0,2,100.0
500525,2020,2,0,0,2,100.0
500540,2012,9,0,0,9,100.0
500540,2013,15,0,0,15,100.0
500540,2014,15,0,0,15,100.0
500540,2015,13,0,0,13,100.0
500540,2016,18,0,0,18,100.0
500540,2017,11,0,0,11,100.0
500540,2018,17,0,0,17,100.0
500540,2019,14,0,0,14,100.0
500540,2020,15,0,0,15,100.0
500560,2012,9,1,1,11,90.9090909090909
500560,2013,9,0,0,9,100.0
500560,2014,5,0,6,11,45.45454545454545
500560,2015,5,0,2,7,71.42857142857143
500560,2016,4,1,8,13,38.46153846153847
500560,2017,10,0,0,10,100.0
500560,2018,11,0,0,11,100.0
500560,2019,14,0,6,20,70.0
500560,2020,9,0,1,10,90.0
500568,2012,8,0,1,9,88.88888888888889
500568,2013,9,0,0,9,100.0
500568,2014,2,1,3,6,50.0
500568,2015,3,2,3,8,62.5
500568,2016,7,0,0,7,100.0
500568,2017,1,0,0,1,100.0
500568,2018,4,0,0,4,100.0
500568,2019,4,0,0,4,100.0
500568,2020,7,0,0,7,100.0
500570,2012,13,0,0,13,100.0
500570,2013,16,0,4,20,80.0
500570,2014,23,0,0,23,100.0
500570,2015,19,0,0,19,100.0
500570,2016,21,0,1,22,95.45454545454545
500570,2017,14,0,1,15,93.33333333333333
500570,2018,16,0,0,16,100.0
500570,2019,21,1,0,22,100.0
500570,2020,17,0,0,17,100.0
500580,2012,2,0,0,2,100.0
500580,2013,3,0,0,3,100.0
500580,2014,3,0,0,3,100.0
500580,2015,4,0,0,4,100.0
500580,2016,3,0,0,3,100.0
500580,2017,5,0,0,5,100.0
500580,2018,3,0,0,3,100.0
500580,2019,2,0,0,2,100.0
500580,2020,6,0,0,6,100.0
500600,2012,3,0,4,7,42.857142857142854
500600,2013,8,0,0,8,100.0
500600,2014,3,0,0,3,100.0
500600,2015,11,0,0,11,100.0
500600,2016,6,0,0,6,100.0
500600,2017,3,0,4,7,42.857142857142854
500600,2018,2,0,3,5,40.0
500600,2019,0,0,5,5,0.0
500600,2020,8,0,0,8,100.0
500620,2012,10,0,0,10,100.0
500620,2013,18,0,0,18,100.0
500620,2014,15,0,0,15,100.0
500620,2015,19,0,0,19,100.0
500620,2016,16,0,2,18,88.88888888888889
500620,2017,17,0,1,18,94.44444444444444
500620,2018,14,0,0,14,100.0
500620,2019,13,0,1,14,92.85714285714286
500620,2020,2,5,11,18,38.88888888888889
500625,2012,5,0,0,5,100.0
500625,2013,1,0,0,1,100.0
500625,2014,6,0,0,6,100.0
500625,2015,0,1,1,2,50.0
500625,2016,0,0,2,2,0.0
500625,2018,0,0,1,1,0.0
500625,2019,0,0,2,2,0.0
500627,2013,0,0,1,1,0.0
500627,2014,0,0,1,1,0.0
500627,2015,0,0,1,1,0.0
500627,2016,1,0,1,2,50.0
500627,2017,0,1,1,2,50.0
500627,2020,0,0,2,2,0.0
500630,2012,19,0,0,19,100.0
500630,2013,8,0,0,8,100.0
500630,2014,8,2,5,15,66.66666666666666
500630,2015,15,0,7,22,68.18181818181817
500630,2016,2,1,27,30,10.0
500630,2017,2,0,12,14,14.285714285714285
500630,2018,10,0,2,12,83.33333333333334
500630,2019,11,0,0,11,100.0
500630,2020,12,0,1,13,92.3076923076923
500635,2012,11,0,0,11,100.0
500635,2013,5,0,0,5,100.0
500635,2014,5,0,0,5,100.0
500635,2015,7,0,1,8,87.5
500635,2016,6,0,1,7,85.71428571428571
500635,2017,0,1,5,6,16.666666666666664
500635,2018,6,0,0,6,100.0
500635,2019,7,0,1,8,87.5
500635,2020,0,1,9,10,10.0
500640,2012,1,0,0,1,100.0
500640,2013,9,0,0,9,100.0
500640,2014,3,0,0,3,100.0
500640,2015,1,0,0,1,100.0
500640,2016,3,0,0,3,100.0
500640,2017,1,0,0,1,100.0
500640,2018,2,0,0,2,100.0
500640,2019,3,0,0,3,100.0
500640,2020,5,0,0,5,100.0
500660,2012,47,1,2,50,96.0
500660,2013,34,0,0,34,100.0
500660,2014,30,0,0,30,100.0
500660,2015,41,0,0,41,100.0
500660,2016,44,1,1,46,97.82608695652173
500660,2017,41,0,0,41,100.0
500660,2018,24,0,1,25,96.0
500660,2019,48,0,0,48,100.0
500660,2020,34,0,0,34,100.0
500690,2012,5,0,0,5,100.0
500690,2013,10,0,0,10,100.0
500690,2014,2,0,0,2,100.0
500690,2015,5,0,0,5,100.0
500690,2016,6,0,1,7,85.71428571428571
500690,2017,5,0,0,5,100.0
500690,2018,2,0,0,2,100.0
500690,2019,5,0,0,5,100.0
500690,2020,6,0,0,6,100.0
500710,2012,6,0,0,6,100.0
500710,2013,5,0,0,5,100.0
500710,2014,7,0,0,7,100.0
500710,2015,11,0,2,13,84.61538461538461
500710,2016,3,0,4,7,42.857142857142854
500710,2017,5,0,0,5,100.0
500710,2018,4,0,0,4,100.0
500710,2019,1,2,3,6,50.0
500710,2020,0,0,4,4,0.0
500720,2012,9,0,0,9,100.0
500720,2013,14,0,0,14,100.0
500720,2014,6,0,0,6,100.0
500720,2015,10,0,0,10,100.0
500720,2016,5,0,4,9,55.55555555555556
500720,2017,6,0,8,14,42.857142857142854
500720,2018,0,0,9,9,0.0
500720,2019,1,0,10,11,9.090909090909092
500720,2020,1,0,11,12,8.333333333333332
500730,2012,3,0,0,3,100.0
500730,2014,2,0,0,2,100.0
500730,2016,1,0,0,1,100.0
500730,2018,1,0,0,1,100.0
500730,2019,2,0,0,2,100.0
500730,2020,3,0,0,3,100.0
500740,2012,12,0,0,12,100.0
500740,2013,10,0,0,10,100.0
500740,2014,7,0,0,7,100.0
500740,2015,6,0,0,6,100.0
500740,2016,8,0,0,8,100.0
500740,2017,6,0,0,6,100.0
500740,2018,10,0,0,10,100.0
500740,2019,7,0,0,7,100.0
500740,2020,4,0,0,4,100.0
500750,2012,3,0,1,4,75.0
500750,2014,4,0,1,5,80.0
500750,2015,0,0,2,2,0.0
500750,2017,0,0,1,1,0.0
500750,2019,0,0,2,2,0.0
500750,2020,0,0,1,1,0.0
500755,2012,3,0,0,3,100.0
500755,2014,3,0,0,3,100.0
500755,2015,1,0,0,1,100.0
500755,2016,2,0,0,2,100.0
500755,2017,3,0,0,3,100.0
500755,2018,1,0,0,1,100.0
500755,2019,1,0,2,3,33.33333333333333
500755,2020,3,0,0,3,100.0
500769,2012,9,0,0,9,100.0
500769,2013,5,0,0,5,100.0
500769,2014,8,0,0,8,100.0
500769,2015,6,0,0,6,100.0
500769,2016,10,0,0,10,100.0
500769,2017,13,0,0,13,100.0
500769,2018,9,0,0,9,100.0
500769,2019,6,0,0,6,100.0
500769,2020,10,0,0,10,100.0
500770,2012,6,0,0,6,100.0
500770,2013,6,0,0,6,100.0
500770,2014,7,0,0,7,100.0
500770,2015,9,0,0,9,100.0
500770,2016,5,0,0,5,100.0
500770,2018,5,0,0,5,100.0
500770,2019,4,0,0,4,100.0
500770,2020,4,0,0,4,100.0
500780,2012,1,0,0,1,100.0
500780,2013,1,0,1,2,50.0
500780,2014,1,0,0,1,100.0
500780,2015,1,1,1,3,66.66666666666666
500780,2016,0,0,6,6,0.0
500780,2017,0,0,4,4,0.0
500780,2018,3,0,0,3,100.0
500780,2019,1,1,1,3,66.66666666666666
500780,2020,2,0,0,2,100.0
500790,2012,13,0,0,13,100.0
500790,2013,11,0,0,11,100.0
500790,2014,13,0,1,14,92.85714285714286
500790,2015,11,0,0,11,100.0
500790,2016,15,0,0,15,100.0
500790,2017,6,0,0,6,100.0
500790,2018,9,0,0,9,100.0
500790,2019,11,0,0,11,100.0
500790,2020,14,0,0,14,100.0
500793,2012,8,0,0,8,100.0
500793,2013,9,0,0,9,100.0
500793,2014,2,0,0,2,100.0
500793,2015,6,1,0,7,100.0
500793,2016,10,0,0,10,100.0
500793,2017,6,0,0,6,100.0
500793,2018,6,0,0,6,100.0
500793,2019,2,0,0,2,100.0
500793,2020,6,0,4,10,60.0
500795,2012,4,0,0,4,100.0
500795,2013,10,0,0,10,100.0
500795,2014,4,0,0,4,100.0
500795,2015,5,0,0,5,100.0
500795,2016,4,0,1,5,80.0
500795,2017,0,0,2,2,0.0
500795,2018,2,1,5,8,37.5
500795,2019,0,0,5,5,0.0
500795,2020,1,2,5,8,37.5
500797,2013,1,0,0,1,100.0
500797,2014,3,0,0,3,100.0
500797,2015,1,0,1,2,50.0
500797,2016,1,0,0,1,100.0
500797,2017,1,0,0,1,100.0
500797,2019,1,0,0,1,100.0
500797,2020,3,0,0,3,100.0
500800,2012,9,0,1,10,90.0
500800,2013,2,0,0,2,100.0
500800,2014,2,0,2,4,50.0
500800,2015,1,1,0,2,100.0
500800,2016,5,0,1,6,83.33333333333334
500800,2017,0,0,4,4,0.0
500800,2018,0,0,3,3,0.0
500800,2019,0,0,4,4,0.0
500800,2020,1,0,5,6,16.666666666666664
500830,2012,37,0,1,38,97.36842105263158
500830,2013,55,0,0,55,100.0
500830,2014,49,0,0,49,100.0
500830,2015,38,0,0,38,100.0
500830,2016,36,0,0,36,100.0
500830,2017,40,0,0,40,100.0
500830,2018,40,0,0,40,100.0
500830,2019,43,0,0,43,100.0
500830,2020,34,0,0,34,100.0
500840,2013,2,0,0,2,100.0
500840,2015,1,0,0,1,100.0
500840,2016,1,0,0,1,100.0
500840,2017,4,0,0,4,100.0
500840,2018,1,0,0,1,100.0
500840,2019,0,0,1,1,0.0
500840,2020,0,0,2,2,0.0
510000,2012,0,0,3,3,0.0
510000,2013,0,0,1,1,0.0
510000,2014,0,0,1,1,0.0
510010,2012,3,0,1,4,75.0
510010,2013,2,0,0,2,100.0
510010,2014,1,0,0,1,100.0
510010,2015,1,0,0,1,100.0
510010,2016,1,0,0,1,100.0
510010,2017,3,0,1,4,75.0
510010,2020,0,0,2,2,0.0
510020,2012,5,0,0,5,100.0
510020,2013,7,0,0,7,100.0
510020,2014,12,0,0,12,100.0
510020,2015,9,0,0,9,100.0
510020,2016,6,0,0,6,100.0
510020,2017,10,0,0,10,100.0
510020,2018,10,0,0,10,100.0
510020,2019,8,0,0,8,100.0
510020,2020,14,0,0,14,100.0
510025,2012,20,2,1,23,95.65217391304348
510025,2013,22,0,3,25,88.0
510025,2014,25,1,2,28,92.85714285714286
510025,2015,18,1,2,21,90.47619047619048
510025,2016,12,1,3,16,81.25
510025,2017,13,0,0,13,100.0
510025,2018,15,0,0,15,100.0
510025,2019,7,3,6,16,62.5
510025,2020,8,2,9,19,52.63157894736842
510030,2012,4,1,0,5,100.0
510030,2013,3,0,3,6,50.0
510030,2014,6,0,2,8,75.0
510030,2015,6,0,1,7,85.71428571428571
510030,2016,8,0,1,9,88.88888888888889
510030,2017,8,0,0,8,100.0
510030,2018,4,0,0,4,100.0
510030,2019,6,0,0,6,100.0
510030,2020,7,0,0,7,100.0
510035,2012,0,0,1,1,0.0
510035,2013,0,1,0,1,100.0
510035,2015,1,0,0,1,100.0
510035,2016,1,0,0,1,100.0
510035,2018,0,0,2,2,0.0
510035,2020,3,0,0,3,100.0
510040,2012,3,0,2,5,60.0
510040,2013,0,2,4,6,33.33333333333333
510040,2014,2,0,0,2,100.0
510040,2015,2,0,0,2,100.0
510040,2016,4,0,0,4,100.0
510040,2017,4,0,0,4,100.0
510040,2018,4,0,0,4,100.0
510040,2019,4,0,0,4,100.0
510040,2020,4,0,0,4,100.0
510050,2013,0,0,1,1,0.0
510050,2014,2,0,0,2,100.0
510050,2015,3,1,1,5,80.0
510050,2016,3,0,0,3,100.0
510050,2017,3,0,0,3,100.0
510050,2018,3,0,0,3,100.0
510050,2019,6,0,0,6,100.0
510050,2020,1,0,0,1,100.0
510060,2012,1,0,0,1,100.0
510060,2013,3,0,0,3,100.0
510060,2014,2,0,0,2,100.0
510060,2015,3,0,0,3,100.0
510060,2016,3,0,1,4,75.0
510060,2017,2,0,0,2,100.0
510060,2018,4,0,0,4,100.0
510060,2019,2,0,0,2,100.0
510060,2020,4,0,0,4,100.0
510080,2012,1,0,0,1,100.0
510080,2013,4,0,0,4,100.0
510080,2014,8,0,0,8,100.0
510080,2017,1,0,0,1,100.0
510080,2018,3,0,0,3,100.0
510080,2019,2,0,0,2,100.0
510100,2012,1,0,0,1,100.0
510100,2014,0,1,0,1,100.0
510100,2016,2,0,0,2,100.0
510100,2017,1,0,0,1,100.0
510100,2018,1,0,0,1,100.0
510100,2019,1,0,0,1,100.0
510100,2020,2,0,0,2,100.0
510120,2016,0,0,1,1,0.0
510120,2019,1,0,0,1,100.0
510125,2012,6,0,1,7,85.71428571428571
510125,2013,3,0,0,3,100.0
510125,2014,7,0,0,7,100.0
510125,2015,5,0,0,5,100.0
510125,2016,6,0,0,6,100.0
510125,2017,5,0,0,5,100.0
510125,2018,3,0,0,3,100.0
510125,2019,6,0,0,6,100.0
510125,2020,9,0,0,9,100.0
510130,2012,3,0,0,3,100.0
510130,2013,3,0,0,3,100.0
510130,2014,2,0,0,2,100.0
510130,2015,6,0,0,6,100.0
510130,2016,4,0,0,4,100.0
510130,2017,5,0,0,5,100.0
510130,2018,3,0,0,3,100.0
510130,2019,5,0,0,5,100.0
510130,2020,7,0,0,7,100.0
510140,2012,5,0,0,5,100.0
510140,2013,6,0,0,6,100.0
510140,2014,9,0,0,9,100.0
510140,2015,6,0,0,6,100.0
510140,2016,5,0,0,5,100.0
510140,2017,2,0,0,2,100.0
510140,2018,1,1,0,2,100.0
510140,2019,0,1,0,1,100.0
510140,2020,15,0,0,15,100.0
510160,2012,0,0,1,1,0.0
510160,2013,1,0,2,3,33.33333333333333
510160,2014,1,0,2,3,33.33333333333333
510160,2015,2,0,0,2,100.0
510160,2017,0,0,3,3,0.0
510160,2018,3,0,0,3,100.0
510160,2019,1,0,0,1,100.0
510160,2020,2,0,0,2,100.0
510170,2012,15,0,0,15,100.0
510170,2013,12,0,0,12,100.0
510170,2014,9,0,0,9,100.0
510170,2015,12,0,0,12,100.0
510170,2016,9,0,0,9,100.0
510170,2017,14,0,0,14,100.0
510170,2018,7,0,0,7,100.0
510170,2019,10,0,0,10,100.0
510170,2020,13,0,0,13,100.0
510180,2012,15,1,12,28,57.14285714285714
510180,2013,21,1,0,22,100.0
510180,2014,17,0,7,24,70.83333333333334
510180,2015,6,3,11,20,45.0
510180,2016,22,0,3,25,88.0
510180,2017,24,0,0,24,100.0
510180,2018,34,0,0,34,100.0
510180,2019,26,0,0,26,100.0
510180,2020,26,0,0,26,100.0
510185,2012,1,1,1,3,66.66666666666666
510185,2013,1,0,0,1,100.0
510185,2015,2,0,0,2,100.0
510185,2016,0,0,1,1,0.0
510185,2017,1,0,1,2,50.0
510185,2018,1,0,0,1,100.0
510185,2020,2,0,0,2,100.0
510190,2012,8,0,0,8,100.0
510190,2013,13,0,0,13,100.0
510190,2014,6,0,0,6,100.0
510190,2015,7,0,0,7,100.0
510190,2016,1,0,0,1,100.0
510190,2017,4,0,0,4,100.0
510190,2018,2,0,0,2,100.0
510190,2019,3,0,0,3,100.0
510190,2020,12,0,0,12,100.0
510250,2012,34,0,0,34,100.0
510250,2013,43,0,0,43,100.0
510250,2014,50,0,0,50,100.0
510250,2015,47,0,0,47,100.0
510250,2016,50,0,0,50,100.0
510250,2017,49,0,0,49,100.0
510250,2018,42,0,0,42,100.0
510250,2019,38,0,0,38,100.0
510250,2020,40,0,0,40,100.0
510260,2012,3,0,2,5,60.0
510260,2013,0,0,1,1,0.0
510260,2014,3,0,0,3,100.0
510260,2015,9,0,0,9,100.0
510260,2016,5,0,0,5,100.0
510260,2017,2,0,0,2,100.0
510260,2018,7,0,0,7,100.0
510260,2019,7,0,0,7,100.0
510260,2020,5,0,0,5,100.0
510263,2012,8,0,0,8,100.0
510263,2013,19,0,0,19,100.0
510263,2014,13,0,0,13,100.0
510263,2015,6,0,0,6,100.0
510263,2016,4,0,0,4,100.0
510263,2017,12,0,0,12,100.0
510263,2018,11,0,0,11,100.0
510263,2019,15,0,0,15,100.0
510263,2020,13,0,0,13,100.0
510267,2012,3,0,0,3,100.0
510267,2013,12,0,0,12,100.0
510267,2014,14,0,0,14,100.0
510267,2015,13,0,0,13,100.0
510267,2016,12,0,0,12,100.0
510267,2017,11,0,0,11,100.0
510267,2018,13,0,0,13,100.0
510267,2019,10,0,0,10,100.0
510267,2020,20,0,1,21,95.23809523809523
510268,2012,2,0,0,2,100.0
510268,2013,2,0,0,2,100.0
510268,2014,1,0,0,1,100.0
510268,2015,1,0,0,1,100.0
510268,2016,1,0,0,1,100.0
510268,2017,1,0,0,1,100.0
510268,2018,4,0,0,4,100.0
510268,2019,1,0,0,1,100.0
510268,2020,5,0,0,5,100.0
510269,2012,0,0,1,1,0.0
510269,2013,1,0,0,1,100.0
510269,2016,0,1,1,2,50.0
510269,2017,1,0,0,1,100.0
510269,2020,1,0,0,1,100.0
510270,2012,6,0,0,6,100.0
510270,2013,10,0,0,10,100.0
510270,2014,11,0,0,11,100.0
510270,2015,6,0,0,6,100.0
510270,2016,6,0,0,6,100.0
510270,2017,5,0,0,5,100.0
510270,2018,4,0,0,4,100.0
510270,2019,6,0,0,6,100.0
510270,2020,7,0,0,7,100.0
510279,2012,2,0,0,2,100.0
510279,2013,2,0,0,2,100.0
510279,2014,1,0,0,1,100.0
510279,2015,0,0,1,1,0.0
510279,2016,4,0,0,4,100.0
510279,2017,1,0,0,1,100.0
510279,2019,0,0,1,1,0.0
510279,2020,1,0,2,3,33.33333333333333
510285,2012,1,0,0,1,100.0
510285,2014,2,0,0,2,100.0
510285,2015,1,1,0,2,100.0
510285,2017,2,0,0,2,100.0
510285,2018,2,0,0,2,100.0
510285,2019,3,0,0,3,100.0
510285,2020,5,0,0,5,100.0
510300,2012,6,0,0,6,100.0
510300,2013,11,1,0,12,100.0
510300,2014,9,0,1,10,90.0
510300,2015,5,0,0,5,100.0
510300,2016,6,0,0,6,100.0
510300,2017,7,0,0,7,100.0
510300,2018,6,0,0,6,100.0
510300,2019,10,0,0,10,100.0
510300,2020,6,0,0,6,100.0
510305,2012,2,1,2,5,60.0
510305,2013,3,0,0,3,100.0
510305,2014,5,0,0,5,100.0
510305,2015,4,0,0,4,100.0
510305,2016,3,0,0,3,100.0
510305,2017,2,0,0,2,100.0
510305,2018,4,0,0,4,100.0
510305,2019,3,0,0,3,100.0
510305,2020,6,0,1,7,85.71428571428571
510310,2012,0,0,1,1,0.0
510310,2014,2,0,1,3,66.66666666666666
510310,2018,0,6,1,7,85.71428571428571
510310,2020,4,0,0,4,100.0
510320,2012,10,0,1,11,90.9090909090909
510320,2013,4,1,0,5,100.0
510320,2014,14,0,0,14,100.0
510320,2015,10,0,0,10,100.0
510320,2016,9,0,0,9,100.0
510320,2017,7,0,0,7,100.0
510320,2018,14,0,0,14,100.0
510320,2019,10,0,0,10,100.0
510320,2020,14,1,0,15,100.0
510325,2012,6,0,0,6,100.0
510325,2013,3,0,0,3,100.0
510325,2014,7,0,0,7,100.0
510325,2015,9,0,0,9,100.0
510325,2016,5,0,0,5,100.0
510325,2017,8,0,1,9,88.88888888888889
510325,2018,8,0,0,8,100.0
510325,2019,6,0,1,7,85.71428571428571
510325,2020,7,0,1,8,87.5
510330,2012,2,0,0,2,100.0
510330,2013,3,0,2,5,60.0
510330,2014,8,0,0,8,100.0
510330,2015,6,0,0,6,100.0
510330,2016,8,0,0,8,100.0
510330,2017,7,0,0,7,100.0
510330,2018,6,0,0,6,100.0
510330,2019,5,0,1,6,83.33333333333334
510330,2020,3,0,0,3,100.0
510335,2012,2,1,0,3,100.0
510335,2013,1,0,5,6,16.666666666666664
510335,2014,4,0,0,4,100.0
510335,2015,7,0,0,7,100.0
510335,2016,9,0,0,9,100.0
510335,2017,8,0,0,8,100.0
510335,2018,5,0,0,5,100.0
510335,2019,12,0,0,12,100.0
510335,2020,12,0,0,12,100.0
510336,2012,1,0,1,2,50.0
510336,2014,1,0,0,1,100.0
510336,2015,0,0,1,1,0.0
510336,2018,1,0,1,2,50.0
510336,2020,3,0,0,3,100.0
510337,2012,3,0,0,3,100.0
510337,2013,1,0,0,1,100.0
510337,2014,2,0,0,2,100.0
510337,2015,3,0,0,3,100.0
510337,2016,5,0,0,5,100.0
510337,2017,5,0,0,5,100.0
510337,2019,5,0,0,5,100.0
510337,2020,3,0,0,3,100.0
510340,2012,254,0,3,257,98.83268482490273
510340,2013,240,1,3,244,98.77049180327869
510340,2014,200,0,20,220,90.9090909090909
510340,2015,215,0,13,228,94.2982456140351
510340,2016,230,0,7,237,97.0464135021097
510340,2017,193,0,6,199,96.98492462311557
510340,2018,189,0,7,196,96.42857142857143
510340,2019,184,0,23,207,88.88888888888889
510340,2020,232,1,20,253,92.09486166007905
510343,2012,1,0,0,1,100.0
510343,2013,1,0,0,1,100.0
510343,2014,0,0,1,1,0.0
510343,2015,1,0,0,1,100.0
510343,2016,3,0,0,3,100.0
510343,2017,3,0,0,3,100.0
510343,2018,2,0,0,2,100.0
510343,2019,6,0,0,6,100.0
510343,2020,4,0,0,4,100.0
510345,2012,0,0,3,3,0.0
510345,2013,1,0,3,4,25.0
510345,2014,1,0,0,1,100.0
510345,2017,5,0,0,5,100.0
510345,2018,2,0,0,2,100.0
510345,2019,11,0,0,11,100.0
510345,2020,3,0,0,3,100.0
510350,2012,16,0,0,16,100.0
510350,2013,7,0,0,7,100.0
510350,2014,6,0,0,6,100.0
510350,2015,9,0,0,9,100.0
510350,2016,10,0,0,10,100.0
510350,2017,9,0,0,9,100.0
510350,2018,7,0,0,7,100.0
510350,2019,8,0,0,8,100.0
510350,2020,7,0,0,7,100.0
510360,2012,1,0,2,3,33.33333333333333
510360,2013,1,1,0,2,100.0
510360,2014,4,0,0,4,100.0
510360,2015,3,0,0,3,100.0
510360,2017,4,0,0,4,100.0
510360,2018,7,0,0,7,100.0
510360,2019,4,0,0,4,100.0
510360,2020,2,0,0,2,100.0
510370,2012,2,0,0,2,100.0
510370,2013,1,0,0,1,100.0
510370,2014,1,0,0,1,100.0
510370,2015,1,0,0,1,100.0
510370,2016,6,0,0,6,100.0
510370,2017,2,0,0,2,100.0
510370,2018,4,0,0,4,100.0
510370,2019,2,0,0,2,100.0
510370,2020,3,0,2,5,60.0
510380,2012,3,1,0,4,100.0
510380,2013,0,1,1,2,50.0
510380,2016,0,0,1,1,0.0
510380,2018,1,0,0,1,100.0
510380,2019,1,0,0,1,100.0
510385,2012,2,0,0,2,100.0
510385,2014,1,0,0,1,100.0
510385,2015,1,0,0,1,100.0
510385,2017,1,0,0,1,100.0
510385,2018,2,0,0,2,100.0
510385,2019,3,0,0,3,100.0
510385,2020,1,0,0,1,100.0
510390,2012,1,0,0,1,100.0
510390,2013,1,0,3,4,25.0
510390,2014,2,0,1,3,66.66666666666666
510390,2015,1,0,0,1,100.0
510390,2016,5,0,0,5,100.0
510390,2017,3,0,0,3,100.0
510390,2018,1,0,0,1,100.0
510390,2019,0,0,1,1,0.0
510390,2020,3,2,0,5,100.0
510395,2012,0,1,0,1,100.0
510395,2014,1,0,0,1,100.0
510395,2015,4,0,0,4,100.0
510395,2016,2,0,0,2,100.0
510395,2017,1,0,0,1,100.0
510395,2018,2,0,0,2,100.0
510395,2019,1,0,0,1,100.0
510395,2020,1,0,0,1,100.0
510410,2012,7,0,0,7,100.0
510410,2013,12,0,0,12,100.0
510410,2014,8,0,0,8,100.0
510410,2015,8,0,0,8,100.0
510410,2016,8,0,0,8,100.0
510410,2017,9,0,0,9,100.0
510410,2018,5,0,0,5,100.0
510410,2019,12,0,0,12,100.0
510410,2020,11,0,0,11,100.0
510420,2012,2,0,0,2,100.0
510420,2013,3,0,0,3,100.0
510420,2014,4,0,0,4,100.0
510420,2015,4,0,0,4,100.0
510420,2016,4,0,1,5,80.0
510420,2018,4,0,0,4,100.0
510420,2020,2,0,0,2,100.0
510450,2016,1,0,0,1,100.0
510450,2017,1,0,0,1,100.0
510450,2020,1,0,0,1,100.0
510452,2012,2,0,0,2,100.0
510452,2014,2,0,0,2,100.0
510452,2015,2,0,0,2,100.0
510452,2016,1,0,0,1,100.0
510452,2017,1,0,0,1,100.0
510452,2018,1,0,0,1,100.0
510452,2019,1,0,0,1,100.0
510452,2020,1,0,0,1,100.0
510454,2013,2,0,0,2,100.0
510454,2014,4,0,0,4,100.0
510454,2015,1,0,0,1,100.0
510454,2016,2,0,0,2,100.0
510454,2017,1,0,0,1,100.0
510454,2018,5,0,0,5,100.0
510454,2020,6,0,0,6,100.0
510455,2012,3,0,0,3,100.0
510455,2013,0,0,3,3,0.0
510455,2015,0,1,1,2,50.0
510455,2016,3,0,0,3,100.0
510455,2017,1,0,0,1,100.0
510455,2018,2,0,0,2,100.0
510455,2019,1,0,0,1,100.0
510455,2020,1,0,0,1,100.0
510460,2012,0,0,2,2,0.0
510460,2013,1,0,1,2,50.0
510460,2014,3,0,0,3,100.0
510460,2015,1,0,0,1,100.0
510460,2016,5,0,0,5,100.0
510460,2017,1,0,0,1,100.0
510460,2018,3,0,0,3,100.0
510460,2019,4,0,0,4,100.0
510460,2020,4,0,0,4,100.0
510480,2012,8,0,0,8,100.0
510480,2013,7,0,0,7,100.0
510480,2014,10,0,0,10,100.0
510480,2015,14,0,0,14,100.0
510480,2016,10,0,0,10,100.0
510480,2017,10,0,0,10,100.0
510480,2018,6,0,0,6,100.0
510480,2019,6,0,0,6,100.0
510480,2020,10,0,0,10,100.0
510490,2012,3,0,0,3,100.0
510490,2013,3,0,0,3,100.0
510490,2014,7,0,0,7,100.0
510490,2015,6,0,0,6,100.0
510490,2016,2,1,0,3,100.0
510490,2017,2,0,0,2,100.0
510490,2018,0,0,2,2,0.0
510490,2019,1,1,4,6,33.33333333333333
510490,2020,0,0,4,4,0.0
510500,2012,4,0,0,4,100.0
510500,2013,1,0,1,2,50.0
510500,2015,2,0,0,2,100.0
510500,2016,2,0,0,2,100.0
510500,2017,6,0,0,6,100.0
510500,2019,0,1,2,3,33.33333333333333
510500,2020,3,0,0,3,100.0
510510,2012,8,0,0,8,100.0
510510,2013,7,0,0,7,100.0
510510,2014,8,2,0,10,100.0
510510,2015,7,0,0,7,100.0
510510,2016,14,0,0,14,100.0
510510,2017,12,0,0,12,100.0
510510,2018,10,0,0,10,100.0
510510,2019,17,0,1,18,94.44444444444444
510510,2020,9,0,0,9,100.0
510515,2012,13,0,0,13,100.0
510515,2013,9,0,0,9,100.0
510515,2014,17,0,0,17,100.0
510515,2015,14,0,0,14,100.0
510515,2016,13,0,0,13,100.0
510515,2017,9,0,0,9,100.0
510515,2018,15,0,0,15,100.0
510515,2019,11,0,0,11,100.0
510515,2020,20,0,0,20,100.0
510517,2013,1,0,0,1,100.0
510517,2014,1,0,0,1,100.0
510517,2015,2,0,0,2,100.0
510517,2016,4,0,0,4,100.0
510517,2017,1,0,0,1,100.0
510517,2018,0,3,0,3,100.0
510517,2019,10,0,0,10,100.0
510517,2020,1,0,0,1,100.0
510520,2012,1,0,0,1,100.0
510520,2013,4,0,0,4,100.0
510520,2014,6,0,0,6,100.0
510520,2015,4,0,0,4,100.0
510520,2016,4,0,0,4,100.0
510520,2017,2,0,0,2,100.0
510520,2018,1,0,0,1,100.0
510520,2019,4,0,0,4,100.0
510520,2020,1,0,0,1,100.0
510523,2012,1,0,0,1,100.0
510523,2013,1,0,0,1,100.0
510523,2014,1,0,0,1,100.0
510523,2015,2,0,0,2,100.0
510523,2016,2,0,0,2,100.0
510523,2017,1,0,0,1,100.0
510523,2020,5,0,0,5,100.0
510525,2012,17,0,0,17,100.0
510525,2013,19,0,0,19,100.0
510525,2014,14,0,0,14,100.0
510525,2015,15,0,0,15,100.0
510525,2016,15,0,0,15,100.0
510525,2017,22,0,0,22,100.0
510525,2018,21,0,0,21,100.0
510525,2019,17,0,1,18,94.44444444444444
510525,2020,32,0,0,32,100.0
510530,2014,0,0,1,1,0.0
510530,2015,0,0,1,1,0.0
510530,2017,2,0,0,2,100.0
510530,2019,2,0,0,2,100.0
510550,2013,3,0,1,4,75.0
510550,2014,5,0,0,5,100.0
510550,2015,4,0,2,6,66.66666666666666
510550,2016,2,0,0,2,100.0
510550,2017,3,0,0,3,100.0
510550,2018,1,0,2,3,33.33333333333333
510550,2019,1,0,3,4,25.0
510550,2020,2,0,8,10,20.0
510558,2012,4,0,0,4,100.0
510558,2013,2,0,0,2,100.0
510558,2014,1,0,0,1,100.0
510558,2015,2,0,0,2,100.0
510558,2016,5,0,0,5,100.0
510558,2017,5,0,0,5,100.0
510558,2018,1,1,3,5,40.0
510558,2019,3,1,0,4,100.0
510558,2020,1,0,0,1,100.0
510560,2012,5,0,0,5,100.0
510560,2013,5,0,0,5,100.0
510560,2014,3,0,0,3,100.0
510560,2015,5,0,0,5,100.0
510560,2016,4,0,0,4,100.0
510560,2017,6,0,0,6,100.0
510560,2018,3,0,0,3,100.0
510560,2019,6,0,0,6,100.0
510560,2020,8,0,0,8,100.0
510562,2012,7,0,0,7,100.0
510562,2013,6,0,0,6,100.0
510562,2014,4,1,0,5,100.0
510562,2015,12,0,0,12,100.0
510562,2016,7,0,0,7,100.0
510562,2017,4,0,0,4,100.0
510562,2018,8,0,0,8,100.0
510562,2019,10,0,0,10,100.0
510562,2020,11,0,0,11,100.0
510590,2012,2,3,1,6,83.33333333333334
510590,2013,4,0,0,4,100.0
510590,2014,5,0,0,5,100.0
510590,2015,6,1,9,16,43.75
510590,2016,5,0,0,5,100.0
510590,2017,4,0,0,4,100.0
510590,2018,7,0,0,7,100.0
510590,2019,6,0,0,6,100.0
510590,2020,7,0,0,7,100.0
510600,2012,2,0,2,4,50.0
510600,2013,6,0,0,6,100.0
510600,2014,2,0,0,2,100.0
510600,2015,5,0,0,5,100.0
510600,2016,2,0,0,2,100.0
510600,2017,2,0,0,2,100.0
510600,2018,1,0,0,1,100.0
510600,2019,5,0,0,5,100.0
510610,2012,3,0,0,3,100.0
510610,2013,2,0,1,3,66.66666666666666
510610,2015,1,1,0,2,100.0
510610,2016,1,0,1,2,50.0
510610,2017,4,0,0,4,100.0
510610,2018,5,0,2,7,71.42857142857143
510610,2019,2,0,0,2,100.0
510610,2020,4,0,0,4,100.0
510615,2012,2,0,0,2,100.0
510615,2013,2,0,0,2,100.0
510615,2014,5,0,0,5,100.0
510615,2015,2,0,0,2,100.0
510615,2016,5,0,0,5,100.0
510615,2017,3,0,0,3,100.0
510615,2018,3,0,0,3,100.0
510615,2019,5,0,0,5,100.0
510615,2020,4,0,0,4,100.0
510617,2012,1,0,1,2,50.0
510617,2016,1,0,2,3,33.33333333333333
510617,2017,1,0,0,1,100.0
510617,2018,3,0,0,3,100.0
510617,2019,0,0,1,1,0.0
510618,2012,0,0,2,2,0.0
510618,2013,1,0,0,1,100.0
510618,2015,1,0,1,2,50.0
510618,2016,1,0,0,1,100.0
510618,2017,1,0,0,1,100.0
510618,2018,1,0,0,1,100.0
510618,2019,1,0,1,2,50.0
510618,2020,0,0,2,2,0.0
510619,2012,4,0,0,4,100.0
510619,2013,0,0,1,1,0.0
510619,2015,1,0,0,1,100.0
510619,2017,2,0,0,2,100.0
510619,2018,3,0,0,3,100.0
510619,2019,2,1,0,3,100.0
510619,2020,1,0,0,1,100.0
510620,2013,2,0,0,2,100.0
510620,2014,1,0,0,1,100.0
510620,2015,4,0,0,4,100.0
510620,2016,3,0,0,3,100.0
510620,2019,1,0,0,1,100.0
510620,2020,1,0,0,1,100.0
510621,2012,3,0,0,3,100.0
510621,2013,3,0,1,4,75.0
510621,2014,1,0,0,1,100.0
510621,2015,1,0,0,1,100.0
510621,2016,7,0,0,7,100.0
510621,2017,4,0,0,4,100.0
510621,2018,1,0,0,1,100.0
510621,2019,4,0,0,4,100.0
510621,2020,1,0,0,1,100.0
510622,2012,19,0,0,19,100.0
510622,2013,9,0,0,9,100.0
510622,2014,14,0,0,14,100.0
510622,2015,18,0,0,18,100.0
510622,2016,14,0,0,14,100.0
510622,2017,12,0,0,12,100.0
510622,2018,11,0,0,11,100.0
510622,2019,13,0,0,13,100.0
510622,2020,18,0,0,18,100.0
510623,2012,3,0,2,5,60.0
510623,2013,7,1,1,9,88.88888888888889
510623,2014,7,0,0,7,100.0
510623,2015,4,0,0,4,100.0
510623,2016,9,0,0,9,100.0
510623,2017,6,0,0,6,100.0
510623,2018,5,0,0,5,100.0
510623,2019,10,0,0,10,100.0
510623,2020,4,0,0,4,100.0
510624,2012,4,0,0,4,100.0
510624,2013,4,0,0,4,100.0
510624,2014,7,0,0,7,100.0
510624,2015,2,0,0,2,100.0
510624,2016,3,0,0,3,100.0
510624,2017,1,0,0,1,100.0
510624,2018,3,0,0,3,100.0
510624,2019,2,0,0,2,100.0
510624,2020,5,0,0,5,100.0
510625,2012,9,0,0,9,100.0
510625,2013,7,0,0,7,100.0
510625,2014,5,0,0,5,100.0
510625,2015,6,0,0,6,100.0
510625,2016,7,0,0,7,100.0
510625,2017,1,0,0,1,100.0
510625,2018,5,0,0,5,100.0
510625,2019,8,0,1,9,88.88888888888889
510625,2020,11,0,0,11,100.0
510626,2012,3,0,0,3,100.0
510626,2013,1,0,0,1,100.0
510626,2014,5,0,0,5,100.0
510626,2015,1,0,0,1,100.0
510626,2016,5,0,0,5,100.0
510626,2018,2,0,0,2,100.0
510626,2020,3,0,0,3,100.0
510627,2012,0,0,1,1,0.0
510627,2013,1,0,0,1,100.0
510627,2014,1,0,0,1,100.0
510627,2016,1,0,0,1,100.0
510627,2017,4,0,0,4,100.0
510627,2019,0,0,1,1,0.0
510627,2020,2,0,1,3,66.66666666666666
510628,2012,2,0,1,3,66.66666666666666
510628,2013,1,0,0,1,100.0
510628,2014,2,0,0,2,100.0
510628,2015,3,0,2,5,60.0
510628,2016,1,0,0,1,100.0
510628,2017,1,0,0,1,100.0
510628,2019,2,0,0,2,100.0
510628,2020,3,0,0,3,100.0
510629,2013,6,0,0,6,100.0
510629,2014,3,0,0,3,100.0
510629,2015,1,0,0,1,100.0
510629,2016,2,0,0,2,100.0
510629,2017,3,0,0,3,100.0
510629,2018,2,0,0,2,100.0
510629,2019,1,0,0,1,100.0
510629,2020,1,0,0,1,100.0
510630,2012,3,1,1,5,80.0
510630,2013,5,1,5,11,54.54545454545454
510630,2014,6,0,0,6,100.0
510630,2015,9,0,0,9,100.0
510630,2016,4,0,2,6,66.66666666666666
510630,2017,11,0,0,11,100.0
510630,2018,6,0,0,6,100.0
510630,2019,12,0,0,12,100.0
510630,2020,9,0,0,9,100.0
510631,2012,0,0,2,2,0.0
510631,2013,0,0,1,1,0.0
510631,2014,0,1,1,2,50.0
510631,2016,1,0,0,1,100.0
510637,2012,0,2,5,7,28.57142857142857
510637,2013,1,0,4,5,20.0
510637,2014,3,0,3,6,50.0
510637,2015,7,0,1,8,87.5
510637,2016,5,0,2,7,71.42857142857143
510637,2017,7,0,0,7,100.0
510637,2018,6,0,0,6,100.0
510637,2019,8,0,0,8,100.0
510637,2020,15,0,0,15,100.0
510642,2012,9,0,1,10,90.0
510642,2013,9,0,0,9,100.0
510642,2014,13,0,4,17,76.47058823529412
510642,2015,10,1,1,12,91.66666666666666
510642,2016,21,0,0,21,100.0
510642,2017,6,0,0,6,100.0
510642,2018,15,0,0,15,100.0
510642,2019,11,0,0,11,100.0
510642,2020,12,0,0,12,100.0
510645,2012,0,0,3,3,0.0
510645,2013,0,1,0,1,100.0
510645,2014,0,0,1,1,0.0
510645,2017,1,0,0,1,100.0
510645,2019,1,0,0,1,100.0
510645,2020,1,0,0,1,100.0
510650,2012,11,0,1,12,91.66666666666666
510650,2013,19,0,3,22,86.36363636363636
510650,2014,15,0,1,16,93.75
510650,2015,14,0,1,15,93.33333333333333
510650,2016,12,0,1,13,92.3076923076923
510650,2017,13,0,0,13,100.0
510650,2018,5,0,0,5,100.0
510650,2019,12,0,1,13,92.3076923076923
510650,2020,14,0,0,14,100.0
510665,2012,5,0,0,5,100.0
510665,2013,1,0,3,4,25.0
510665,2014,1,0,1,2,50.0
510665,2015,1,0,0,1,100.0
510665,2016,2,0,0,2,100.0
510665,2018,1,0,1,2,50.0
510665,2019,7,0,0,7,100.0
510670,2013,3,0,0,3,100.0
510670,2017,1,0,0,1,100.0
510670,2018,1,0,0,1,100.0
510670,2020,1,0,0,1,100.0
510675,2012,12,0,3,15,80.0
510675,2013,17,0,0,17,100.0
510675,2014,12,0,0,12,100.0
510675,2015,16,0,0,16,100.0
510675,2016,9,0,2,11,81.81818181818183
510675,2017,17,0,0,17,100.0
510675,2018,11,0,0,11,100.0
510675,2019,10,0,0,10,100.0
510675,2020,23,0,1,24,95.83333333333334
510677,2012,0,1,0,1,100.0
510677,2013,1,1,2,4,50.0
510677,2014,1,1,1,3,66.66666666666666
510677,2015,2,0,1,3,66.66666666666666
510677,2016,4,0,0,4,100.0
510677,2017,6,0,0,6,100.0
510677,2018,4,0,0,4,100.0
510677,2019,3,0,2,5,60.0
510677,2020,1,0,0,1,100.0
510680,2013,2,0,0,2,100.0
510680,2014,3,0,0,3,100.0
510680,2015,4,0,0,4,100.0
510680,2017,1,0,0,1,100.0
510680,2018,1,0,0,1,100.0
510680,2019,3,0,0,3,100.0
510680,2020,1,0,0,1,100.0
510682,2012,2,0,0,2,100.0
510682,2013,1,0,0,1,100.0
510682,2014,2,0,0,2,100.0
510682,2015,1,0,0,1,100.0
510682,2016,4,0,0,4,100.0
510682,2017,4,0,0,4,100.0
510682,2018,2,0,0,2,100.0
510682,2019,1,0,0,1,100.0
510682,2020,8,0,0,8,100.0
510685,2012,1,0,2,3,33.33333333333333
510685,2013,0,1,0,1,100.0
510685,2014,1,0,0,1,100.0
510685,2015,0,1,0,1,100.0
510685,2016,2,0,0,2,100.0
510685,2017,1,0,0,1,100.0
510685,2018,3,0,0,3,100.0
510685,2019,2,0,0,2,100.0
510700,2012,3,0,4,7,42.857142857142854
510700,2013,9,0,0,9,100.0
510700,2014,7,0,0,7,100.0
510700,2015,6,0,0,6,100.0
510700,2016,3,0,0,3,100.0
510700,2017,8,0,0,8,100.0
510700,2018,6,0,0,6,100.0
510700,2019,5,0,0,5,100.0
510700,2020,6,0,0,6,100.0
510704,2012,24,0,0,24,100.0
510704,2013,25,0,0,25,100.0
510704,2014,29,0,0,29,100.0
510704,2015,23,0,0,23,100.0
510704,2016,29,0,0,29,100.0
510704,2017,34,0,0,34,100.0
510704,2018,23,0,0,23,100.0
510704,2019,29,0,0,29,100.0
510704,2020,35,0,0,35,100.0
510706,2012,5,0,0,5,100.0
510706,2013,1,0,0,1,100.0
510706,2014,8,0,0,8,100.0
510706,2015,3,0,1,4,75.0
510706,2016,9,0,0,9,100.0
510706,2017,6,0,1,7,85.71428571428571
510706,2018,4,0,0,4,100.0
510706,2019,4,0,0,4,100.0
510706,2020,10,0,0,10,100.0
510710,2012,6,0,0,6,100.0
510710,2013,5,0,1,6,83.33333333333334
510710,2014,5,0,0,5,100.0
510710,2015,4,0,0,4,100.0
510710,2016,3,0,0,3,100.0
510710,2017,7,0,0,7,100.0
510710,2018,5,0,0,5,100.0
510710,2019,5,0,0,5,100.0
510710,2020,4,0,0,4,100.0
510715,2012,0,0,1,1,0.0
510715,2016,2,0,0,2,100.0
510715,2017,1,0,0,1,100.0
510715,2018,3,0,0,3,100.0
510715,2019,1,0,0,1,100.0
510718,2012,3,0,0,3,100.0
510718,2013,5,0,0,5,100.0
510718,2014,1,0,0,1,100.0
510718,2015,6,0,0,6,100.0
510718,2016,2,0,0,2,100.0
510718,2017,5,0,0,5,100.0
510718,2018,1,0,0,1,100.0
510718,2019,6,0,0,6,100.0
510718,2020,5,0,1,6,83.33333333333334
510719,2013,1,0,0,1,100.0
510719,2017,1,0,0,1,100.0
510719,2019,1,0,0,1,100.0
510719,2020,1,0,0,1,100.0
510720,2012,2,0,0,2,100.0
510720,2013,2,0,0,2,100.0
510720,2014,2,0,0,2,100.0
510720,2015,1,0,0,1,100.0
510720,2016,1,0,0,1,100.0
510720,2017,5,0,0,5,100.0
510720,2018,4,0,0,4,100.0
510720,2019,2,0,0,2,100.0
510720,2020,1,0,0,1,100.0
510724,2012,1,1,0,2,100.0
510724,2014,3,0,0,3,100.0
510724,2015,2,0,0,2,100.0
510724,2016,1,0,0,1,100.0
510724,2017,3,0,0,3,100.0
510724,2018,3,0,0,3,100.0
510724,2019,1,0,0,1,100.0
510724,2020,2,0,0,2,100.0
510726,2012,1,1,0,2,100.0
510726,2014,1,0,0,1,100.0
510726,2016,3,0,0,3,100.0
510726,2019,1,0,0,1,100.0
510726,2020,2,0,0,2,100.0
510729,2012,1,0,0,1,100.0
510729,2015,1,0,0,1,100.0
510729,2017,3,0,0,3,100.0
510729,2018,1,0,0,1,100.0
510729,2019,1,0,0,1,100.0
510729,2020,0,0,1,1,0.0
510730,2012,5,0,0,5,100.0
510730,2013,6,0,0,6,100.0
510730,2014,7,0,0,7,100.0
510730,2015,10,0,0,10,100.0
510730,2016,4,0,0,4,100.0
510730,2017,8,0,0,8,100.0
510730,2018,4,0,0,4,100.0
510730,2019,7,0,0,7,100.0
510730,2020,6,0,0,6,100.0
510735,2012,1,0,0,1,100.0
510735,2015,1,0,1,2,50.0
510735,2017,4,0,0,4,100.0
510735,2018,1,0,0,1,100.0
510735,2019,0,1,2,3,33.33333333333333
510735,2020,1,0,0,1,100.0
510740,2012,1,0,0,1,100.0
510740,2013,1,0,0,1,100.0
510740,2015,2,0,0,2,100.0
510740,2017,1,0,0,1,100.0
510740,2018,2,0,0,2,100.0
510740,2019,2,0,0,2,100.0
510740,2020,1,0,0,1,100.0
510757,2016,1,0,0,1,100.0
510757,2017,1,1,0,2,100.0
510757,2018,1,0,0,1,100.0
510760,2012,102,0,1,103,99.02912621359224
510760,2013,91,0,0,91,100.0
510760,2014,90,0,1,91,98.9010989010989
510760,2015,94,0,0,94,100.0
510760,2016,88,0,1,89,98.87640449438202
510760,2017,65,0,0,65,100.0
510760,2018,92,0,0,92,100.0
510760,2019,82,0,0,82,100.0
510760,2020,70,4,25,99,74.74747474747475
510770,2012,5,0,2,7,71.42857142857143
510770,2013,4,1,2,7,71.42857142857143
510770,2014,5,0,1,6,83.33333333333334
510770,2015,3,0,4,7,42.857142857142854
510770,2016,12,0,0,12,100.0
510770,2017,5,0,0,5,100.0
510770,2018,2,0,0,2,100.0
510770,2019,3,0,0,3,100.0
510770,2020,5,0,0,5,100.0
510774,2017,1,0,0,1,100.0
510774,2020,1,0,0,1,100.0
510775,2012,0,0,1,1,0.0
510775,2013,1,0,0,1,100.0
510775,2014,0,0,1,1,0.0
510775,2015,1,0,0,1,100.0
510775,2016,2,0,0,2,100.0
510775,2017,1,0,0,1,100.0
510775,2019,1,0,0,1,100.0
510776,2012,1,0,0,1,100.0
510776,2015,1,0,0,1,100.0
510776,2016,1,0,0,1,100.0
510776,2017,1,0,0,1,100.0
510776,2018,1,0,0,1,100.0
510776,2020,2,0,0,2,100.0
510777,2012,0,0,3,3,0.0
510777,2013,1,0,1,2,50.0
510777,2015,1,1,0,2,100.0
510777,2017,0,0,2,2,0.0
510777,2018,0,1,3,4,25.0
510777,2019,1,0,2,3,33.33333333333333
510777,2020,2,0,0,2,100.0
510779,2012,1,0,0,1,100.0
510779,2013,1,0,0,1,100.0
510779,2014,2,0,0,2,100.0
510779,2015,1,0,0,1,100.0
510779,2016,1,0,0,1,100.0
510779,2018,1,0,0,1,100.0
510779,2019,0,0,3,3,0.0
510779,2020,1,0,0,1,100.0
510780,2012,2,0,0,2,100.0
510780,2013,6,0,1,7,85.71428571428571
510780,2014,5,0,1,6,83.33333333333334
510780,2015,6,0,1,7,85.71428571428571
510780,2016,5,0,0,5,100.0
510780,2017,8,0,0,8,100.0
510780,2018,4,0,0,4,100.0
510780,2019,4,0,1,5,80.0
510780,2020,9,0,2,11,81.81818181818183
510785,2012,1,0,2,3,33.33333333333333
510785,2014,2,1,3,6,50.0
510785,2015,2,0,0,2,100.0
510785,2017,2,0,0,2,100.0
510785,2018,2,0,0,2,100.0
510785,2019,1,0,0,1,100.0
510785,2020,5,0,0,5,100.0
510787,2012,5,0,1,6,83.33333333333334
510787,2013,4,0,0,4,100.0
510787,2014,6,0,0,6,100.0
510787,2015,5,0,0,5,100.0
510787,2016,5,0,0,5,100.0
510787,2017,5,0,0,5,100.0
510787,2018,7,0,0,7,100.0
510787,2019,6,0,0,6,100.0
510787,2020,5,0,0,5,100.0
510790,2012,39,0,0,39,100.0
510790,2013,50,1,0,51,100.0
510790,2014,53,0,0,53,100.0
510790,2015,50,0,0,50,100.0
510790,2016,49,0,0,49,100.0
510790,2017,61,0,1,62,98.38709677419355
510790,2018,63,0,0,63,100.0
510790,2019,39,2,0,41,100.0
510790,2020,11,5,31,47,34.04255319148936
510792,2012,24,0,0,24,100.0
510792,2013,20,0,0,20,100.0
510792,2014,25,0,0,25,100.0
510792,2015,33,0,0,33,100.0
510792,2016,28,0,0,28,100.0
510792,2017,32,0,0,32,100.0
510792,2018,25,0,0,25,100.0
510792,2019,24,0,0,24,100.0
510792,2020,33,0,0,33,100.0
510794,2013,3,0,0,3,100.0
510794,2014,3,0,0,3,100.0
510794,2015,1,0,0,1,100.0
510794,2016,2,0,0,2,100.0
510794,2017,1,0,0,1,100.0
510794,2018,2,0,0,2,100.0
510794,2019,6,0,0,6,100.0
510794,2020,4,0,0,4,100.0
510795,2012,32,0,0,32,100.0
510795,2013,25,0,9,34,73.52941176470588
510795,2014,33,0,0,33,100.0
510795,2015,23,0,0,23,100.0
510795,2016,34,0,0,34,100.0
510795,2017,28,0,0,28,100.0
510795,2018,44,0,0,44,100.0
510795,2019,30,0,0,30,100.0
510795,2020,43,0,0,43,100.0
510800,2012,4,0,0,4,100.0
510800,2013,1,0,0,1,100.0
510800,2014,2,0,0,2,100.0
510800,2015,3,0,0,3,100.0
510800,2016,1,0,0,1,100.0
510800,2017,1,0,0,1,100.0
510800,2018,1,0,0,1,100.0
510800,2019,5,0,0,5,100.0
510800,2020,1,0,0,1,100.0
510805,2012,1,0,0,1,100.0
510805,2013,6,0,0,6,100.0
510805,2014,2,0,0,2,100.0
510805,2015,3,0,0,3,100.0
510805,2016,3,0,0,3,100.0
510805,2017,2,0,0,2,100.0
510805,2018,5,0,0,5,100.0
510805,2019,0,0,1,1,0.0
510805,2020,1,0,5,6,16.666666666666664
510810,2012,2,0,0,2,100.0
510810,2013,1,0,0,1,100.0
510810,2014,1,0,0,1,100.0
510810,2016,2,0,0,2,100.0
510810,2017,2,0,0,2,100.0
510810,2018,1,0,0,1,100.0
510820,2012,1,0,0,1,100.0
510820,2014,1,0,0,1,100.0
510820,2015,2,0,0,2,100.0
510820,2016,4,0,0,4,100.0
510820,2018,5,0,0,5,100.0
510820,2019,2,0,0,2,100.0
510820,2020,1,0,0,1,100.0
510830,2012,1,0,0,1,100.0
510830,2013,2,0,2,4,50.0
510830,2014,2,0,0,2,100.0
510830,2015,1,0,0,1,100.0
510830,2016,2,0,0,2,100.0
510830,2017,1,0,0,1,100.0
510830,2018,1,0,0,1,100.0
510830,2020,3,0,0,3,100.0
510835,2012,0,0,1,1,0.0
510835,2013,1,0,0,1,100.0
510835,2014,1,0,0,1,100.0
510835,2015,1,0,0,1,100.0
510835,2018,1,0,0,1,100.0
510840,2012,104,1,4,109,96.3302752293578
510840,2013,94,17,12,123,90.2439024390244
510840,2014,108,3,25,136,81.61764705882352
510840,2015,106,0,8,114,92.98245614035088
510840,2016,89,1,8,98,91.83673469387756
510840,2017,109,0,4,113,96.46017699115043
510840,2018,113,0,5,118,95.76271186440678
510840,2019,106,0,8,114,92.98245614035088
510840,2020,115,0,8,123,93.4959349593496
510850,2012,5,0,0,5,100.0
510850,2013,1,0,0,1,100.0
510850,2014,3,0,0,3,100.0
510850,2015,4,0,0,4,100.0
510850,2016,5,0,0,5,100.0
510850,2017,6,0,0,6,100.0
510850,2018,4,0,0,4,100.0
510850,2019,3,0,0,3,100.0
510850,2020,2,0,0,2,100.0
510860,2012,1,0,10,11,9.090909090909092
510860,2013,2,1,2,5,60.0
510860,2014,0,1,2,3,33.33333333333333
510860,2015,1,1,5,7,28.57142857142857
510860,2016,3,0,1,4,75.0
510860,2017,6,0,1,7,85.71428571428571
510860,2018,6,0,0,6,100.0
510860,2019,9,0,0,9,100.0
510860,2020,13,0,0,13,100.0
510880,2012,0,0,1,1,0.0
510880,2013,2,0,1,3,66.66666666666666
510880,2014,0,0,1,1,0.0
510880,2015,1,0,0,1,100.0
510880,2016,1,0,0,1,100.0
510880,2019,1,0,0,1,100.0
510880,2020,2,0,0,2,100.0
510885,2012,2,0,0,2,100.0
510885,2013,1,0,0,1,100.0
510885,2014,1,0,0,1,100.0
510885,2016,1,0,0,1,100.0
510885,2018,1,0,0,1,100.0
510885,2019,2,0,0,2,100.0
510885,2020,1,0,0,1,100.0
510890,2012,1,0,0,1,100.0
510890,2013,3,1,0,4,100.0
510890,2014,1,0,0,1,100.0
510890,2017,2,0,0,2,100.0
510890,2018,1,0,0,1,100.0
510890,2020,0,0,1,1,0.0
510895,2012,1,0,0,1,100.0
510895,2013,1,0,0,1,100.0
510895,2014,4,0,0,4,100.0
510895,2015,3,0,0,3,100.0
510895,2016,1,0,0,1,100.0
510895,2017,1,0,0,1,100.0
510895,2018,2,0,0,2,100.0
510895,2019,4,0,0,4,100.0
510895,2020,2,0,0,2,100.0
520000,2012,1,1,2,4,50.0
520000,2013,4,2,2,8,75.0
520000,2014,1,0,9,10,10.0
520000,2016,2,0,0,2,100.0
520000,2017,0,0,4,4,0.0
520000,2018,1,1,1,3,66.66666666666666
520000,2019,1,0,2,3,33.33333333333333
520000,2020,0,0,3,3,0.0
520005,2012,0,0,1,1,0.0
520005,2013,0,1,1,2,50.0
520005,2014,0,1,2,3,33.33333333333333
520005,2015,3,1,2,6,66.66666666666666
520005,2016,3,0,0,3,100.0
520005,2017,2,0,0,2,100.0
520005,2018,8,0,0,8,100.0
520005,2019,1,1,1,3,66.66666666666666
520005,2020,4,0,0,4,100.0
520010,2012,5,0,0,5,100.0
520010,2013,9,0,1,10,90.0
520010,2014,3,0,0,3,100.0
520010,2015,5,0,0,5,100.0
520010,2016,10,0,0,10,100.0
520010,2017,7,0,0,7,100.0
520010,2018,5,0,0,5,100.0
520010,2019,10,0,0,10,100.0
520010,2020,4,0,0,4,100.0
520013,2012,10,0,1,11,90.9090909090909
520013,2013,5,0,5,10,50.0
520013,2014,9,0,0,9,100.0
520013,2015,10,0,0,10,100.0
520013,2016,8,0,0,8,100.0
520013,2017,3,0,0,3,100.0
520013,2018,10,0,0,10,100.0
520013,2019,9,0,0,9,100.0
520013,2020,9,0,0,9,100.0
520015,2012,0,1,1,2,50.0
520015,2015,1,0,0,1,100.0
520015,2016,2,0,0,2,100.0
520015,2017,2,0,0,2,100.0
520015,2018,1,0,0,1,100.0
520015,2019,1,0,0,1,100.0
520017,2012,3,0,0,3,100.0
520017,2013,3,0,0,3,100.0
520017,2014,4,0,0,4,100.0
520017,2015,1,0,0,1,100.0
520017,2016,1,0,0,1,100.0
520017,2017,2,0,0,2,100.0
520017,2020,0,0,1,1,0.0
520020,2012,1,0,0,1,100.0
520020,2016,1,0,0,1,100.0
520020,2017,1,0,0,1,100.0
520020,2018,1,0,0,1,100.0
520020,2019,1,0,0,1,100.0
520020,2020,1,0,0,1,100.0
520025,2012,46,7,11,64,82.8125
520025,2013,34,2,12,48,75.0
520025,2014,63,4,13,80,83.75
520025,2015,58,4,5,67,92.53731343283582
520025,2016,62,1,0,63,100.0
520025,2017,54,0,0,54,100.0
520025,2018,64,0,0,64,100.0
520025,2019,59,1,6,66,90.9090909090909
520025,2020,65,2,8,75,89.33333333333333
520030,2012,2,1,3,6,50.0
520030,2013,10,0,0,10,100.0
520030,2014,15,0,0,15,100.0
520030,2015,16,0,0,16,100.0
520030,2016,16,0,0,16,100.0
520030,2017,14,0,1,15,93.33333333333333
520030,2018,14,0,0,14,100.0
520030,2019,11,0,2,13,84.61538461538461
520030,2020,12,0,0,12,100.0
520050,2012,0,0,1,1,0.0
520050,2013,1,0,1,2,50.0
520050,2014,0,0,1,1,0.0
520050,2015,1,0,0,1,100.0
520050,2016,1,0,0,1,100.0
520050,2017,1,0,0,1,100.0
520050,2018,0,0,1,1,0.0
520055,2012,1,0,1,2,50.0
520055,2014,3,0,2,5,60.0
520055,2015,1,0,0,1,100.0
520055,2016,3,0,0,3,100.0
520055,2017,3,0,0,3,100.0
520055,2018,1,0,1,2,50.0
520055,2019,0,1,0,1,100.0
520055,2020,0,0,5,5,0.0
520060,2012,1,0,0,1,100.0
520060,2013,1,0,0,1,100.0
520060,2014,2,0,2,4,50.0
520060,2015,2,0,0,2,100.0
520060,2016,4,0,1,5,80.0
520060,2017,1,0,0,1,100.0
520060,2018,2,0,1,3,66.66666666666666
520060,2019,4,0,0,4,100.0
520060,2020,3,0,0,3,100.0
520080,2012,5,0,0,5,100.0
520080,2013,1,0,0,1,100.0
520080,2014,3,0,0,3,100.0
520080,2015,3,0,0,3,100.0
520080,2016,4,0,0,4,100.0
520080,2017,5,0,0,5,100.0
520080,2018,3,0,0,3,100.0
520080,2019,1,0,0,1,100.0
520080,2020,4,0,0,4,100.0
520082,2014,0,0,2,2,0.0
520082,2016,0,0,1,1,0.0
520082,2020,0,0,1,1,0.0
520085,2012,3,0,0,3,100.0
520085,2013,3,0,0,3,100.0
520085,2014,1,0,0,1,100.0
520085,2015,1,0,0,1,100.0
520085,2016,2,0,0,2,100.0
520085,2017,4,0,0,4,100.0
520085,2018,2,0,0,2,100.0
520085,2019,2,0,0,2,100.0
520085,2020,2,0,1,3,66.66666666666666
520090,2013,0,0,1,1,0.0
520090,2016,0,0,1,1,0.0
520090,2017,0,0,2,2,0.0
520090,2018,2,0,0,2,100.0
520110,2012,123,0,3,126,97.61904761904762
520110,2013,153,0,0,153,100.0
520110,2014,139,0,0,139,100.0
520110,2015,131,0,0,131,100.0
520110,2016,125,0,0,125,100.0
520110,2017,100,0,0,100,100.0
520110,2018,129,0,0,129,100.0
520110,2019,135,0,0,135,100.0
520110,2020,148,0,0,148,100.0
520120,2017,0,0,1,1,0.0
520120,2020,0,0,1,1,0.0
520130,2012,8,0,0,8,100.0
520130,2013,2,0,1,3,66.66666666666666
520130,2014,1,0,4,5,20.0
520130,2015,3,0,1,4,75.0
520130,2016,7,1,0,8,100.0
520130,2017,7,0,0,7,100.0
520130,2018,4,0,0,4,100.0
520130,2019,6,0,0,6,100.0
520130,2020,3,0,0,3,100.0
520140,2012,198,1,4,203,98.0295566502463
520140,2013,206,2,2,210,99.04761904761905
520140,2014,177,3,5,185,97.2972972972973
520140,2015,188,0,0,188,100.0
520140,2016,200,0,0,200,100.0
520140,2017,206,0,0,206,100.0
520140,2018,208,0,0,208,100.0
520140,2019,167,0,0,167,100.0
520140,2020,193,0,0,193,100.0
520145,2012,0,0,1,1,0.0
520145,2013,2,0,0,2,100.0
520145,2016,1,0,0,1,100.0
520145,2019,1,0,0,1,100.0
520145,2020,2,0,0,2,100.0
520150,2012,1,0,0,1,100.0
520150,2013,2,0,0,2,100.0
520150,2014,1,0,0,1,100.0
520150,2015,2,0,0,2,100.0
520150,2016,2,0,0,2,100.0
520150,2017,3,0,0,3,100.0
520150,2018,1,0,0,1,100.0
520150,2019,2,0,0,2,100.0
520150,2020,1,0,0,1,100.0
520160,2012,2,0,0,2,100.0
520160,2015,2,0,0,2,100.0
520160,2016,2,0,0,2,100.0
520160,2017,5,0,0,5,100.0
520160,2018,1,0,0,1,100.0
520160,2019,3,0,0,3,100.0
520160,2020,2,0,0,2,100.0
520170,2012,8,0,3,11,72.72727272727273
520170,2013,6,0,5,11,54.54545454545454
520170,2014,7,1,6,14,57.14285714285714
520170,2015,9,1,0,10,100.0
520170,2016,4,0,0,4,100.0
520170,2017,4,0,0,4,100.0
520170,2018,11,0,0,11,100.0
520170,2019,11,0,0,11,100.0
520170,2020,8,0,0,8,100.0
520180,2012,4,0,0,4,100.0
520180,2013,1,0,0,1,100.0
520180,2014,4,0,0,4,100.0
520180,2015,1,0,0,1,100.0
520180,2016,4,0,0,4,100.0
520180,2017,9,0,0,9,100.0
520180,2018,2,0,0,2,100.0
520180,2019,1,0,0,1,100.0
520180,2020,2,0,1,3,66.66666666666666
520215,2012,0,0,2,2,0.0
520215,2013,0,0,2,2,0.0
520215,2014,0,0,2,2,0.0
520215,2015,5,0,0,5,100.0
520215,2016,0,0,3,3,0.0
520215,2017,1,0,0,1,100.0
520215,2018,2,0,0,2,100.0
520215,2019,4,0,2,6,66.66666666666666
520215,2020,0,0,2,2,0.0
520235,2015,1,0,0,1,100.0
520235,2016,1,0,0,1,100.0
520235,2018,1,0,0,1,100.0
520250,2012,7,0,0,7,100.0
520250,2013,2,0,0,2,100.0
520250,2014,1,0,4,5,20.0
520250,2015,1,0,1,2,50.0
520250,2016,2,0,0,2,100.0
520250,2017,0,0,3,3,0.0
520250,2018,3,0,0,3,100.0
520250,2019,3,0,0,3,100.0
520250,2020,3,0,0,3,100.0
520260,2012,0,0,1,1,0.0
520260,2013,1,0,0,1,100.0
520260,2014,2,0,0,2,100.0
520260,2015,1,0,0,1,100.0
520260,2016,3,0,0,3,100.0
520260,2018,2,0,0,2,100.0
520260,2020,1,0,0,1,100.0
520280,2013,0,0,1,1,0.0
520280,2014,0,0,1,1,0.0
520280,2016,3,0,0,3,100.0
520280,2017,2,0,0,2,100.0
520280,2018,1,0,0,1,100.0
520280,2020,2,0,0,2,100.0
520310,2012,1,0,0,1,100.0
520310,2013,2,0,1,3,66.66666666666666
520310,2014,0,0,1,1,0.0
520310,2016,1,0,0,1,100.0
520310,2017,1,0,0,1,100.0
520310,2020,0,0,1,1,0.0
520320,2012,3,0,0,3,100.0
520320,2014,1,0,0,1,100.0
520320,2015,2,1,0,3,100.0
520320,2016,4,0,1,5,80.0
520320,2017,1,0,0,1,100.0
520320,2018,6,0,0,6,100.0
520320,2019,7,0,0,7,100.0
520320,2020,2,0,0,2,100.0
520330,2012,13,0,0,13,100.0
520330,2013,7,0,3,10,70.0
520330,2014,11,0,0,11,100.0
520330,2015,14,0,0,14,100.0
520330,2016,17,0,0,17,100.0
520330,2017,19,0,0,19,100.0
520330,2018,10,0,0,10,100.0
520330,2019,11,0,0,11,100.0
520330,2020,16,0,0,16,100.0
520340,2012,6,0,0,6,100.0
520340,2013,1,0,0,1,100.0
520340,2014,6,0,0,6,100.0
520340,2015,2,0,0,2,100.0
520340,2016,1,0,0,1,100.0
520340,2017,6,0,0,6,100.0
520340,2018,1,0,0,1,100.0
520340,2019,4,1,0,5,100.0
520340,2020,4,0,0,4,100.0
520350,2012,2,0,2,4,50.0
520350,2013,12,0,1,13,92.3076923076923
520350,2014,7,0,2,9,77.77777777777779
520350,2015,10,0,0,10,100.0
520350,2016,11,0,0,11,100.0
520350,2017,4,0,0,4,100.0
520350,2018,12,0,0,12,100.0
520350,2019,5,0,0,5,100.0
520350,2020,9,0,0,9,100.0
520355,2012,5,0,0,5,100.0
520355,2013,1,0,0,1,100.0
520355,2014,2,0,0,2,100.0
520355,2015,3,0,0,3,100.0
520355,2016,4,0,0,4,100.0
520355,2017,0,0,1,1,0.0
520355,2018,5,0,0,5,100.0
520355,2019,4,0,5,9,44.44444444444444
520355,2020,6,0,0,6,100.0
520357,2012,1,0,1,2,50.0
520357,2015,1,0,0,1,100.0
520357,2016,2,0,0,2,100.0
520357,2017,1,0,0,1,100.0
520357,2018,1,0,0,1,100.0
520357,2020,2,0,0,2,100.0
520360,2012,0,0,1,1,0.0
520360,2013,0,0,1,1,0.0
520360,2014,0,1,1,2,50.0
520360,2015,0,0,1,1,0.0
520360,2016,2,0,0,2,100.0
520360,2019,1,0,2,3,33.33333333333333
520360,2020,1,0,0,1,100.0
520380,2012,6,0,0,6,100.0
520380,2013,1,0,0,1,100.0
520380,2014,2,0,0,2,100.0
520380,2015,5,0,0,5,100.0
520380,2016,2,0,0,2,100.0
520380,2017,1,0,0,1,100.0
520380,2019,4,0,0,4,100.0
520380,2020,2,0,0,2,100.0
520390,2012,1,0,2,3,33.33333333333333
520390,2013,2,0,4,6,33.33333333333333
520390,2014,1,0,2,3,33.33333333333333
520390,2015,3,0,0,3,100.0
520390,2016,1,0,0,1,100.0
520390,2017,4,0,0,4,100.0
520390,2018,2,0,0,2,100.0
520390,2019,4,0,0,4,100.0
520390,2020,4,0,1,5,80.0
520393,2012,0,1,1,2,50.0
520393,2013,0,0,1,1,0.0
520393,2014,1,0,0,1,100.0
520393,2015,2,0,0,2,100.0
520393,2016,1,0,0,1,100.0
520393,2017,1,0,0,1,100.0
520393,2018,1,0,0,1,100.0
520393,2019,2,0,0,2,100.0
520393,2020,1,0,0,1,100.0
520396,2012,2,0,0,2,100.0
520396,2014,0,0,1,1,0.0
520396,2015,1,0,0,1,100.0
520396,2016,0,0,2,2,0.0
520396,2018,1,0,0,1,100.0
520396,2019,1,0,0,1,100.0
520396,2020,1,0,0,1,100.0
520400,2012,2,0,0,2,100.0
520400,2013,2,0,0,2,100.0
520400,2014,4,0,0,4,100.0
520400,2015,1,0,0,1,100.0
520400,2016,2,0,0,2,100.0
520400,2017,5,0,0,5,100.0
520400,2018,2,0,0,2,100.0
520400,2019,1,0,0,1,100.0
520400,2020,4,0,0,4,100.0
520410,2013,5,0,0,5,100.0
520410,2014,3,0,0,3,100.0
520410,2015,2,0,0,2,100.0
520410,2016,2,0,0,2,100.0
520410,2017,4,0,0,4,100.0
520410,2018,3,0,0,3,100.0
520410,2019,2,0,0,2,100.0
520410,2020,6,0,0,6,100.0
520420,2013,1,0,0,1,100.0
520420,2015,1,0,0,1,100.0
520420,2017,2,0,0,2,100.0
520425,2012,5,0,0,5,100.0
520425,2013,3,0,0,3,100.0
520425,2014,3,0,1,4,75.0
520425,2015,5,0,0,5,100.0
520425,2016,2,0,0,2,100.0
520425,2017,4,0,0,4,100.0
520425,2018,1,0,0,1,100.0
520425,2019,1,0,0,1,100.0
520430,2012,4,0,0,4,100.0
520430,2013,5,0,0,5,100.0
520430,2014,5,0,0,5,100.0
520430,2015,2,0,0,2,100.0
520430,2016,3,0,0,3,100.0
520430,2017,2,0,0,2,100.0
520430,2018,4,0,0,4,100.0
520430,2019,7,0,0,7,100.0
520430,2020,3,0,0,3,100.0
520440,2012,5,0,0,5,100.0
520440,2013,7,0,0,7,100.0
520440,2014,5,0,0,5,100.0
520440,2015,6,0,0,6,100.0
520440,2016,6,0,0,6,100.0
520440,2017,5,0,0,5,100.0
520440,2018,10,0,0,10,100.0
520440,2019,11,0,0,11,100.0
520440,2020,8,0,0,8,100.0
520450,2012,18,1,11,30,63.33333333333333
520450,2013,29,0,2,31,93.54838709677419
520450,2014,29,0,0,29,100.0
520450,2015,34,0,0,34,100.0
520450,2016,30,0,0,30,100.0
520450,2017,36,0,0,36,100.0
520450,2018,37,0,0,37,100.0
520450,2019,25,0,0,25,100.0
520450,2020,38,0,0,38,100.0
520455,2012,0,0,1,1,0.0
520455,2013,0,1,1,2,50.0
520455,2014,0,0,1,1,0.0
520455,2017,0,1,0,1,100.0
520455,2019,2,0,0,2,100.0
520455,2020,3,0,0,3,100.0
520460,2012,1,0,0,1,100.0
520460,2013,2,0,0,2,100.0
520460,2014,2,0,0,2,100.0
520460,2015,1,0,0,1,100.0
520460,2016,3,0,0,3,100.0
520460,2017,2,0,0,2,100.0
520460,2019,1,0,0,1,100.0
520465,2014,2,0,1,3,66.66666666666666
520465,2015,0,0,1,1,0.0
520465,2016,2,0,0,2,100.0
520465,2017,1,0,0,1,100.0
520465,2018,3,0,0,3,100.0
520465,2019,2,0,0,2,100.0
520465,2020,3,0,0,3,100.0
520470,2012,4,2,1,7,85.71428571428571
520470,2013,2,0,2,4,50.0
520470,2014,0,0,4,4,0.0
520470,2015,2,0,1,3,66.66666666666666
520470,2016,2,0,0,2,100.0
520470,2017,2,0,1,3,66.66666666666666
520470,2018,2,0,4,6,33.33333333333333
520470,2019,2,1,0,3,100.0
520470,2020,0,0,2,2,0.0
520480,2012,4,0,0,4,100.0
520480,2013,1,0,0,1,100.0
520480,2014,1,0,4,5,20.0
520480,2015,0,0,1,1,0.0
520480,2016,0,1,0,1,100.0
520480,2017,0,0,1,1,0.0
520480,2018,0,0,4,4,0.0
520480,2019,1,1,2,4,50.0
520480,2020,0,0,2,2,0.0
520485,2012,1,0,1,2,50.0
520485,2013,3,0,0,3,100.0
520485,2014,3,0,0,3,100.0
520485,2015,2,0,0,2,100.0
520485,2016,7,0,0,7,100.0
520485,2017,0,0,2,2,0.0
520485,2018,3,0,0,3,100.0
520485,2019,1,0,2,3,33.33333333333333
520485,2020,2,0,0,2,100.0
520490,2012,4,0,3,7,57.14285714285714
520490,2013,7,0,0,7,100.0
520490,2014,8,0,1,9,88.88888888888889
520490,2015,8,0,0,8,100.0
520490,2016,8,0,0,8,100.0
520490,2017,4,0,3,7,57.14285714285714
520490,2018,3,2,8,13,38.46153846153847
520490,2019,15,0,0,15,100.0
520490,2020,11,0,0,11,100.0
520495,2012,1,0,0,1,100.0
520495,2013,1,0,0,1,100.0
520495,2014,2,0,1,3,66.66666666666666
520495,2016,1,0,0,1,100.0
520495,2018,3,0,0,3,100.0
520495,2019,1,0,0,1,100.0
520500,2012,5,0,0,5,100.0
520500,2013,3,0,0,3,100.0
520500,2015,4,0,0,4,100.0
520500,2016,1,0,0,1,100.0
520500,2017,5,0,0,5,100.0
520500,2018,7,0,0,7,100.0
520500,2019,2,0,0,2,100.0
520500,2020,5,0,0,5,100.0
520505,2012,1,0,0,1,100.0
520505,2013,1,0,0,1,100.0
520505,2014,2,0,0,2,100.0
520505,2015,1,0,0,1,100.0
520505,2016,2,0,0,2,100.0
520505,2017,1,0,0,1,100.0
520505,2018,3,0,0,3,100.0
520510,2012,44,0,1,45,97.77777777777777
520510,2013,15,0,5,20,75.0
520510,2014,14,0,10,24,58.333333333333336
520510,2015,36,0,3,39,92.3076923076923
520510,2016,35,1,0,36,100.0
520510,2017,33,0,0,33,100.0
520510,2018,23,0,3,26,88.46153846153845
520510,2019,36,0,0,36,100.0
520510,2020,21,0,5,26,80.76923076923077
520520,2012,1,0,0,1,100.0
520520,2013,1,0,0,1,100.0
520520,2014,3,0,0,3,100.0
520520,2016,3,0,0,3,100.0
520520,2017,1,0,0,1,100.0
520520,2018,2,0,0,2,100.0
520520,2019,0,0,3,3,0.0
520530,2013,1,0,0,1,100.0
520530,2015,2,0,0,2,100.0
520530,2016,4,0,1,5,80.0
520530,2017,6,0,0,6,100.0
520530,2018,5,0,0,5,100.0
520530,2019,1,0,0,1,100.0
520530,2020,1,0,2,3,33.33333333333333
520540,2012,7,0,0,7,100.0
520540,2013,4,0,0,4,100.0
520540,2014,7,0,0,7,100.0
520540,2015,7,0,0,7,100.0
520540,2016,4,0,0,4,100.0
520540,2017,7,0,0,7,100.0
520540,2018,10,0,0,10,100.0
520540,2019,11,0,0,11,100.0
520540,2020,6,0,0,6,100.0
520545,2012,4,0,0,4,100.0
520545,2013,3,0,0,3,100.0
520545,2014,1,0,0,1,100.0
520545,2015,4,0,1,5,80.0
520545,2016,5,0,0,5,100.0
520545,2017,5,0,0,5,100.0
520545,2018,2,0,0,2,100.0
520545,2019,3,0,0,3,100.0
520545,2020,7,0,0,7,100.0
520547,2012,3,0,0,3,100.0
520547,2013,5,0,0,5,100.0
520547,2014,5,0,0,5,100.0
520547,2015,3,0,0,3,100.0
520547,2016,1,0,0,1,100.0
520547,2017,3,0,0,3,100.0
520547,2018,2,0,0,2,100.0
520547,2019,1,0,0,1,100.0
520547,2020,4,0,0,4,100.0
520549,2012,22,0,0,22,100.0
520549,2013,24,0,0,24,100.0
520549,2014,26,0,0,26,100.0
520549,2015,24,0,0,24,100.0
520549,2016,18,0,0,18,100.0
520549,2017,20,1,2,23,91.30434782608695
520549,2018,24,1,0,25,100.0
520549,2019,20,0,0,20,100.0
520549,2020,28,0,0,28,100.0
520551,2012,0,0,1,1,0.0
520551,2013,9,0,1,10,90.0
520551,2014,4,0,1,5,80.0
520551,2015,9,0,0,9,100.0
520551,2016,6,0,0,6,100.0
520551,2017,9,0,0,9,100.0
520551,2018,5,0,0,5,100.0
520551,2019,7,0,0,7,100.0
520551,2020,6,0,0,6,100.0
520552,2012,1,0,2,3,33.33333333333333
520552,2013,1,0,0,1,100.0
520552,2014,2,0,0,2,100.0
520552,2015,1,0,0,1,100.0
520552,2016,3,0,0,3,100.0
520552,2020,3,0,0,3,100.0
520570,2012,1,0,0,1,100.0
520570,2014,1,0,0,1,100.0
520570,2015,1,0,0,1,100.0
520570,2017,2,0,0,2,100.0
520570,2018,1,0,0,1,100.0
520570,2020,2,0,0,2,100.0
520580,2012,1,0,2,3,33.33333333333333
520580,2013,3,1,0,4,100.0
520580,2014,3,0,0,3,100.0
520580,2015,1,0,0,1,100.0
520580,2016,1,0,0,1,100.0
520580,2017,4,0,0,4,100.0
520580,2018,2,0,0,2,100.0
520580,2019,2,0,0,2,100.0
520580,2020,2,0,1,3,66.66666666666666
520590,2012,3,0,0,3,100.0
520590,2013,1,0,0,1,100.0
520590,2014,5,0,0,5,100.0
520590,2015,4,0,0,4,100.0
520590,2016,1,0,0,1,100.0
520590,2017,4,0,0,4,100.0
520590,2018,2,0,0,2,100.0
520590,2019,2,0,0,2,100.0
520590,2020,5,0,0,5,100.0
520620,2012,19,0,2,21,90.47619047619048
520620,2013,24,0,0,24,100.0
520620,2014,20,0,0,20,100.0
520620,2015,19,0,0,19,100.0
520620,2016,18,0,0,18,100.0
520620,2017,15,0,1,16,93.75
520620,2018,21,0,0,21,100.0
520620,2019,21,0,0,21,100.0
520620,2020,28,0,0,28,100.0
520630,2012,3,0,0,3,100.0
520630,2014,1,0,0,1,100.0
520630,2016,0,0,1,1,0.0
520630,2017,2,1,0,3,100.0
520630,2019,0,0,1,1,0.0
520630,2020,2,0,0,2,100.0
520640,2012,8,0,0,8,100.0
520640,2013,9,0,0,9,100.0
520640,2014,4,0,0,4,100.0
520640,2015,5,0,0,5,100.0
520640,2016,5,0,0,5,100.0
520640,2017,10,0,0,10,100.0
520640,2018,6,0,0,6,100.0
520640,2019,7,0,0,7,100.0
520640,2020,6,0,0,6,100.0
520650,2014,1,0,0,1,100.0
520650,2016,0,0,1,1,0.0
520650,2017,1,0,0,1,100.0
520650,2019,0,0,1,1,0.0
520650,2020,3,0,0,3,100.0
520660,2015,0,0,1,1,0.0
520660,2017,1,0,0,1,100.0
520660,2019,0,0,1,1,0.0
520660,2020,4,0,0,4,100.0
520670,2015,4,0,0,4,100.0
520670,2016,1,0,0,1,100.0
520670,2017,1,0,1,2,50.0
520680,2013,0,0,1,1,0.0
520680,2015,3,0,0,3,100.0
520680,2016,1,0,0,1,100.0
520680,2018,1,0,0,1,100.0
520680,2019,0,1,1,2,50.0
520680,2020,1,0,0,1,100.0
520690,2012,1,0,0,1,100.0
520690,2013,0,0,1,1,0.0
520690,2016,0,0,1,1,0.0
520690,2018,0,0,1,1,0.0
520710,2012,1,0,0,1,100.0
520710,2013,1,0,0,1,100.0
520710,2020,0,0,2,2,0.0
520725,2012,2,0,1,3,66.66666666666666
520725,2014,5,0,0,5,100.0
520725,2015,2,0,0,2,100.0
520725,2016,2,0,0,2,100.0
520725,2017,2,0,0,2,100.0
520725,2018,1,0,0,1,100.0
520725,2019,0,0,2,2,0.0
520725,2020,2,0,0,2,100.0
520735,2012,0,0,1,1,0.0
520735,2013,1,0,0,1,100.0
520735,2015,2,0,0,2,100.0
520735,2016,1,0,0,1,100.0
520735,2017,2,0,0,2,100.0
520735,2018,1,0,0,1,100.0
520735,2019,1,0,0,1,100.0
520735,2020,3,0,0,3,100.0
520740,2012,6,0,1,7,85.71428571428571
520740,2013,5,0,0,5,100.0
520740,2014,6,0,0,6,100.0
520740,2015,2,0,0,2,100.0
520740,2016,2,0,1,3,66.66666666666666
520740,2017,5,0,0,5,100.0
520740,2018,2,0,0,2,100.0
520740,2019,6,0,0,6,100.0
520740,2020,4,0,0,4,100.0
520750,2012,2,0,0,2,100.0
520750,2013,0,0,2,2,0.0
520750,2014,3,0,0,3,100.0
520750,2015,0,0,1,1,0.0
520750,2016,0,0,2,2,0.0
520750,2017,1,0,1,2,50.0
520750,2018,0,0,1,1,0.0
520750,2019,1,0,2,3,33.33333333333333
520750,2020,0,0,3,3,0.0
520753,2012,2,0,0,2,100.0
520753,2013,2,1,0,3,100.0
520753,2014,0,0,1,1,0.0
520753,2015,1,0,1,2,50.0
520753,2016,0,0,2,2,0.0
520753,2017,2,0,0,2,100.0
520753,2018,2,0,0,2,100.0
520753,2019,4,0,0,4,100.0
520753,2020,2,0,0,2,100.0
520760,2012,3,0,0,3,100.0
520760,2013,0,0,2,2,0.0
520760,2014,0,1,1,2,50.0
520760,2015,0,0,1,1,0.0
520760,2017,1,0,0,1,100.0
520760,2018,2,0,0,2,100.0
520760,2019,3,0,0,3,100.0
520780,2012,3,0,0,3,100.0
520780,2013,1,0,0,1,100.0
520780,2015,3,0,0,3,100.0
520780,2016,3,0,0,3,100.0
520780,2017,3,0,0,3,100.0
520780,2018,3,0,0,3,100.0
520780,2019,5,0,0,5,100.0
520780,2020,1,0,0,1,100.0
520790,2012,5,0,0,5,100.0
520790,2013,1,0,0,1,100.0
520790,2014,2,0,0,2,100.0
520790,2015,1,0,0,1,100.0
520790,2016,1,0,0,1,100.0
520790,2017,1,0,0,1,100.0
520790,2018,3,0,0,3,100.0
520790,2019,1,0,0,1,100.0
520790,2020,2,0,0,2,100.0
520800,2012,14,3,27,44,38.63636363636363
520800,2013,34,1,2,37,94.5945945945946
520800,2014,35,3,11,49,77.55102040816327
520800,2015,38,0,0,38,100.0
520800,2016,41,1,1,43,97.67441860465115
520800,2017,30,4,4,38,89.47368421052632
520800,2018,38,4,8,50,84.0
520800,2019,31,2,11,44,75.0
520800,2020,37,1,4,42,90.47619047619048
520810,2013,0,0,4,4,0.0
520810,2014,0,0,1,1,0.0
520810,2016,1,0,2,3,33.33333333333333
520810,2018,2,0,1,3,66.66666666666666
520810,2019,0,0,1,1,0.0
520815,2015,1,0,0,1,100.0
520815,2016,1,0,0,1,100.0
520815,2017,2,0,0,2,100.0
520815,2018,1,0,0,1,100.0
520815,2019,1,0,0,1,100.0
520815,2020,1,0,0,1,100.0
520830,2012,0,0,1,1,0.0
520830,2013,1,0,1,2,50.0
520830,2014,0,0,1,1,0.0
520830,2015,3,0,0,3,100.0
520830,2016,3,0,0,3,100.0
520830,2017,1,0,1,2,50.0
520830,2018,0,1,0,1,100.0
520830,2019,5,0,0,5,100.0
520840,2012,4,0,0,4,100.0
520840,2013,4,0,0,4,100.0
520840,2014,5,0,1,6,83.33333333333334
520840,2015,3,0,0,3,100.0
520840,2016,2,0,0,2,100.0
520840,2017,4,0,0,4,100.0
520840,2018,4,0,0,4,100.0
520840,2019,4,0,0,4,100.0
520840,2020,4,0,0,4,100.0
520850,2014,0,1,2,3,33.33333333333333
520850,2015,0,0,2,2,0.0
520850,2017,2,0,1,3,66.66666666666666
520850,2018,1,1,0,2,100.0
520850,2020,0,0,1,1,0.0
520860,2012,20,0,0,20,100.0
520860,2013,25,0,0,25,100.0
520860,2014,17,0,1,18,94.44444444444444
520860,2015,17,0,0,17,100.0
520860,2016,25,0,0,25,100.0
520860,2017,18,0,0,18,100.0
520860,2018,21,0,0,21,100.0
520860,2019,20,0,2,22,90.9090909090909
520860,2020,35,0,0,35,100.0
520870,2012,472,1,0,473,100.0
520870,2013,485,0,0,485,100.0
520870,2014,486,0,1,487,99.7946611909651
520870,2015,463,0,0,463,100.0
520870,2016,437,0,0,437,100.0
520870,2017,413,0,0,413,100.0
520870,2018,404,0,0,404,100.0
520870,2019,394,0,0,394,100.0
520870,2020,518,0,0,518,100.0
520880,2012,13,1,0,14,100.0
520880,2013,12,0,0,12,100.0
520880,2014,19,1,0,20,100.0
520880,2015,16,0,1,17,94.11764705882352
520880,2016,21,0,0,21,100.0
520880,2017,23,0,0,23,100.0
520880,2018,37,0,0,37,100.0
520880,2019,18,0,0,18,100.0
520880,2020,33,0,0,33,100.0
520890,2012,8,0,1,9,88.88888888888889
520890,2013,6,0,0,6,100.0
520890,2014,5,2,5,12,58.333333333333336
520890,2015,7,0,0,7,100.0
520890,2016,4,0,3,7,57.14285714285714
520890,2017,15,0,0,15,100.0
520890,2018,14,0,0,14,100.0
520890,2019,8,0,0,8,100.0
520890,2020,3,0,6,9,33.33333333333333
520910,2012,7,0,0,7,100.0
520910,2013,9,0,0,9,100.0
520910,2014,13,0,1,14,92.85714285714286
520910,2015,13,0,0,13,100.0
520910,2016,9,0,0,9,100.0
520910,2017,14,0,0,14,100.0
520910,2018,15,0,0,15,100.0
520910,2019,15,0,0,15,100.0
520910,2020,6,0,0,6,100.0
520915,2012,0,1,0,1,100.0
520915,2013,0,0,1,1,0.0
520915,2014,2,0,0,2,100.0
520915,2015,1,0,0,1,100.0
520915,2016,2,0,0,2,100.0
520915,2018,1,0,0,1,100.0
520915,2020,1,0,0,1,100.0
520920,2012,9,0,0,9,100.0
520920,2013,2,1,0,3,100.0
520920,2014,4,0,0,4,100.0
520920,2015,7,0,0,7,100.0
520920,2016,7,0,0,7,100.0
520920,2017,7,0,0,7,100.0
520920,2018,6,0,0,6,100.0
520920,2019,5,0,3,8,62.5
520920,2020,1,0,9,10,10.0
520929,2012,0,0,1,1,0.0
520929,2013,1,0,1,2,50.0
520929,2014,0,0,1,1,0.0
520929,2016,0,1,2,3,33.33333333333333
520929,2020,0,0,1,1,0.0
520940,2012,1,0,0,1,100.0
520940,2015,1,0,0,1,100.0
520940,2016,1,0,0,1,100.0
520940,2017,1,0,0,1,100.0
520940,2018,1,0,0,1,100.0
520940,2019,1,0,0,1,100.0
520940,2020,1,0,0,1,100.0
520945,2013,2,0,0,2,100.0
520945,2014,1,0,1,2,50.0
520945,2017,1,0,0,1,100.0
520960,2012,2,0,0,2,100.0
520960,2013,2,0,0,2,100.0
520960,2014,1,0,0,1,100.0
520960,2015,3,0,0,3,100.0
520960,2016,1,0,0,1,100.0
520960,2018,1,0,0,1,100.0
520960,2020,0,0,1,1,0.0
520970,2012,5,0,0,5,100.0
520970,2013,8,0,0,8,100.0
520970,2014,8,0,0,8,100.0
520970,2015,3,0,0,3,100.0
520970,2016,11,0,0,11,100.0
520970,2017,7,0,0,7,100.0
520970,2018,11,0,0,11,100.0
520970,2019,11,0,0,11,100.0
520970,2020,12,0,0,12,100.0
520980,2012,1,0,0,1,100.0
520980,2013,1,0,0,1,100.0
520980,2014,0,0,2,2,0.0
520980,2015,0,1,1,2,50.0
520980,2017,0,0,2,2,0.0
520980,2018,0,0,1,1,0.0
520990,2012,3,0,1,4,75.0
520990,2013,3,0,0,3,100.0
520990,2014,12,0,0,12,100.0
520990,2015,6,0,0,6,100.0
520990,2016,1,2,0,3,100.0
520990,2017,4,0,1,5,80.0
520990,2018,2,2,0,4,100.0
520990,2020,1,0,0,1,100.0
520993,2012,2,0,0,2,100.0
520993,2013,0,1,2,3,33.33333333333333
520993,2014,2,0,1,3,66.66666666666666
520993,2016,1,0,0,1,100.0
520993,2017,1,0,0,1,100.0
520993,2018,1,0,0,1,100.0
520993,2019,1,0,0,1,100.0
520993,2020,3,0,0,3,100.0
520995,2012,0,1,5,6,16.666666666666664
520995,2013,7,0,0,7,100.0
520995,2014,1,1,2,4,50.0
520995,2015,3,0,0,3,100.0
520995,2016,5,0,0,5,100.0
520995,2017,8,0,0,8,100.0
520995,2018,5,0,0,5,100.0
520995,2019,6,0,0,6,100.0
520995,2020,12,0,0,12,100.0
521000,2012,21,0,0,21,100.0
521000,2013,15,0,0,15,100.0
521000,2014,16,0,0,16,100.0
521000,2015,19,0,0,19,100.0
521000,2016,23,1,3,27,88.88888888888889
521000,2017,23,0,0,23,100.0
521000,2018,9,0,0,9,100.0
521000,2019,21,0,0,21,100.0
521000,2020,16,0,0,16,100.0
521010,2012,8,0,1,9,88.88888888888889
521010,2013,2,0,8,10,20.0
521010,2014,9,0,0,9,100.0
521010,2015,10,0,0,10,100.0
521010,2016,10,0,0,10,100.0
521010,2017,5,0,0,5,100.0
521010,2018,11,0,0,11,100.0
521010,2019,9,0,0,9,100.0
521010,2020,6,0,0,6,100.0
521015,2013,1,0,0,1,100.0
521015,2014,1,0,0,1,100.0
521015,2015,1,0,0,1,100.0
521015,2016,1,0,0,1,100.0
521015,2017,1,0,0,1,100.0
521015,2018,0,1,0,1,100.0
521015,2019,2,0,0,2,100.0
521020,2012,8,0,2,10,80.0
521020,2013,11,0,1,12,91.66666666666666
521020,2014,15,0,3,18,83.33333333333334
521020,2015,12,0,0,12,100.0
521020,2016,16,0,0,16,100.0
521020,2017,17,0,1,18,94.44444444444444
521020,2018,16,0,0,16,100.0
521020,2019,8,0,0,8,100.0
521020,2020,17,0,1,18,94.44444444444444
521030,2012,1,0,0,1,100.0
521030,2013,4,0,0,4,100.0
521030,2015,1,0,0,1,100.0
521030,2016,0,1,0,1,100.0
521030,2017,1,0,0,1,100.0
521040,2012,18,0,0,18,100.0
521040,2013,15,0,0,15,100.0
521040,2014,16,0,0,16,100.0
521040,2015,13,0,0,13,100.0
521040,2016,6,1,2,9,77.77777777777779
521040,2017,12,0,0,12,100.0
521040,2018,18,0,0,18,100.0
521040,2019,12,0,0,12,100.0
521040,2020,13,0,0,13,100.0
521056,2012,0,0,5,5,0.0
521056,2013,0,0,1,1,0.0
521056,2014,0,0,2,2,0.0
521056,2016,1,0,1,2,50.0
521056,2018,1,0,0,1,100.0
521056,2020,2,0,0,2,100.0
521060,2012,2,0,0,2,100.0
521060,2014,2,0,0,2,100.0
521060,2015,2,0,0,2,100.0
521060,2016,1,0,0,1,100.0
521060,2019,3,0,0,3,100.0
521080,2012,2,0,0,2,100.0
521080,2013,1,0,0,1,100.0
521080,2014,2,0,0,2,100.0
521080,2015,3,0,0,3,100.0
521080,2016,2,0,0,2,100.0
521080,2017,2,0,0,2,100.0
521080,2018,1,0,0,1,100.0
521080,2019,1,0,0,1,100.0
521080,2020,1,0,0,1,100.0
521090,2012,5,0,0,5,100.0
521090,2013,7,0,0,7,100.0
521090,2014,7,0,0,7,100.0
521090,2015,4,0,0,4,100.0
521090,2016,4,0,0,4,100.0
521090,2017,8,0,0,8,100.0
521090,2018,4,0,0,4,100.0
521090,2019,7,0,0,7,100.0
521090,2020,5,0,0,5,100.0
521100,2012,3,0,0,3,100.0
521100,2013,1,0,1,2,50.0
521100,2014,0,0,2,2,0.0
521100,2015,3,0,0,3,100.0
521100,2016,0,0,3,3,0.0
521100,2017,1,0,1,2,50.0
521100,2018,1,0,1,2,50.0
521100,2019,1,0,0,1,100.0
521100,2020,1,2,1,4,75.0
521120,2012,7,0,1,8,87.5
521120,2013,8,0,3,11,72.72727272727273
521120,2014,0,1,5,6,16.666666666666664
521120,2015,2,0,10,12,16.666666666666664
521120,2016,6,0,2,8,75.0
521120,2017,3,0,4,7,42.857142857142854
521120,2018,9,0,0,9,100.0
521120,2019,5,2,1,8,87.5
521120,2020,3,0,7,10,30.0
521130,2012,3,0,0,3,100.0
521130,2013,4,0,0,4,100.0
521130,2014,3,0,1,4,75.0
521130,2015,2,0,0,2,100.0
521130,2018,3,0,0,3,100.0
521130,2019,4,0,0,4,100.0
521130,2020,6,0,0,6,100.0
521140,2012,3,0,1,4,75.0
521140,2013,2,0,0,2,100.0
521140,2014,1,0,0,1,100.0
521140,2015,3,0,0,3,100.0
521140,2016,5,0,0,5,100.0
521140,2017,5,0,0,5,100.0
521140,2018,2,0,0,2,100.0
521150,2012,33,1,0,34,100.0
521150,2013,40,1,0,41,100.0
521150,2014,38,0,1,39,97.43589743589743
521150,2015,35,0,0,35,100.0
521150,2016,40,0,0,40,100.0
521150,2017,30,0,1,31,96.7741935483871
521150,2018,31,3,3,37,91.8918918918919
521150,2019,25,0,1,26,96.15384615384616
521150,2020,46,0,0,46,100.0
521160,2013,1,0,0,1,100.0
521160,2015,1,0,0,1,100.0
521160,2016,0,1,0,1,100.0
521160,2018,2,0,0,2,100.0
521160,2020,0,0,1,1,0.0
521170,2012,3,0,0,3,100.0
521170,2013,2,0,0,2,100.0
521170,2014,1,0,0,1,100.0
521170,2015,2,0,0,2,100.0
521170,2016,3,0,0,3,100.0
521170,2017,1,0,0,1,100.0
521170,2018,2,0,0,2,100.0
521170,2019,3,0,0,3,100.0
521170,2020,2,0,0,2,100.0
521180,2012,11,0,0,11,100.0
521180,2013,18,0,0,18,100.0
521180,2014,15,0,0,15,100.0
521180,2015,14,0,0,14,100.0
521180,2016,19,0,0,19,100.0
521180,2017,8,0,2,10,80.0
521180,2018,14,0,1,15,93.33333333333333
521180,2019,14,0,1,15,93.33333333333333
521180,2020,18,0,0,18,100.0
521190,2012,37,0,0,37,100.0
521190,2013,35,0,0,35,100.0
521190,2014,41,0,0,41,100.0
521190,2015,36,0,0,36,100.0
521190,2016,42,0,0,42,100.0
521190,2017,27,0,0,27,100.0
521190,2018,30,0,0,30,100.0
521190,2019,26,0,1,27,96.29629629629629
521190,2020,38,0,0,38,100.0
521200,2012,1,0,0,1,100.0
521200,2013,5,0,0,5,100.0
521200,2014,1,0,0,1,100.0
521200,2015,0,0,1,1,0.0
521200,2016,1,0,1,2,50.0
521200,2017,1,0,1,2,50.0
521200,2018,1,0,2,3,33.33333333333333
521205,2012,2,0,0,2,100.0
521205,2013,1,0,0,1,100.0
521205,2016,1,0,0,1,100.0
521205,2018,1,0,0,1,100.0
521205,2019,2,0,0,2,100.0
521210,2012,2,0,0,2,100.0
521210,2013,3,0,0,3,100.0
521210,2014,1,0,0,1,100.0
521210,2015,1,0,0,1,100.0
521210,2016,1,0,0,1,100.0
521210,2017,3,0,0,3,100.0
521210,2018,2,0,0,2,100.0
521210,2019,5,0,0,5,100.0
521210,2020,4,0,0,4,100.0
521220,2012,5,0,0,5,100.0
521220,2013,7,0,0,7,100.0
521220,2014,2,0,5,7,28.57142857142857
521220,2015,16,0,0,16,100.0
521220,2016,5,0,0,5,100.0
521220,2017,15,0,0,15,100.0
521220,2018,5,0,0,5,100.0
521220,2019,6,0,0,6,100.0
521220,2020,4,0,0,4,100.0
521225,2013,0,2,0,2,100.0
521225,2014,1,0,0,1,100.0
521225,2017,1,0,0,1,100.0
521225,2018,1,0,0,1,100.0
521230,2012,0,0,2,2,0.0
521230,2013,1,1,0,2,100.0
521230,2014,0,1,1,2,50.0
521230,2015,1,1,2,4,50.0
521230,2016,3,0,0,3,100.0
521230,2017,2,0,1,3,66.66666666666666
521230,2018,0,0,3,3,0.0
521230,2019,1,1,2,4,50.0
521230,2020,3,0,0,3,100.0
521250,2012,50,6,16,72,77.77777777777779
521250,2013,65,4,1,70,98.57142857142858
521250,2014,75,0,0,75,100.0
521250,2015,77,0,0,77,100.0
521250,2016,65,0,9,74,87.83783783783784
521250,2017,73,0,3,76,96.05263157894737
521250,2018,74,2,3,79,96.20253164556962
521250,2019,62,2,2,66,96.96969696969697
521250,2020,64,1,9,74,87.83783783783784
521260,2014,0,0,1,1,0.0
521260,2016,0,0,1,1,0.0
521260,2017,2,0,0,2,100.0
521260,2019,1,0,0,1,100.0
521260,2020,1,0,0,1,100.0
521270,2012,0,1,3,4,25.0
521270,2013,1,0,0,1,100.0
521270,2014,2,1,0,3,100.0
521270,2015,3,0,0,3,100.0
521270,2016,4,0,0,4,100.0
521270,2017,2,0,0,2,100.0
521270,2018,7,0,0,7,100.0
521270,2019,3,0,0,3,100.0
521270,2020,2,0,0,2,100.0
521280,2012,3,0,0,3,100.0
521280,2013,2,0,0,2,100.0
521280,2014,1,0,1,2,50.0
521280,2015,4,0,0,4,100.0
521280,2016,5,0,0,5,100.0
521280,2017,1,0,0,1,100.0
521280,2018,3,0,0,3,100.0
521280,2019,7,0,1,8,87.5
521280,2020,0,0,1,1,0.0
521290,2012,0,0,4,4,0.0
521290,2013,0,0,1,1,0.0
521290,2015,0,0,1,1,0.0
521290,2016,1,0,1,2,50.0
521290,2019,1,0,0,1,100.0
521295,2012,0,0,3,3,0.0
521295,2014,0,0,4,4,0.0
521295,2015,4,1,1,6,83.33333333333334
521295,2016,2,0,1,3,66.66666666666666
521295,2017,0,0,1,1,0.0
521295,2018,1,0,0,1,100.0
521295,2019,0,2,0,2,100.0
521295,2020,0,0,1,1,0.0
521300,2012,7,0,0,7,100.0
521300,2013,2,0,0,2,100.0
521300,2014,0,0,8,8,0.0
521300,2015,3,0,0,3,100.0
521300,2016,5,0,0,5,100.0
521300,2017,3,0,0,3,100.0
521300,2018,8,0,0,8,100.0
521300,2019,7,0,0,7,100.0
521300,2020,8,0,0,8,100.0
521305,2014,1,1,0,2,100.0
521308,2012,10,0,0,10,100.0
521308,2013,8,0,0,8,100.0
521308,2014,13,0,0,13,100.0
521308,2015,9,0,0,9,100.0
521308,2016,8,0,0,8,100.0
521308,2017,8,0,0,8,100.0
521308,2018,8,0,0,8,100.0
521308,2019,12,0,0,12,100.0
521308,2020,9,0,0,9,100.0
521310,2012,27,0,0,27,100.0
521310,2013,28,0,0,28,100.0
521310,2014,24,0,0,24,100.0
521310,2015,21,0,0,21,100.0
521310,2016,14,0,0,14,100.0
521310,2017,25,0,0,25,100.0
521310,2018,25,0,0,25,100.0
521310,2019,13,0,0,13,100.0
521310,2020,32,0,0,32,100.0
521340,2012,1,0,0,1,100.0
521340,2013,1,0,1,2,50.0
521340,2015,1,0,0,1,100.0
521340,2016,1,0,0,1,100.0
521340,2018,1,0,0,1,100.0
521340,2019,1,0,0,1,100.0
521350,2012,4,0,4,8,50.0
521350,2013,2,0,0,2,100.0
521350,2014,2,0,0,2,100.0
521350,2015,4,0,0,4,100.0
521350,2016,2,0,0,2,100.0
521350,2017,2,0,3,5,40.0
521350,2018,0,1,3,4,25.0
521350,2019,1,0,0,1,100.0
521350,2020,2,0,0,2,100.0
521370,2012,2,0,0,2,100.0
521370,2013,3,0,0,3,100.0
521370,2014,2,0,0,2,100.0
521370,2015,5,0,0,5,100.0
521370,2017,2,0,0,2,100.0
521370,2018,2,0,0,2,100.0
521370,2019,4,0,0,4,100.0
521370,2020,3,0,0,3,100.0
521375,2012,1,1,3,5,40.0
521375,2013,2,0,3,5,40.0
521375,2014,0,0,3,3,0.0
521375,2015,5,0,0,5,100.0
521375,2016,2,0,0,2,100.0
521375,2017,5,0,0,5,100.0
521375,2018,5,0,0,5,100.0
521375,2019,5,0,0,5,100.0
521375,2020,4,0,0,4,100.0
521377,2015,0,0,2,2,0.0
521377,2016,0,0,1,1,0.0
521377,2017,1,0,0,1,100.0
521377,2018,1,0,0,1,100.0
521377,2019,3,0,0,3,100.0
521377,2020,1,0,0,1,100.0
521380,2012,20,0,0,20,100.0
521380,2013,10,0,0,10,100.0
521380,2014,17,0,1,18,94.44444444444444
521380,2015,12,0,0,12,100.0
521380,2016,19,0,0,19,100.0
521380,2017,13,0,0,13,100.0
521380,2018,22,0,0,22,100.0
521380,2019,18,0,0,18,100.0
521380,2020,15,0,0,15,100.0
521385,2012,2,0,0,2,100.0
521385,2014,1,0,0,1,100.0
521385,2015,2,0,0,2,100.0
521385,2017,2,0,0,2,100.0
521385,2018,1,0,0,1,100.0
521385,2019,1,0,0,1,100.0
521390,2012,1,0,0,1,100.0
521390,2014,0,1,2,3,33.33333333333333
521390,2016,0,1,0,1,100.0
521390,2017,4,0,0,4,100.0
521390,2018,1,0,0,1,100.0
521390,2020,0,0,3,3,0.0
521400,2012,4,0,0,4,100.0
521400,2014,1,0,2,3,33.33333333333333
521400,2015,1,4,1,6,83.33333333333334
521400,2016,4,0,0,4,100.0
521400,2017,5,0,0,5,100.0
521400,2018,5,0,0,5,100.0
521400,2019,2,0,0,2,100.0
521400,2020,6,0,0,6,100.0
521405,2013,0,1,2,3,33.33333333333333
521405,2014,0,0,1,1,0.0
521405,2015,4,0,0,4,100.0
521405,2016,3,0,0,3,100.0
521405,2017,3,0,0,3,100.0
521405,2018,0,0,1,1,0.0
521405,2019,1,0,0,1,100.0
521405,2020,0,0,6,6,0.0
521410,2012,1,0,0,1,100.0
521410,2014,0,0,1,1,0.0
521410,2015,1,0,0,1,100.0
521410,2016,0,0,1,1,0.0
521410,2017,1,0,2,3,33.33333333333333
521410,2018,2,0,0,2,100.0
521410,2020,0,0,1,1,0.0
521440,2012,4,0,2,6,66.66666666666666
521440,2013,5,0,0,5,100.0
521440,2014,1,0,0,1,100.0
521440,2015,4,0,0,4,100.0
521440,2016,6,0,0,6,100.0
521440,2017,2,0,0,2,100.0
521440,2018,2,0,0,2,100.0
521440,2019,3,0,0,3,100.0
521440,2020,3,0,0,3,100.0
521450,2012,1,3,9,13,30.76923076923077
521450,2013,2,2,4,8,50.0
521450,2014,3,1,9,13,30.76923076923077
521450,2015,13,1,3,17,82.35294117647058
521450,2016,9,0,0,9,100.0
521450,2017,9,0,0,9,100.0
521450,2018,12,1,0,13,100.0
521450,2019,1,3,6,10,40.0
521450,2020,9,0,0,9,100.0
521460,2012,8,0,1,9,88.88888888888889
521460,2013,9,0,1,10,90.0
521460,2014,9,0,1,10,90.0
521460,2015,11,0,1,12,91.66666666666666
521460,2016,12,0,0,12,100.0
521460,2017,10,0,0,10,100.0
521460,2018,8,0,0,8,100.0
521460,2019,12,0,0,12,100.0
521460,2020,13,0,0,13,100.0
521470,2012,2,0,0,2,100.0
521470,2014,0,0,2,2,0.0
521470,2015,1,0,0,1,100.0
521470,2016,1,0,0,1,100.0
521470,2017,1,0,0,1,100.0
521470,2018,1,0,0,1,100.0
521470,2020,1,0,0,1,100.0
521480,2012,0,0,1,1,0.0
521480,2013,1,0,0,1,100.0
521480,2015,0,0,1,1,0.0
521480,2018,1,0,0,1,100.0
521480,2020,0,0,1,1,0.0
521483,2012,4,0,0,4,100.0
521483,2013,1,0,1,2,50.0
521483,2014,0,0,3,3,0.0
521483,2015,3,0,0,3,100.0
521483,2016,2,0,1,3,66.66666666666666
521483,2017,1,1,3,5,40.0
521483,2018,8,0,0,8,100.0
521483,2019,8,0,0,8,100.0
521483,2020,0,1,0,1,100.0
521486,2012,2,0,0,2,100.0
521486,2013,4,0,0,4,100.0
521486,2014,4,0,0,4,100.0
521486,2015,2,0,0,2,100.0
521486,2016,3,0,0,3,100.0
521486,2017,4,0,0,4,100.0
521486,2018,2,0,0,2,100.0
521486,2019,2,0,0,2,100.0
521486,2020,3,0,0,3,100.0
521487,2014,0,0,2,2,0.0
521487,2015,0,0,2,2,0.0
521487,2018,1,0,0,1,100.0
521487,2019,1,0,1,2,50.0
521490,2016,0,0,1,1,0.0
521490,2017,1,0,0,1,100.0
521490,2018,1,0,0,1,100.0
521490,2019,1,0,0,1,100.0
521500,2012,3,0,0,3,100.0
521500,2013,2,0,0,2,100.0
521500,2014,3,0,0,3,100.0
521500,2015,5,0,0,5,100.0
521500,2016,5,0,0,5,100.0
521500,2018,1,0,0,1,100.0
521500,2019,3,0,0,3,100.0
521500,2020,7,0,0,7,100.0
521520,2012,1,0,0,1,100.0
521520,2014,2,0,0,2,100.0
521520,2015,1,0,1,2,50.0
521520,2016,1,0,1,2,50.0
521520,2018,0,0,1,1,0.0
521520,2019,3,0,0,3,100.0
521520,2020,0,1,2,3,33.33333333333333
521523,2012,21,3,7,31,77.41935483870968
521523,2013,37,0,3,40,92.5
521523,2014,32,4,6,42,85.71428571428571
521523,2015,16,3,14,33,57.57575757575758
521523,2016,25,1,8,34,76.47058823529412
521523,2017,31,1,1,33,96.96969696969697
521523,2018,28,0,1,29,96.55172413793103
521523,2019,21,3,3,27,88.88888888888889
521523,2020,47,1,0,48,100.0
521525,2013,0,0,2,2,0.0
521525,2015,0,0,1,1,0.0
521525,2016,0,0,3,3,0.0
521525,2018,0,0,2,2,0.0
521525,2019,0,0,1,1,0.0
521530,2012,3,0,0,3,100.0
521530,2013,11,0,0,11,100.0
521530,2014,5,0,0,5,100.0
521530,2015,8,0,0,8,100.0
521530,2016,4,0,0,4,100.0
521530,2017,8,0,0,8,100.0
521530,2018,3,0,0,3,100.0
521530,2019,6,0,0,6,100.0
521530,2020,6,0,1,7,85.71428571428571
521540,2012,2,0,0,2,100.0
521540,2014,1,0,0,1,100.0
521540,2015,2,0,0,2,100.0
521540,2016,2,0,0,2,100.0
521540,2017,1,0,0,1,100.0
521540,2018,2,0,0,2,100.0
521540,2019,4,0,0,4,100.0
521540,2020,2,0,0,2,100.0
521550,2013,2,0,0,2,100.0
521550,2015,1,0,1,2,50.0
521550,2016,0,0,2,2,0.0
521550,2017,2,0,0,2,100.0
521550,2019,1,0,0,1,100.0
521550,2020,3,0,0,3,100.0
521560,2012,11,0,1,12,91.66666666666666
521560,2013,11,0,0,11,100.0
521560,2014,8,0,0,8,100.0
521560,2015,8,0,0,8,100.0
521560,2016,4,0,3,7,57.14285714285714
521560,2017,1,4,10,15,33.33333333333333
521560,2018,0,1,10,11,9.090909090909092
521560,2019,3,1,7,11,36.36363636363637
521560,2020,0,2,14,16,12.5
521565,2012,1,0,1,2,50.0
521565,2013,0,0,1,1,0.0
521565,2015,1,0,0,1,100.0
521565,2017,0,0,1,1,0.0
521565,2018,1,0,0,1,100.0
521565,2020,0,0,2,2,0.0
521570,2012,6,0,1,7,85.71428571428571
521570,2013,12,0,0,12,100.0
521570,2014,10,0,0,10,100.0
521570,2015,15,0,0,15,100.0
521570,2016,8,0,0,8,100.0
521570,2017,10,0,0,10,100.0
521570,2018,6,0,0,6,100.0
521570,2019,11,0,0,11,100.0
521570,2020,13,0,0,13,100.0
521580,2012,2,0,0,2,100.0
521580,2013,0,0,1,1,0.0
521580,2014,0,0,1,1,0.0
521580,2015,0,0,1,1,0.0
521580,2016,0,0,2,2,0.0
521580,2018,0,1,2,3,33.33333333333333
521580,2019,0,0,1,1,0.0
521580,2020,0,0,1,1,0.0
521590,2012,1,0,0,1,100.0
521590,2013,1,0,0,1,100.0
521590,2014,1,0,0,1,100.0
521590,2015,1,0,0,1,100.0
521590,2016,1,0,0,1,100.0
521590,2017,1,0,0,1,100.0
521590,2018,2,0,0,2,100.0
521590,2020,1,0,0,1,100.0
521600,2014,0,0,1,1,0.0
521600,2018,2,0,0,2,100.0
521600,2019,1,0,0,1,100.0
521630,2012,1,0,0,1,100.0
521630,2013,6,0,0,6,100.0
521630,2014,7,0,0,7,100.0
521630,2015,1,0,0,1,100.0
521630,2016,2,0,0,2,100.0
521630,2019,1,0,0,1,100.0
521630,2020,2,0,0,2,100.0
521640,2012,6,1,0,7,100.0
521640,2013,2,0,0,2,100.0
521640,2014,4,0,0,4,100.0
521640,2015,5,0,0,5,100.0
521640,2016,4,0,0,4,100.0
521640,2017,5,0,0,5,100.0
521640,2018,8,0,0,8,100.0
521640,2019,2,0,0,2,100.0
521640,2020,6,0,0,6,100.0
521645,2012,2,0,0,2,100.0
521645,2013,2,0,0,2,100.0
521645,2015,1,0,0,1,100.0
521645,2016,0,0,2,2,0.0
521645,2020,1,0,0,1,100.0
521680,2012,3,0,2,5,60.0
521680,2013,2,0,1,3,66.66666666666666
521680,2014,2,0,2,4,50.0
521680,2015,1,0,0,1,100.0
521680,2016,3,1,0,4,100.0
521680,2017,5,0,0,5,100.0
521680,2018,5,0,0,5,100.0
521680,2019,2,0,0,2,100.0
521680,2020,5,0,0,5,100.0
521690,2012,1,0,0,1,100.0
521690,2016,2,0,0,2,100.0
521690,2019,3,0,0,3,100.0
521690,2020,2,0,0,2,100.0
521710,2012,4,0,5,9,44.44444444444444
521710,2013,4,2,4,10,60.0
521710,2014,2,0,4,6,33.33333333333333
521710,2015,9,0,0,9,100.0
521710,2016,12,0,0,12,100.0
521710,2017,9,0,1,10,90.0
521710,2018,6,1,0,7,100.0
521710,2019,6,0,2,8,75.0
521710,2020,11,0,0,11,100.0
521720,2012,6,0,1,7,85.71428571428571
521720,2013,1,0,2,3,33.33333333333333
521720,2014,3,0,0,3,100.0
521720,2015,5,0,0,5,100.0
521720,2016,2,0,1,3,66.66666666666666
521720,2017,5,0,0,5,100.0
521720,2018,3,0,0,3,100.0
521720,2019,2,0,0,2,100.0
521720,2020,3,0,0,3,100.0
521730,2012,9,0,0,9,100.0
521730,2013,10,0,0,10,100.0
521730,2014,5,0,0,5,100.0
521730,2015,8,0,0,8,100.0
521730,2016,12,0,0,12,100.0
521730,2017,8,0,0,8,100.0
521730,2018,2,0,0,2,100.0
521730,2019,7,0,0,7,100.0
521730,2020,11,0,0,11,100.0
521740,2012,9,0,0,9,100.0
521740,2013,12,0,0,12,100.0
521740,2014,2,0,7,9,22.22222222222222
521740,2015,2,0,8,10,20.0
521740,2016,7,0,5,12,58.333333333333336
521740,2017,12,0,1,13,92.3076923076923
521740,2018,9,1,0,10,100.0
521740,2019,11,0,0,11,100.0
521740,2020,14,0,0,14,100.0
521760,2012,25,3,8,36,77.77777777777779
521760,2013,31,0,0,31,100.0
521760,2014,41,0,1,42,97.61904761904762
521760,2015,22,0,2,24,91.66666666666666
521760,2016,42,0,0,42,100.0
521760,2017,29,0,0,29,100.0
521760,2018,27,0,2,29,93.10344827586206
521760,2019,31,1,0,32,100.0
521760,2020,36,1,0,37,100.0
521770,2012,4,0,0,4,100.0
521770,2013,5,1,0,6,100.0
521770,2014,3,0,4,7,42.857142857142854
521770,2015,7,0,0,7,100.0
521770,2016,12,0,0,12,100.0
521770,2017,7,0,0,7,100.0
521770,2018,6,0,0,6,100.0
521770,2019,8,0,1,9,88.88888888888889
521770,2020,5,0,0,5,100.0
521800,2012,9,0,1,10,90.0
521800,2013,17,0,0,17,100.0
521800,2014,10,0,1,11,90.9090909090909
521800,2015,15,0,0,15,100.0
521800,2016,16,0,0,16,100.0
521800,2017,15,0,0,15,100.0
521800,2018,9,2,3,14,78.57142857142857
521800,2019,14,0,5,19,73.68421052631578
521800,2020,4,0,9,13,30.76923076923077
521805,2012,1,0,1,2,50.0
521805,2013,1,0,1,2,50.0
521805,2014,2,0,0,2,100.0
521805,2015,4,0,0,4,100.0
521805,2016,1,0,0,1,100.0
521805,2019,1,0,0,1,100.0
521805,2020,3,0,0,3,100.0
521810,2012,1,0,0,1,100.0
521810,2013,2,0,0,2,100.0
521810,2014,4,0,0,4,100.0
521810,2015,0,1,0,1,100.0
521810,2018,1,0,0,1,100.0
521810,2019,1,0,0,1,100.0
521810,2020,0,0,2,2,0.0
521830,2012,9,0,1,10,90.0
521830,2013,13,0,0,13,100.0
521830,2014,11,0,0,11,100.0
521830,2015,9,0,0,9,100.0
521830,2016,9,0,0,9,100.0
521830,2017,17,0,0,17,100.0
521830,2018,16,1,0,17,100.0
521830,2019,9,0,1,10,90.0
521830,2020,14,0,0,14,100.0
521839,2012,1,0,1,2,50.0
521839,2013,1,0,0,1,100.0
521839,2017,0,1,0,1,100.0
521839,2018,0,0,1,1,0.0
521839,2019,0,0,1,1,0.0
521850,2012,7,0,0,7,100.0
521850,2013,14,0,0,14,100.0
521850,2014,19,0,7,26,73.07692307692307
521850,2015,15,0,0,15,100.0
521850,2016,21,0,0,21,100.0
521850,2017,14,0,0,14,100.0
521850,2018,13,0,0,13,100.0
521850,2019,9,0,0,9,100.0
521850,2020,15,0,0,15,100.0
521860,2012,6,0,0,6,100.0
521860,2013,4,0,0,4,100.0
521860,2014,6,0,0,6,100.0
521860,2015,4,0,0,4,100.0
521860,2016,4,0,0,4,100.0
521860,2017,4,0,0,4,100.0
521860,2018,3,0,0,3,100.0
521860,2019,2,0,0,2,100.0
521860,2020,2,0,0,2,100.0
521870,2012,1,0,0,1,100.0
521870,2013,2,0,0,2,100.0
521870,2014,2,0,0,2,100.0
521870,2015,2,0,0,2,100.0
521870,2017,1,0,0,1,100.0
521870,2018,1,0,0,1,100.0
521870,2019,4,0,0,4,100.0
521870,2020,2,0,0,2,100.0
521878,2012,1,0,0,1,100.0
521878,2013,3,0,0,3,100.0
521878,2015,2,0,0,2,100.0
521878,2019,3,0,0,3,100.0
521878,2020,1,0,0,1,100.0
521880,2012,59,0,1,60,98.33333333333333
521880,2013,80,0,2,82,97.5609756097561
521880,2014,65,0,0,65,100.0
521880,2015,73,0,0,73,100.0
521880,2016,54,0,0,54,100.0
521880,2017,64,0,0,64,100.0
521880,2018,64,0,0,64,100.0
521880,2019,73,0,1,74,98.64864864864865
521880,2020,84,0,0,84,100.0
521890,2012,8,0,0,8,100.0
521890,2013,7,0,0,7,100.0
521890,2014,4,0,0,4,100.0
521890,2015,4,0,0,4,100.0
521890,2016,5,0,0,5,100.0
521890,2017,5,0,0,5,100.0
521890,2018,8,0,0,8,100.0
521890,2019,7,0,0,7,100.0
521890,2020,8,0,0,8,100.0
521900,2012,0,0,2,2,0.0
521900,2013,3,0,0,3,100.0
521900,2014,2,0,0,2,100.0
521900,2015,1,0,0,1,100.0
521900,2016,3,0,0,3,100.0
521900,2017,1,0,0,1,100.0
521900,2019,2,0,0,2,100.0
521900,2020,6,0,0,6,100.0
521910,2012,3,0,0,3,100.0
521910,2013,2,0,0,2,100.0
521910,2014,2,0,0,2,100.0
521910,2015,2,0,0,2,100.0
521910,2016,3,0,0,3,100.0
521910,2017,1,1,0,2,100.0
521910,2018,2,0,0,2,100.0
521910,2019,2,0,0,2,100.0
521910,2020,3,0,0,3,100.0
521920,2012,1,0,0,1,100.0
521920,2013,1,0,1,2,50.0
521920,2015,0,0,1,1,0.0
521920,2016,0,0,1,1,0.0
521920,2017,1,0,0,1,100.0
521920,2018,0,0,2,2,0.0
521920,2019,0,0,2,2,0.0
521925,2013,0,0,1,1,0.0
521925,2014,0,0,4,4,0.0
521925,2015,2,0,0,2,100.0
521925,2016,0,0,1,1,0.0
521925,2017,2,0,0,2,100.0
521930,2012,9,0,1,10,90.0
521930,2013,17,0,0,17,100.0
521930,2014,14,0,1,15,93.33333333333333
521930,2015,16,1,0,17,100.0
521930,2016,9,0,0,9,100.0
521930,2017,16,0,1,17,94.11764705882352
521930,2018,11,0,0,11,100.0
521930,2019,15,0,0,15,100.0
521930,2020,21,0,0,21,100.0
521935,2012,1,0,0,1,100.0
521935,2014,1,0,0,1,100.0
521935,2015,2,0,0,2,100.0
521935,2016,1,0,0,1,100.0
521935,2018,1,0,0,1,100.0
521935,2019,1,0,0,1,100.0
521935,2020,1,0,0,1,100.0
521940,2012,3,0,0,3,100.0
521940,2013,2,1,0,3,100.0
521940,2014,2,0,0,2,100.0
521940,2015,1,0,0,1,100.0
521940,2016,0,0,3,3,0.0
521940,2017,0,1,2,3,33.33333333333333
521940,2018,1,0,1,2,50.0
521940,2019,1,0,0,1,100.0
521940,2020,0,0,2,2,0.0
521945,2012,2,0,0,2,100.0
521945,2013,1,0,1,2,50.0
521945,2014,0,0,1,1,0.0
521945,2015,2,0,0,2,100.0
521945,2017,0,0,1,1,0.0
521945,2019,0,0,1,1,0.0
521945,2020,4,0,0,4,100.0
521950,2012,1,0,0,1,100.0
521950,2013,2,0,0,2,100.0
521950,2014,3,0,0,3,100.0
521950,2015,1,0,0,1,100.0
521950,2016,2,0,0,2,100.0
521950,2018,1,0,0,1,100.0
521960,2012,2,0,0,2,100.0
521960,2013,1,0,0,1,100.0
521960,2014,1,0,0,1,100.0
521960,2016,4,0,0,4,100.0
521960,2017,2,0,0,2,100.0
521960,2020,2,0,0,2,100.0
521970,2012,1,0,0,1,100.0
521970,2013,3,0,0,3,100.0
521970,2014,5,0,0,5,100.0
521970,2015,4,0,0,4,100.0
521970,2016,2,0,0,2,100.0
521970,2017,4,0,0,4,100.0
521970,2018,3,0,0,3,100.0
521970,2019,5,0,0,5,100.0
521970,2020,5,0,0,5,100.0
521971,2012,0,1,0,1,100.0
521971,2013,2,0,0,2,100.0
521971,2014,1,0,0,1,100.0
521971,2017,1,0,0,1,100.0
521971,2018,1,0,0,1,100.0
521971,2020,1,0,1,2,50.0
521973,2012,0,1,2,3,33.33333333333333
521973,2014,0,1,0,1,100.0
521973,2015,0,0,1,1,0.0
521973,2016,2,0,0,2,100.0
521973,2017,1,0,0,1,100.0
521973,2018,1,0,0,1,100.0
521973,2019,5,0,0,5,100.0
521973,2020,4,0,0,4,100.0
521975,2012,20,3,4,27,85.18518518518519
521975,2013,30,0,0,30,100.0
521975,2014,24,0,2,26,92.3076923076923
521975,2015,30,0,1,31,96.7741935483871
521975,2016,28,0,1,29,96.55172413793103
521975,2017,18,1,1,20,95.0
521975,2018,11,1,2,14,85.71428571428571
521975,2019,16,2,0,18,100.0
521975,2020,22,0,0,22,100.0
521980,2012,5,0,0,5,100.0
521980,2013,2,0,0,2,100.0
521980,2014,0,0,2,2,0.0
521980,2015,2,0,2,4,50.0
521980,2016,0,0,1,1,0.0
521980,2017,2,0,1,3,66.66666666666666
521980,2018,3,0,0,3,100.0
521980,2019,1,1,1,3,66.66666666666666
521980,2020,2,0,0,2,100.0
521990,2012,2,0,0,2,100.0
521990,2014,6,0,0,6,100.0
521990,2016,2,0,0,2,100.0
521990,2017,1,0,0,1,100.0
521990,2019,2,0,0,2,100.0
521990,2020,2,0,0,2,100.0
522000,2012,4,0,0,4,100.0
522000,2014,2,0,0,2,100.0
522000,2015,2,0,0,2,100.0
522000,2016,3,0,0,3,100.0
522000,2017,0,0,2,2,0.0
522000,2018,7,2,1,10,90.0
522000,2019,2,0,2,4,50.0
522005,2012,1,0,0,1,100.0
522005,2013,3,0,0,3,100.0
522005,2016,4,0,0,4,100.0
522005,2018,2,0,0,2,100.0
522005,2019,1,0,0,1,100.0
522005,2020,1,0,0,1,100.0
522010,2012,6,0,0,6,100.0
522010,2013,11,0,0,11,100.0
522010,2014,11,0,0,11,100.0
522010,2015,8,0,0,8,100.0
522010,2016,8,0,0,8,100.0
522010,2017,13,0,0,13,100.0
522010,2018,7,0,0,7,100.0
522010,2019,7,0,0,7,100.0
522010,2020,16,0,0,16,100.0
522015,2012,1,0,0,1,100.0
522015,2013,1,0,0,1,100.0
522015,2014,1,0,0,1,100.0
522015,2015,2,0,0,2,100.0
522015,2016,1,0,0,1,100.0
522015,2017,1,0,0,1,100.0
522015,2018,2,0,0,2,100.0
522015,2019,2,0,0,2,100.0
522015,2020,2,0,0,2,100.0
522020,2012,3,0,1,4,75.0
522020,2013,2,0,9,11,18.181818181818183
522020,2014,1,1,8,10,20.0
522020,2015,13,0,0,13,100.0
522020,2016,10,0,0,10,100.0
522020,2017,4,0,5,9,44.44444444444444
522020,2018,8,0,2,10,80.0
522020,2019,3,0,4,7,42.857142857142854
522020,2020,7,0,1,8,87.5
522026,2012,2,0,0,2,100.0
522026,2013,1,0,0,1,100.0
522026,2014,1,0,0,1,100.0
522026,2016,2,0,0,2,100.0
522026,2017,1,0,0,1,100.0
522026,2018,1,0,0,1,100.0
522026,2019,3,0,0,3,100.0
522026,2020,2,0,0,2,100.0
522028,2012,1,0,0,1,100.0
522028,2013,1,0,0,1,100.0
522028,2020,2,0,0,2,100.0
522040,2012,3,0,0,3,100.0
522040,2013,12,0,0,12,100.0
522040,2014,7,0,0,7,100.0
522040,2015,4,0,0,4,100.0
522040,2016,6,0,0,6,100.0
522040,2017,5,0,1,6,83.33333333333334
522040,2018,6,0,0,6,100.0
522040,2019,6,0,0,6,100.0
522040,2020,7,0,0,7,100.0
522045,2012,47,0,0,47,100.0
522045,2013,40,0,0,40,100.0
522045,2014,58,0,1,59,98.30508474576271
522045,2015,49,0,0,49,100.0
522045,2016,46,0,0,46,100.0
522045,2017,49,0,1,50,98.0
522045,2018,44,0,0,44,100.0
522045,2019,42,3,6,51,88.23529411764706
522045,2020,60,0,1,61,98.36065573770492
522050,2012,3,0,0,3,100.0
522050,2013,3,0,0,3,100.0
522050,2014,6,0,0,6,100.0
522050,2015,2,0,0,2,100.0
522050,2016,3,0,0,3,100.0
522050,2017,2,1,0,3,100.0
522050,2019,2,0,1,3,66.66666666666666
522050,2020,1,0,0,1,100.0
522060,2012,7,0,0,7,100.0
522060,2013,8,0,2,10,80.0
522060,2014,0,2,0,2,100.0
522060,2015,3,0,0,3,100.0
522060,2016,4,0,0,4,100.0
522060,2017,9,0,0,9,100.0
522060,2018,5,0,0,5,100.0
522060,2019,4,0,0,4,100.0
522060,2020,4,1,0,5,100.0
522068,2012,2,0,0,2,100.0
522068,2013,6,1,0,7,100.0
522068,2014,1,0,0,1,100.0
522068,2015,2,0,0,2,100.0
522068,2017,5,0,0,5,100.0
522068,2018,1,0,0,1,100.0
522068,2019,1,0,5,6,16.666666666666664
522068,2020,0,1,3,4,25.0
522070,2012,1,0,0,1,100.0
522070,2013,0,0,1,1,0.0
522070,2016,0,0,2,2,0.0
522070,2018,2,0,0,2,100.0
522100,2012,1,0,0,1,100.0
522100,2015,2,0,0,2,100.0
522100,2016,1,0,0,1,100.0
522100,2018,1,0,0,1,100.0
522100,2020,2,0,0,2,100.0
522108,2015,1,0,1,2,50.0
522108,2016,0,0,1,1,0.0
522108,2017,0,0,2,2,0.0
522108,2018,0,0,2,2,0.0
522108,2020,2,0,0,2,100.0
522119,2012,2,0,0,2,100.0
522119,2013,8,0,0,8,100.0
522119,2014,8,0,0,8,100.0
522119,2015,3,0,0,3,100.0
522119,2016,3,0,0,3,100.0
522119,2017,3,0,0,3,100.0
522119,2018,2,0,0,2,100.0
522119,2019,2,0,0,2,100.0
522119,2020,2,0,0,2,100.0
522130,2013,2,0,0,2,100.0
522130,2014,1,0,0,1,100.0
522130,2015,0,0,1,1,0.0
522130,2017,1,0,1,2,50.0
522130,2018,0,0,4,4,0.0
522130,2019,1,0,0,1,100.0
522130,2020,3,0,0,3,100.0
522140,2012,37,1,1,39,97.43589743589743
522140,2013,48,0,1,49,97.95918367346938
522140,2014,50,1,4,55,92.72727272727272
522140,2015,49,4,4,57,92.98245614035088
522140,2016,51,0,0,51,100.0
522140,2017,47,1,0,48,100.0
522140,2018,54,0,0,54,100.0
522140,2019,35,10,6,51,88.23529411764706
522140,2020,41,3,14,58,75.86206896551724
522145,2013,0,0,2,2,0.0
522145,2014,0,0,1,1,0.0
522145,2015,1,0,0,1,100.0
522145,2016,0,0,2,2,0.0
522145,2017,4,0,1,5,80.0
522145,2019,1,0,0,1,100.0
522145,2020,0,0,1,1,0.0
522150,2012,2,0,0,2,100.0
522150,2013,2,0,0,2,100.0
522150,2016,2,0,0,2,100.0
522150,2017,3,0,0,3,100.0
522150,2018,2,0,0,2,100.0
522150,2019,3,0,0,3,100.0
522150,2020,1,0,0,1,100.0
522155,2013,1,0,1,2,50.0
522155,2014,1,0,2,3,33.33333333333333
522155,2015,1,0,0,1,100.0
522155,2016,1,0,0,1,100.0
522155,2017,1,0,0,1,100.0
522155,2018,1,0,0,1,100.0
522155,2019,3,0,0,3,100.0
522155,2020,1,0,0,1,100.0
522157,2013,1,0,0,1,100.0
522157,2014,3,0,0,3,100.0
522157,2015,1,0,0,1,100.0
522157,2016,1,0,0,1,100.0
522157,2018,1,0,0,1,100.0
522157,2020,1,0,0,1,100.0
522160,2012,16,2,1,19,94.73684210526315
522160,2013,14,0,0,14,100.0
522160,2014,13,0,1,14,92.85714285714286
522160,2015,11,0,1,12,91.66666666666666
522160,2016,19,0,2,21,90.47619047619048
522160,2017,12,0,1,13,92.3076923076923
522160,2018,14,0,0,14,100.0
522160,2019,15,0,0,15,100.0
522160,2020,10,1,0,11,100.0
522170,2012,6,0,0,6,100.0
522170,2013,4,0,0,4,100.0
522170,2014,3,0,0,3,100.0
522170,2015,5,0,0,5,100.0
522170,2016,6,0,0,6,100.0
522170,2017,5,0,0,5,100.0
522170,2018,11,0,0,11,100.0
522170,2019,4,0,0,4,100.0
522170,2020,8,0,0,8,100.0
522180,2014,0,0,1,1,0.0
522180,2016,1,0,2,3,33.33333333333333
522180,2017,0,0,1,1,0.0
522180,2018,2,0,0,2,100.0
522180,2019,1,0,0,1,100.0
522185,2012,43,1,5,49,89.79591836734694
522185,2013,44,1,2,47,95.74468085106383
522185,2014,29,2,9,40,77.5
522185,2015,37,2,5,44,88.63636363636364
522185,2016,60,1,5,66,92.42424242424242
522185,2017,41,0,0,41,100.0
522185,2018,40,3,4,47,91.48936170212765
522185,2019,38,2,8,48,83.33333333333334
522185,2020,41,1,3,45,93.33333333333333
522190,2012,0,0,1,1,0.0
522190,2013,0,0,2,2,0.0
522190,2014,0,0,1,1,0.0
522190,2015,1,0,0,1,100.0
522190,2017,0,0,1,1,0.0
522190,2018,1,0,0,1,100.0
522200,2012,5,0,1,6,83.33333333333334
522200,2013,4,0,1,5,80.0
522200,2014,4,1,0,5,100.0
522200,2015,1,0,0,1,100.0
522200,2016,8,0,1,9,88.88888888888889
522200,2017,9,0,0,9,100.0
522200,2018,2,0,0,2,100.0
522200,2019,2,0,0,2,100.0
522200,2020,6,0,0,6,100.0
522205,2012,0,0,3,3,0.0
522205,2013,1,0,2,3,33.33333333333333
522205,2014,0,1,4,5,20.0
522205,2015,1,0,2,3,33.33333333333333
522205,2016,1,0,0,1,100.0
522205,2017,4,0,0,4,100.0
522205,2018,4,0,1,5,80.0
522205,2019,1,0,3,4,25.0
522205,2020,0,0,2,2,0.0
522220,2012,2,0,0,2,100.0
522220,2013,6,0,0,6,100.0
522220,2014,3,0,0,3,100.0
522220,2015,4,0,0,4,100.0
522220,2016,3,0,0,3,100.0
522220,2017,1,0,0,1,100.0
522220,2018,1,0,0,1,100.0
522220,2019,1,0,0,1,100.0
522220,2020,3,0,0,3,100.0
522230,2013,1,0,0,1,100.0
522230,2014,1,0,0,1,100.0
522230,2016,0,0,1,1,0.0
522230,2019,1,0,0,1,100.0
522230,2020,3,0,0,3,100.0
530010,2012,708,28,61,797,92.34629861982434
530010,2013,748,22,57,827,93.10761789600967
530010,2014,706,33,62,801,92.25967540574283
530010,2015,633,43,84,760,88.94736842105263
530010,2016,645,73,99,817,87.88249694002448
530010,2017,563,50,89,702,87.32193732193733
530010,2018,671,47,55,773,92.88486416558862
530010,2019,662,23,27,712,96.20786516853933
530010,2020,790,29,18,837,97.84946236559139
